GEOid,GEOid2,GEO.display-label,HD01_VD01,HD02_VD01,HD01_VD02,HD02_VD02,HD01_VD03,HD02_VD03
1400000US48001950100,48001950100,"Census Tract 9501, Anderson County, Texas",5477,674,5073,677,404,297
1400000US48001950401,48001950401,"Census Tract 9504.01, Anderson County, Texas",6773,429,4940,387,1833,235
1400000US48001950402,48001950402,"Census Tract 9504.02, Anderson County, Texas",3192,531,2419,443,773,160
1400000US48001950500,48001950500,"Census Tract 9505, Anderson County, Texas",4538,556,3341,465,1197,469
1400000US48001950600,48001950600,"Census Tract 9506, Anderson County, Texas",6233,576,4949,542,1284,349
1400000US48001950700,48001950700,"Census Tract 9507, Anderson County, Texas",3154,429,2738,397,416,145
1400000US48001950800,48001950800,"Census Tract 9508, Anderson County, Texas",4715,453,4228,448,487,261
1400000US48001950901,48001950901,"Census Tract 9509.01, Anderson County, Texas",5939,650,4797,657,1142,434
1400000US48001950902,48001950902,"Census Tract 9509.02, Anderson County, Texas",5207,628,4405,588,802,396
1400000US48001951000,48001951000,"Census Tract 9510, Anderson County, Texas",7528,605,7053,620,475,305
1400000US48001951100,48001951100,"Census Tract 9511, Anderson County, Texas",5513,624,5049,644,464,234
1400000US48003950100,48003950100,"Census Tract 9501, Andrews County, Texas",1893,219,1368,198,525,243
1400000US48003950200,48003950200,"Census Tract 9502, Andrews County, Texas",6646,421,3564,347,3082,452
1400000US48003950300,48003950300,"Census Tract 9503, Andrews County, Texas",3972,424,1576,310,2396,379
1400000US48003950400,48003950400,"Census Tract 9504, Andrews County, Texas",2495,290,1066,241,1429,307
1400000US48005000101,48005000101,"Census Tract 1.01, Angelina County, Texas",5954,638,5109,555,845,504
1400000US48005000102,48005000102,"Census Tract 1.02, Angelina County, Texas",4768,409,3985,379,783,243
1400000US48005000200,48005000200,"Census Tract 2, Angelina County, Texas",6196,537,4935,547,1261,443
1400000US48005000301,48005000301,"Census Tract 3.01, Angelina County, Texas",5381,613,4527,520,854,463
1400000US48005000302,48005000302,"Census Tract 3.02, Angelina County, Texas",4656,455,4024,443,632,285
1400000US48005000400,48005000400,"Census Tract 4, Angelina County, Texas",5583,613,4681,526,902,388
1400000US48005000500,48005000500,"Census Tract 5, Angelina County, Texas",4046,473,3434,399,612,339
1400000US48005000600,48005000600,"Census Tract 6, Angelina County, Texas",6725,606,3586,411,3139,517
1400000US48005000700,48005000700,"Census Tract 7, Angelina County, Texas",3956,452,1785,329,2171,473
1400000US48005000800,48005000800,"Census Tract 8, Angelina County, Texas",5630,648,4826,543,804,490
1400000US48005000901,48005000901,"Census Tract 9.01, Angelina County, Texas",6527,476,5811,514,716,258
1400000US48005000902,48005000902,"Census Tract 9.02, Angelina County, Texas",2767,378,2586,349,181,148
1400000US48005001001,48005001001,"Census Tract 10.01, Angelina County, Texas",5935,449,3643,468,2292,363
1400000US48005001002,48005001002,"Census Tract 10.02, Angelina County, Texas",4165,389,2702,402,1463,342
1400000US48005001100,48005001100,"Census Tract 11, Angelina County, Texas",6399,615,6252,634,147,133
1400000US48005001200,48005001200,"Census Tract 12, Angelina County, Texas",2814,441,2793,441,21,19
1400000US48005001300,48005001300,"Census Tract 13, Angelina County, Texas",5048,545,4743,486,305,244
1400000US48007950100,48007950100,"Census Tract 9501, Aransas County, Texas",5798,591,4805,572,993,344
1400000US48007950200,48007950200,"Census Tract 9502, Aransas County, Texas",1179,146,1121,143,58,60
1400000US48007950300,48007950300,"Census Tract 9503, Aransas County, Texas",7009,427,5331,485,1678,408
1400000US48007950400,48007950400,"Census Tract 9504, Aransas County, Texas",3491,484,2028,322,1463,348
1400000US48007950500,48007950500,"Census Tract 9505, Aransas County, Texas",5914,584,4256,519,1658,432
1400000US48007990000,48007990000,"Census Tract 9900, Aransas County, Texas",0,13,0,13,0,13
1400000US48009020100,48009020100,"Census Tract 201, Archer County, Texas",2728,186,2638,183,90,68
1400000US48009020200,48009020200,"Census Tract 202, Archer County, Texas",2743,209,2598,206,145,63
1400000US48009020300,48009020300,"Census Tract 203, Archer County, Texas",3473,223,3016,205,457,85
1400000US48011950100,48011950100,"Census Tract 9501, Armstrong County, Texas",1820,116,1635,114,185,50
1400000US48013960100,48013960100,"Census Tract 9601, Atascosa County, Texas",6186,588,2815,492,3371,605
1400000US48013960201,48013960201,"Census Tract 9602.01, Atascosa County, Texas",6765,729,2565,419,4200,705
1400000US48013960202,48013960202,"Census Tract 9602.02, Atascosa County, Texas",10375,869,3415,569,6960,937
1400000US48013960300,48013960300,"Census Tract 9603, Atascosa County, Texas",3592,166,405,189,3187,129
1400000US48013960401,48013960401,"Census Tract 9604.01, Atascosa County, Texas",2340,467,454,130,1886,452
1400000US48013960402,48013960402,"Census Tract 9604.02, Atascosa County, Texas",7623,621,3921,552,3702,710
1400000US48013960500,48013960500,"Census Tract 9605, Atascosa County, Texas",2511,349,519,147,1992,369
1400000US48013960600,48013960600,"Census Tract 9606, Atascosa County, Texas",5699,374,3055,446,2644,358
1400000US48015760100,48015760100,"Census Tract 7601, Austin County, Texas",2304,299,1705,275,599,239
1400000US48015760200,48015760200,"Census Tract 7602, Austin County, Texas",6218,494,4211,465,2007,403
1400000US48015760300,48015760300,"Census Tract 7603, Austin County, Texas",7183,615,5128,582,2055,550
1400000US48015760400,48015760400,"Census Tract 7604, Austin County, Texas",3682,512,3481,516,201,182
1400000US48015760501,48015760501,"Census Tract 7605.01, Austin County, Texas",4217,486,3610,459,607,259
1400000US48015760502,48015760502,"Census Tract 7605.02, Austin County, Texas",4768,445,3557,426,1211,437
1400000US48017950100,48017950100,"Census Tract 9501, Bailey County, Texas",7096,,3125,213,3971,213
1400000US48019000101,48019000101,"Census Tract 1.01, Bandera County, Texas",4724,536,3941,453,783,320
1400000US48019000102,48019000102,"Census Tract 1.02, Bandera County, Texas",4612,575,4106,551,506,274
1400000US48019000200,48019000200,"Census Tract 2, Bandera County, Texas",2544,303,2186,288,358,175
1400000US48019000300,48019000300,"Census Tract 3, Bandera County, Texas",6575,655,5262,547,1313,453
1400000US48019000400,48019000400,"Census Tract 4, Bandera County, Texas",2022,341,1549,285,473,217
1400000US48021950100,48021950100,"Census Tract 9501, Bastrop County, Texas",9280,823,5961,534,3319,795
1400000US48021950200,48021950200,"Census Tract 9502, Bastrop County, Texas",8046,309,4426,523,3620,462
1400000US48021950300,48021950300,"Census Tract 9503, Bastrop County, Texas",12261,886,9870,769,2391,691
1400000US48021950400,48021950400,"Census Tract 9504, Bastrop County, Texas",7833,764,6304,584,1529,611
1400000US48021950501,48021950501,"Census Tract 9505.01, Bastrop County, Texas",8005,693,5162,653,2843,468
1400000US48021950502,48021950502,"Census Tract 9505.02, Bastrop County, Texas",5868,591,5337,526,531,307
1400000US48021950600,48021950600,"Census Tract 9506, Bastrop County, Texas",4946,565,3817,467,1129,502
1400000US48021950700,48021950700,"Census Tract 9507, Bastrop County, Texas",3995,125,3181,317,814,292
1400000US48021950801,48021950801,"Census Tract 9508.01, Bastrop County, Texas",6496,849,1936,424,4560,864
1400000US48021950802,48021950802,"Census Tract 9508.02, Bastrop County, Texas",7293,938,3947,757,3346,713
1400000US48023950300,48023950300,"Census Tract 9503, Baylor County, Texas",3706,,3336,103,370,103
1400000US48025950100,48025950100,"Census Tract 9501, Bee County, Texas",2267,358,1446,316,821,208
1400000US48025950201,48025950201,"Census Tract 9502.01, Bee County, Texas",7326,515,4160,384,3166,358
1400000US48025950202,48025950202,"Census Tract 9502.02, Bee County, Texas",5064,502,2218,331,2846,442
1400000US48025950300,48025950300,"Census Tract 9503, Bee County, Texas",4540,495,2036,410,2504,367
1400000US48025950400,48025950400,"Census Tract 9504, Bee County, Texas",2052,240,745,234,1307,213
1400000US48025950500,48025950500,"Census Tract 9505, Bee County, Texas",8369,655,2386,428,5983,569
1400000US48025950600,48025950600,"Census Tract 9506, Bee County, Texas",2465,319,1002,238,1463,268
1400000US48027020100,48027020100,"Census Tract 201, Bell County, Texas",6831,450,5837,494,994,312
1400000US48027020201,48027020201,"Census Tract 202.01, Bell County, Texas",6601,632,5953,610,648,397
1400000US48027020202,48027020202,"Census Tract 202.02, Bell County, Texas",5505,693,4600,661,905,217
1400000US48027020300,48027020300,"Census Tract 203, Bell County, Texas",9107,733,7183,719,1924,477
1400000US48027020401,48027020401,"Census Tract 204.01, Bell County, Texas",2554,464,2115,427,439,222
1400000US48027020402,48027020402,"Census Tract 204.02, Bell County, Texas",2032,450,1548,417,484,232
1400000US48027020500,48027020500,"Census Tract 205, Bell County, Texas",3925,408,2874,329,1051,287
1400000US48027020600,48027020600,"Census Tract 206, Bell County, Texas",3006,409,2493,460,513,222
1400000US48027020701,48027020701,"Census Tract 207.01, Bell County, Texas",1128,190,795,171,333,148
1400000US48027020702,48027020702,"Census Tract 207.02, Bell County, Texas",1903,371,883,193,1020,371
1400000US48027020800,48027020800,"Census Tract 208, Bell County, Texas",2931,501,1993,422,938,333
1400000US48027020900,48027020900,"Census Tract 209, Bell County, Texas",2197,454,1447,311,750,331
1400000US48027021000,48027021000,"Census Tract 210, Bell County, Texas",4130,638,2648,459,1482,430
1400000US48027021100,48027021100,"Census Tract 211, Bell County, Texas",5636,675,4297,572,1339,479
1400000US48027021201,48027021201,"Census Tract 212.01, Bell County, Texas",3226,547,2731,494,495,195
1400000US48027021202,48027021202,"Census Tract 212.02, Bell County, Texas",4065,606,3281,510,784,264
1400000US48027021203,48027021203,"Census Tract 212.03, Bell County, Texas",4223,451,3705,421,518,187
1400000US48027021301,48027021301,"Census Tract 213.01, Bell County, Texas",5601,554,4751,510,850,320
1400000US48027021302,48027021302,"Census Tract 213.02, Bell County, Texas",3381,418,3216,413,165,90
1400000US48027021303,48027021303,"Census Tract 213.03, Bell County, Texas",5996,667,5006,596,990,332
1400000US48027021400,48027021400,"Census Tract 214, Bell County, Texas",3743,336,3188,367,555,290
1400000US48027021500,48027021500,"Census Tract 215, Bell County, Texas",5658,623,4311,590,1347,417
1400000US48027021601,48027021601,"Census Tract 216.01, Bell County, Texas",5226,584,2802,411,2424,531
1400000US48027021602,48027021602,"Census Tract 216.02, Bell County, Texas",2437,365,2041,370,396,149
1400000US48027021700,48027021700,"Census Tract 217, Bell County, Texas",8151,596,7273,617,878,302
1400000US48027021800,48027021800,"Census Tract 218, Bell County, Texas",7017,640,5511,661,1506,440
1400000US48027021901,48027021901,"Census Tract 219.01, Bell County, Texas",3401,381,2561,331,840,290
1400000US48027021903,48027021903,"Census Tract 219.03, Bell County, Texas",9067,711,7894,740,1173,582
1400000US48027021904,48027021904,"Census Tract 219.04, Bell County, Texas",8149,886,6076,723,2073,748
1400000US48027022000,48027022000,"Census Tract 220, Bell County, Texas",7977,869,6573,731,1404,393
1400000US48027022101,48027022101,"Census Tract 221.01, Bell County, Texas",4315,580,3484,500,831,303
1400000US48027022103,48027022103,"Census Tract 221.03, Bell County, Texas",5585,516,4636,501,949,223
1400000US48027022104,48027022104,"Census Tract 221.04, Bell County, Texas",4259,566,3422,467,837,364
1400000US48027022105,48027022105,"Census Tract 221.05, Bell County, Texas",1985,331,1473,344,512,265
1400000US48027022200,48027022200,"Census Tract 222, Bell County, Texas",3498,434,2562,416,936,352
1400000US48027022300,48027022300,"Census Tract 223, Bell County, Texas",3715,468,2888,374,827,312
1400000US48027022401,48027022401,"Census Tract 224.01, Bell County, Texas",5672,735,3818,622,1854,624
1400000US48027022402,48027022402,"Census Tract 224.02, Bell County, Texas",3775,523,2750,466,1025,359
1400000US48027022403,48027022403,"Census Tract 224.03, Bell County, Texas",4428,548,3876,580,552,315
1400000US48027022404,48027022404,"Census Tract 224.04, Bell County, Texas",7705,810,5916,781,1789,514
1400000US48027022405,48027022405,"Census Tract 224.05, Bell County, Texas",1848,428,954,265,894,464
1400000US48027022501,48027022501,"Census Tract 225.01, Bell County, Texas",3603,655,2663,480,940,478
1400000US48027022502,48027022502,"Census Tract 225.02, Bell County, Texas",9432,855,7420,788,2012,530
1400000US48027022600,48027022600,"Census Tract 226, Bell County, Texas",4019,667,2548,466,1471,510
1400000US48027022801,48027022801,"Census Tract 228.01, Bell County, Texas",2733,412,2019,320,714,375
1400000US48027022900,48027022900,"Census Tract 229, Bell County, Texas",3477,518,2454,378,1023,386
1400000US48027023000,48027023000,"Census Tract 230, Bell County, Texas",6773,575,5033,510,1740,458
1400000US48027023103,48027023103,"Census Tract 231.03, Bell County, Texas",4516,422,3611,374,905,266
1400000US48027023104,48027023104,"Census Tract 231.04, Bell County, Texas",4308,533,3241,593,1067,439
1400000US48027023105,48027023105,"Census Tract 231.05, Bell County, Texas",7574,903,6411,785,1163,521
1400000US48027023106,48027023106,"Census Tract 231.06, Bell County, Texas",9205,890,6933,1008,2272,648
1400000US48027023107,48027023107,"Census Tract 231.07, Bell County, Texas",7505,918,5547,910,1958,607
1400000US48027023108,48027023108,"Census Tract 231.08, Bell County, Texas",15073,1520,10994,1424,4079,819
1400000US48027023201,48027023201,"Census Tract 232.01, Bell County, Texas",2542,253,2031,349,511,236
1400000US48027023202,48027023202,"Census Tract 232.02, Bell County, Texas",8480,603,6292,661,2188,656
1400000US48027023203,48027023203,"Census Tract 232.03, Bell County, Texas",2800,404,1850,417,950,376
1400000US48027023204,48027023204,"Census Tract 232.04, Bell County, Texas",5100,481,4247,492,853,229
1400000US48027023300,48027023300,"Census Tract 233, Bell County, Texas",6560,503,5689,467,871,289
1400000US48027023402,48027023402,"Census Tract 234.02, Bell County, Texas",4167,447,3332,348,835,256
1400000US48027023403,48027023403,"Census Tract 234.03, Bell County, Texas",5021,475,4438,459,583,318
1400000US48027023404,48027023404,"Census Tract 234.04, Bell County, Texas",2889,459,2459,409,430,200
1400000US48027023500,48027023500,"Census Tract 235, Bell County, Texas",1981,376,1544,360,437,190
1400000US48027980001,48027980001,"Census Tract 9800.01, Bell County, Texas",795,229,637,195,158,110
1400000US48027980002,48027980002,"Census Tract 9800.02, Bell County, Texas",13,24,13,24,0,13
1400000US48027980003,48027980003,"Census Tract 9800.03, Bell County, Texas",0,13,0,13,0,13
1400000US48029110100,48029110100,"Census Tract 1101, Bexar County, Texas",2854,353,1042,221,1812,346
1400000US48029110300,48029110300,"Census Tract 1103, Bexar County, Texas",3148,407,826,236,2322,400
1400000US48029110500,48029110500,"Census Tract 1105, Bexar County, Texas",2128,269,123,80,2005,284
1400000US48029110600,48029110600,"Census Tract 1106, Bexar County, Texas",7808,607,1690,319,6118,570
1400000US48029110700,48029110700,"Census Tract 1107, Bexar County, Texas",2116,604,306,135,1810,602
1400000US48029110800,48029110800,"Census Tract 1108, Bexar County, Texas",1650,261,514,119,1136,278
1400000US48029110900,48029110900,"Census Tract 1109, Bexar County, Texas",444,254,216,220,228,121
1400000US48029111000,48029111000,"Census Tract 1110, Bexar County, Texas",1681,249,420,112,1261,238
1400000US48029120100,48029120100,"Census Tract 1201, Bexar County, Texas",7146,662,5987,612,1159,259
1400000US48029120300,48029120300,"Census Tract 1203, Bexar County, Texas",7131,20,5543,303,1588,300
1400000US48029120400,48029120400,"Census Tract 1204, Bexar County, Texas",5875,293,4859,463,1016,324
1400000US48029120501,48029120501,"Census Tract 1205.01, Bexar County, Texas",7433,888,3580,462,3853,847
1400000US48029120502,48029120502,"Census Tract 1205.02, Bexar County, Texas",5010,561,2266,376,2744,464
1400000US48029120600,48029120600,"Census Tract 1206, Bexar County, Texas",6050,531,4284,517,1766,547
1400000US48029120701,48029120701,"Census Tract 1207.01, Bexar County, Texas",5039,674,2278,416,2761,505
1400000US48029120702,48029120702,"Census Tract 1207.02, Bexar County, Texas",4537,431,3885,365,652,284
1400000US48029120800,48029120800,"Census Tract 1208, Bexar County, Texas",6843,416,5190,512,1653,345
1400000US48029120901,48029120901,"Census Tract 1209.01, Bexar County, Texas",2189,305,1212,162,977,293
1400000US48029120902,48029120902,"Census Tract 1209.02, Bexar County, Texas",6752,953,4185,715,2567,734
1400000US48029121000,48029121000,"Census Tract 1210, Bexar County, Texas",6839,653,4367,542,2472,506
1400000US48029121108,48029121108,"Census Tract 1211.08, Bexar County, Texas",7073,512,4780,409,2293,520
1400000US48029121110,48029121110,"Census Tract 1211.10, Bexar County, Texas",5104,384,3015,374,2089,308
1400000US48029121111,48029121111,"Census Tract 1211.11, Bexar County, Texas",6772,714,3828,756,2944,506
1400000US48029121112,48029121112,"Census Tract 1211.12, Bexar County, Texas",3860,257,2674,309,1186,320
1400000US48029121115,48029121115,"Census Tract 1211.15, Bexar County, Texas",5321,425,4058,413,1263,337
1400000US48029121116,48029121116,"Census Tract 1211.16, Bexar County, Texas",4944,435,3194,352,1750,429
1400000US48029121117,48029121117,"Census Tract 1211.17, Bexar County, Texas",4358,349,2963,343,1395,250
1400000US48029121118,48029121118,"Census Tract 1211.18, Bexar County, Texas",6047,575,3800,447,2247,498
1400000US48029121119,48029121119,"Census Tract 1211.19, Bexar County, Texas",5261,414,3243,334,2018,303
1400000US48029121120,48029121120,"Census Tract 1211.20, Bexar County, Texas",5536,466,3265,430,2271,544
1400000US48029121121,48029121121,"Census Tract 1211.21, Bexar County, Texas",2865,163,2190,133,675,135
1400000US48029121122,48029121122,"Census Tract 1211.22, Bexar County, Texas",5402,335,3602,348,1800,211
1400000US48029121203,48029121203,"Census Tract 1212.03, Bexar County, Texas",3921,376,1556,199,2365,367
1400000US48029121204,48029121204,"Census Tract 1212.04, Bexar County, Texas",7530,610,4319,482,3211,595
1400000US48029121205,48029121205,"Census Tract 1212.05, Bexar County, Texas",3889,567,1773,484,2116,455
1400000US48029121206,48029121206,"Census Tract 1212.06, Bexar County, Texas",8067,660,3791,613,4276,703
1400000US48029121300,48029121300,"Census Tract 1213, Bexar County, Texas",6039,475,3845,442,2194,493
1400000US48029121402,48029121402,"Census Tract 1214.02, Bexar County, Texas",5341,499,1989,383,3352,463
1400000US48029121403,48029121403,"Census Tract 1214.03, Bexar County, Texas",5217,501,3004,385,2213,398
1400000US48029121404,48029121404,"Census Tract 1214.04, Bexar County, Texas",5102,463,2595,397,2507,471
1400000US48029121501,48029121501,"Census Tract 1215.01, Bexar County, Texas",7542,441,4865,462,2677,427
1400000US48029121504,48029121504,"Census Tract 1215.04, Bexar County, Texas",6907,577,4352,496,2555,582
1400000US48029121505,48029121505,"Census Tract 1215.05, Bexar County, Texas",4660,361,2849,395,1811,348
1400000US48029121506,48029121506,"Census Tract 1215.06, Bexar County, Texas",5100,557,2351,427,2749,591
1400000US48029121507,48029121507,"Census Tract 1215.07, Bexar County, Texas",4522,463,3027,351,1495,379
1400000US48029121508,48029121508,"Census Tract 1215.08, Bexar County, Texas",5009,471,2884,541,2125,434
1400000US48029121601,48029121601,"Census Tract 1216.01, Bexar County, Texas",4593,462,2699,411,1894,458
1400000US48029121604,48029121604,"Census Tract 1216.04, Bexar County, Texas",7590,550,5691,665,1899,431
1400000US48029121605,48029121605,"Census Tract 1216.05, Bexar County, Texas",2333,225,1465,185,868,204
1400000US48029121606,48029121606,"Census Tract 1216.06, Bexar County, Texas",4981,404,3380,410,1601,375
1400000US48029121701,48029121701,"Census Tract 1217.01, Bexar County, Texas",4030,533,2695,384,1335,493
1400000US48029121702,48029121702,"Census Tract 1217.02, Bexar County, Texas",6469,665,4754,437,1715,721
1400000US48029121802,48029121802,"Census Tract 1218.02, Bexar County, Texas",8926,742,4792,561,4134,748
1400000US48029121803,48029121803,"Census Tract 1218.03, Bexar County, Texas",4921,360,2316,448,2605,480
1400000US48029121804,48029121804,"Census Tract 1218.04, Bexar County, Texas",6695,667,3280,474,3415,686
1400000US48029121808,48029121808,"Census Tract 1218.08, Bexar County, Texas",3304,303,1752,277,1552,229
1400000US48029121809,48029121809,"Census Tract 1218.09, Bexar County, Texas",4613,388,2969,405,1644,394
1400000US48029121810,48029121810,"Census Tract 1218.10, Bexar County, Texas",4706,379,2732,299,1974,394
1400000US48029121811,48029121811,"Census Tract 1218.11, Bexar County, Texas",5075,327,2539,288,2536,409
1400000US48029121812,48029121812,"Census Tract 1218.12, Bexar County, Texas",5557,503,3232,450,2325,343
1400000US48029121813,48029121813,"Census Tract 1218.13, Bexar County, Texas",1550,162,1012,160,538,145
1400000US48029121903,48029121903,"Census Tract 1219.03, Bexar County, Texas",5077,263,4117,287,960,237
1400000US48029121904,48029121904,"Census Tract 1219.04, Bexar County, Texas",3767,289,2832,340,935,228
1400000US48029121905,48029121905,"Census Tract 1219.05, Bexar County, Texas",4746,441,3441,456,1305,310
1400000US48029121906,48029121906,"Census Tract 1219.06, Bexar County, Texas",5125,404,3616,449,1509,323
1400000US48029121907,48029121907,"Census Tract 1219.07, Bexar County, Texas",9671,574,5673,585,3998,614
1400000US48029121908,48029121908,"Census Tract 1219.08, Bexar County, Texas",2146,349,1469,353,677,246
1400000US48029121909,48029121909,"Census Tract 1219.09, Bexar County, Texas",4463,467,2549,299,1914,355
1400000US48029121910,48029121910,"Census Tract 1219.10, Bexar County, Texas",4380,300,2941,408,1439,347
1400000US48029130200,48029130200,"Census Tract 1302, Bexar County, Texas",1951,359,497,252,1454,402
1400000US48029130300,48029130300,"Census Tract 1303, Bexar County, Texas",3047,434,715,165,2332,418
1400000US48029130401,48029130401,"Census Tract 1304.01, Bexar County, Texas",3312,578,650,196,2662,647
1400000US48029130402,48029130402,"Census Tract 1304.02, Bexar County, Texas",3956,651,1347,536,2609,613
1400000US48029130500,48029130500,"Census Tract 1305, Bexar County, Texas",4430,642,1490,373,2940,582
1400000US48029130600,48029130600,"Census Tract 1306, Bexar County, Texas",5100,504,2520,444,2580,482
1400000US48029130700,48029130700,"Census Tract 1307, Bexar County, Texas",1817,265,372,174,1445,224
1400000US48029130800,48029130800,"Census Tract 1308, Bexar County, Texas",5646,621,3451,496,2195,600
1400000US48029130900,48029130900,"Census Tract 1309, Bexar County, Texas",4493,459,2046,350,2447,473
1400000US48029131000,48029131000,"Census Tract 1310, Bexar County, Texas",5095,587,3022,378,2073,469
1400000US48029131100,48029131100,"Census Tract 1311, Bexar County, Texas",2529,533,1266,330,1263,466
1400000US48029131200,48029131200,"Census Tract 1312, Bexar County, Texas",3003,306,1649,291,1354,234
1400000US48029131300,48029131300,"Census Tract 1313, Bexar County, Texas",6193,966,3025,581,3168,961
1400000US48029131401,48029131401,"Census Tract 1314.01, Bexar County, Texas",7003,651,2627,545,4376,628
1400000US48029131402,48029131402,"Census Tract 1314.02, Bexar County, Texas",3059,347,1049,302,2010,479
1400000US48029131503,48029131503,"Census Tract 1315.03, Bexar County, Texas",3337,395,2180,442,1157,367
1400000US48029131504,48029131504,"Census Tract 1315.04, Bexar County, Texas",4109,454,2092,495,2017,400
1400000US48029131505,48029131505,"Census Tract 1315.05, Bexar County, Texas",3664,345,1801,412,1863,456
1400000US48029131506,48029131506,"Census Tract 1315.06, Bexar County, Texas",3199,482,1297,372,1902,422
1400000US48029131507,48029131507,"Census Tract 1315.07, Bexar County, Texas",6993,960,2384,428,4609,814
1400000US48029131601,48029131601,"Census Tract 1316.01, Bexar County, Texas",2216,323,1334,221,882,259
1400000US48029131606,48029131606,"Census Tract 1316.06, Bexar County, Texas",5004,399,3159,366,1845,450
1400000US48029131608,48029131608,"Census Tract 1316.08, Bexar County, Texas",4774,498,3003,459,1771,539
1400000US48029131609,48029131609,"Census Tract 1316.09, Bexar County, Texas",9254,943,4733,774,4521,959
1400000US48029131610,48029131610,"Census Tract 1316.10, Bexar County, Texas",5655,462,3686,415,1969,388
1400000US48029131611,48029131611,"Census Tract 1316.11, Bexar County, Texas",1580,241,1177,199,403,153
1400000US48029131612,48029131612,"Census Tract 1316.12, Bexar County, Texas",1922,529,1130,521,792,340
1400000US48029131613,48029131613,"Census Tract 1316.13, Bexar County, Texas",5306,460,2722,527,2584,566
1400000US48029131614,48029131614,"Census Tract 1316.14, Bexar County, Texas",3952,529,2432,524,1520,326
1400000US48029131615,48029131615,"Census Tract 1316.15, Bexar County, Texas",6794,656,3881,666,2913,620
1400000US48029131700,48029131700,"Census Tract 1317, Bexar County, Texas",1193,259,1119,255,74,56
1400000US48029131801,48029131801,"Census Tract 1318.01, Bexar County, Texas",2511,310,2142,322,369,145
1400000US48029131802,48029131802,"Census Tract 1318.02, Bexar County, Texas",5730,570,3936,500,1794,520
1400000US48029140100,48029140100,"Census Tract 1401, Bexar County, Texas",1772,287,192,80,1580,286
1400000US48029140200,48029140200,"Census Tract 1402, Bexar County, Texas",3117,354,346,184,2771,420
1400000US48029140300,48029140300,"Census Tract 1403, Bexar County, Texas",3391,392,233,175,3158,435
1400000US48029140400,48029140400,"Census Tract 1404, Bexar County, Texas",3916,452,389,156,3527,486
1400000US48029140500,48029140500,"Census Tract 1405, Bexar County, Texas",4043,346,478,155,3565,369
1400000US48029140600,48029140600,"Census Tract 1406, Bexar County, Texas",2382,357,284,96,2098,353
1400000US48029140700,48029140700,"Census Tract 1407, Bexar County, Texas",4532,434,965,345,3567,459
1400000US48029140800,48029140800,"Census Tract 1408, Bexar County, Texas",4936,456,689,174,4247,470
1400000US48029140900,48029140900,"Census Tract 1409, Bexar County, Texas",1750,302,207,41,1543,294
1400000US48029141000,48029141000,"Census Tract 1410, Bexar County, Texas",3275,509,427,121,2848,518
1400000US48029141101,48029141101,"Census Tract 1411.01, Bexar County, Texas",4313,560,1162,284,3151,640
1400000US48029141102,48029141102,"Census Tract 1411.02, Bexar County, Texas",3511,468,902,340,2609,434
1400000US48029141200,48029141200,"Census Tract 1412, Bexar County, Texas",7192,586,1095,296,6097,596
1400000US48029141300,48029141300,"Census Tract 1413, Bexar County, Texas",5537,620,1781,315,3756,611
1400000US48029141402,48029141402,"Census Tract 1414.02, Bexar County, Texas",4043,413,656,150,3387,421
1400000US48029141403,48029141403,"Census Tract 1414.03, Bexar County, Texas",3556,479,777,227,2779,497
1400000US48029141404,48029141404,"Census Tract 1414.04, Bexar County, Texas",4901,642,1533,289,3368,613
1400000US48029141600,48029141600,"Census Tract 1416, Bexar County, Texas",4602,427,565,216,4037,425
1400000US48029141700,48029141700,"Census Tract 1417, Bexar County, Texas",5209,530,1664,228,3545,492
1400000US48029141800,48029141800,"Census Tract 1418, Bexar County, Texas",4751,768,1477,289,3274,737
1400000US48029141900,48029141900,"Census Tract 1419, Bexar County, Texas",6091,766,3637,636,2454,658
1400000US48029150100,48029150100,"Census Tract 1501, Bexar County, Texas",5089,611,201,87,4888,599
1400000US48029150300,48029150300,"Census Tract 1503, Bexar County, Texas",4320,568,517,231,3803,560
1400000US48029150400,48029150400,"Census Tract 1504, Bexar County, Texas",4446,674,100,53,4346,688
1400000US48029150501,48029150501,"Census Tract 1505.01, Bexar County, Texas",4256,426,115,56,4141,416
1400000US48029150502,48029150502,"Census Tract 1505.02, Bexar County, Texas",4329,630,149,114,4180,666
1400000US48029150600,48029150600,"Census Tract 1506, Bexar County, Texas",4221,370,220,83,4001,379
1400000US48029150700,48029150700,"Census Tract 1507, Bexar County, Texas",6312,662,538,267,5774,666
1400000US48029150800,48029150800,"Census Tract 1508, Bexar County, Texas",2887,352,458,260,2429,442
1400000US48029150900,48029150900,"Census Tract 1509, Bexar County, Texas",5751,693,318,137,5433,709
1400000US48029151000,48029151000,"Census Tract 1510, Bexar County, Texas",3489,404,225,100,3264,401
1400000US48029151100,48029151100,"Census Tract 1511, Bexar County, Texas",7329,638,290,218,7039,701
1400000US48029151200,48029151200,"Census Tract 1512, Bexar County, Texas",9689,984,658,253,9031,992
1400000US48029151301,48029151301,"Census Tract 1513.01, Bexar County, Texas",6022,778,336,145,5686,781
1400000US48029151302,48029151302,"Census Tract 1513.02, Bexar County, Texas",3331,373,214,115,3117,362
1400000US48029151400,48029151400,"Census Tract 1514, Bexar County, Texas",4316,469,515,197,3801,446
1400000US48029151500,48029151500,"Census Tract 1515, Bexar County, Texas",2313,291,292,158,2021,295
1400000US48029151600,48029151600,"Census Tract 1516, Bexar County, Texas",7630,539,1280,254,6350,610
1400000US48029151700,48029151700,"Census Tract 1517, Bexar County, Texas",6518,780,763,249,5755,768
1400000US48029151900,48029151900,"Census Tract 1519, Bexar County, Texas",6190,732,199,82,5991,723
1400000US48029152000,48029152000,"Census Tract 1520, Bexar County, Texas",1610,324,211,84,1399,294
1400000US48029152100,48029152100,"Census Tract 1521, Bexar County, Texas",5571,689,1716,514,3855,618
1400000US48029152201,48029152201,"Census Tract 1522.01, Bexar County, Texas",8627,1226,2115,595,6512,1335
1400000US48029152202,48029152202,"Census Tract 1522.02, Bexar County, Texas",4386,1070,1097,501,3289,1192
1400000US48029160100,48029160100,"Census Tract 1601, Bexar County, Texas",5719,576,35,30,5684,576
1400000US48029160200,48029160200,"Census Tract 1602, Bexar County, Texas",2817,410,84,96,2733,421
1400000US48029160300,48029160300,"Census Tract 1603, Bexar County, Texas",5758,627,246,117,5512,619
1400000US48029160400,48029160400,"Census Tract 1604, Bexar County, Texas",4389,516,166,74,4223,482
1400000US48029160501,48029160501,"Census Tract 1605.01, Bexar County, Texas",4301,454,323,317,3978,463
1400000US48029160502,48029160502,"Census Tract 1605.02, Bexar County, Texas",4486,574,83,57,4403,582
1400000US48029160600,48029160600,"Census Tract 1606, Bexar County, Texas",5305,593,83,65,5222,591
1400000US48029160701,48029160701,"Census Tract 1607.01, Bexar County, Texas",3146,336,208,132,2938,325
1400000US48029160702,48029160702,"Census Tract 1607.02, Bexar County, Texas",5338,464,435,199,4903,518
1400000US48029160901,48029160901,"Census Tract 1609.01, Bexar County, Texas",3162,685,121,74,3041,673
1400000US48029160902,48029160902,"Census Tract 1609.02, Bexar County, Texas",4902,584,102,75,4800,569
1400000US48029161000,48029161000,"Census Tract 1610, Bexar County, Texas",3704,380,207,129,3497,422
1400000US48029161100,48029161100,"Census Tract 1611, Bexar County, Texas",9141,835,228,148,8913,859
1400000US48029161200,48029161200,"Census Tract 1612, Bexar County, Texas",2914,421,507,251,2407,446
1400000US48029161302,48029161302,"Census Tract 1613.02, Bexar County, Texas",6172,483,558,143,5614,505
1400000US48029161303,48029161303,"Census Tract 1613.03, Bexar County, Texas",5100,747,152,142,4948,798
1400000US48029161304,48029161304,"Census Tract 1613.04, Bexar County, Texas",4595,597,272,116,4323,598
1400000US48029161400,48029161400,"Census Tract 1614, Bexar County, Texas",8109,779,6669,696,1440,404
1400000US48029161501,48029161501,"Census Tract 1615.01, Bexar County, Texas",7332,705,1561,317,5771,690
1400000US48029161503,48029161503,"Census Tract 1615.03, Bexar County, Texas",3989,494,550,135,3439,472
1400000US48029161504,48029161504,"Census Tract 1615.04, Bexar County, Texas",4191,517,872,207,3319,566
1400000US48029161600,48029161600,"Census Tract 1616, Bexar County, Texas",4592,486,957,226,3635,497
1400000US48029161801,48029161801,"Census Tract 1618.01, Bexar County, Texas",3811,496,1288,304,2523,385
1400000US48029161802,48029161802,"Census Tract 1618.02, Bexar County, Texas",6919,803,1996,550,4923,687
1400000US48029161901,48029161901,"Census Tract 1619.01, Bexar County, Texas",1343,287,354,140,989,232
1400000US48029161902,48029161902,"Census Tract 1619.02, Bexar County, Texas",8707,601,2097,267,6610,613
1400000US48029162001,48029162001,"Census Tract 1620.01, Bexar County, Texas",2628,496,539,170,2089,495
1400000US48029162003,48029162003,"Census Tract 1620.03, Bexar County, Texas",5313,443,1496,409,3817,483
1400000US48029162004,48029162004,"Census Tract 1620.04, Bexar County, Texas",4023,393,792,301,3231,494
1400000US48029170101,48029170101,"Census Tract 1701.01, Bexar County, Texas",3841,468,103,47,3738,466
1400000US48029170102,48029170102,"Census Tract 1701.02, Bexar County, Texas",4217,519,39,37,4178,531
1400000US48029170200,48029170200,"Census Tract 1702, Bexar County, Texas",5619,523,99,54,5520,520
1400000US48029170300,48029170300,"Census Tract 1703, Bexar County, Texas",5888,681,349,128,5539,666
1400000US48029170401,48029170401,"Census Tract 1704.01, Bexar County, Texas",4088,458,153,85,3935,458
1400000US48029170402,48029170402,"Census Tract 1704.02, Bexar County, Texas",4275,511,167,112,4108,507
1400000US48029170500,48029170500,"Census Tract 1705, Bexar County, Texas",4527,499,423,146,4104,500
1400000US48029170600,48029170600,"Census Tract 1706, Bexar County, Texas",4352,426,738,189,3614,455
1400000US48029170700,48029170700,"Census Tract 1707, Bexar County, Texas",4493,603,427,220,4066,635
1400000US48029170800,48029170800,"Census Tract 1708, Bexar County, Texas",1448,245,23,21,1425,244
1400000US48029170900,48029170900,"Census Tract 1709, Bexar County, Texas",3931,512,340,121,3591,508
1400000US48029171000,48029171000,"Census Tract 1710, Bexar County, Texas",5192,682,404,222,4788,685
1400000US48029171100,48029171100,"Census Tract 1711, Bexar County, Texas",3475,444,427,322,3048,477
1400000US48029171200,48029171200,"Census Tract 1712, Bexar County, Texas",3996,617,201,197,3795,603
1400000US48029171301,48029171301,"Census Tract 1713.01, Bexar County, Texas",2702,415,46,46,2656,407
1400000US48029171302,48029171302,"Census Tract 1713.02, Bexar County, Texas",4276,532,992,326,3284,432
1400000US48029171401,48029171401,"Census Tract 1714.01, Bexar County, Texas",4195,711,287,130,3908,747
1400000US48029171402,48029171402,"Census Tract 1714.02, Bexar County, Texas",4652,676,339,259,4313,619
1400000US48029171501,48029171501,"Census Tract 1715.01, Bexar County, Texas",2297,269,459,334,1838,361
1400000US48029171502,48029171502,"Census Tract 1715.02, Bexar County, Texas",5627,666,765,368,4862,630
1400000US48029171601,48029171601,"Census Tract 1716.01, Bexar County, Texas",4289,655,719,307,3570,564
1400000US48029171602,48029171602,"Census Tract 1716.02, Bexar County, Texas",3584,455,435,185,3149,453
1400000US48029171700,48029171700,"Census Tract 1717, Bexar County, Texas",6877,693,1649,262,5228,746
1400000US48029171801,48029171801,"Census Tract 1718.01, Bexar County, Texas",4956,429,1009,236,3947,336
1400000US48029171802,48029171802,"Census Tract 1718.02, Bexar County, Texas",6129,676,957,238,5172,667
1400000US48029171902,48029171902,"Census Tract 1719.02, Bexar County, Texas",9079,798,2784,542,6295,791
1400000US48029171903,48029171903,"Census Tract 1719.03, Bexar County, Texas",6746,678,1313,375,5433,578
1400000US48029171912,48029171912,"Census Tract 1719.12, Bexar County, Texas",6069,388,2100,321,3969,448
1400000US48029171913,48029171913,"Census Tract 1719.13, Bexar County, Texas",5233,480,1317,220,3916,493
1400000US48029171914,48029171914,"Census Tract 1719.14, Bexar County, Texas",5814,530,1930,268,3884,560
1400000US48029171915,48029171915,"Census Tract 1719.15, Bexar County, Texas",2093,226,712,255,1381,293
1400000US48029171916,48029171916,"Census Tract 1719.16, Bexar County, Texas",7474,484,3071,376,4403,417
1400000US48029171917,48029171917,"Census Tract 1719.17, Bexar County, Texas",8981,901,3938,915,5043,669
1400000US48029171918,48029171918,"Census Tract 1719.18, Bexar County, Texas",5044,377,2123,367,2921,476
1400000US48029171919,48029171919,"Census Tract 1719.19, Bexar County, Texas",3498,530,1122,300,2376,526
1400000US48029171920,48029171920,"Census Tract 1719.20, Bexar County, Texas",8979,629,2519,513,6460,697
1400000US48029171921,48029171921,"Census Tract 1719.21, Bexar County, Texas",5914,554,1635,388,4279,585
1400000US48029171922,48029171922,"Census Tract 1719.22, Bexar County, Texas",3311,384,914,293,2397,355
1400000US48029171923,48029171923,"Census Tract 1719.23, Bexar County, Texas",7918,853,3236,702,4682,648
1400000US48029171924,48029171924,"Census Tract 1719.24, Bexar County, Texas",4635,433,2581,334,2054,418
1400000US48029171925,48029171925,"Census Tract 1719.25, Bexar County, Texas",9285,540,4079,461,5206,567
1400000US48029172002,48029172002,"Census Tract 1720.02, Bexar County, Texas",7979,707,3335,587,4644,652
1400000US48029172003,48029172003,"Census Tract 1720.03, Bexar County, Texas",6473,656,3735,1073,2738,634
1400000US48029172004,48029172004,"Census Tract 1720.04, Bexar County, Texas",3079,335,2165,256,914,316
1400000US48029172005,48029172005,"Census Tract 1720.05, Bexar County, Texas",2975,239,1645,311,1330,323
1400000US48029172006,48029172006,"Census Tract 1720.06, Bexar County, Texas",6227,670,3601,466,2626,442
1400000US48029172007,48029172007,"Census Tract 1720.07, Bexar County, Texas",9612,1101,4791,1065,4821,760
1400000US48029180101,48029180101,"Census Tract 1801.01, Bexar County, Texas",5339,561,739,191,4600,581
1400000US48029180102,48029180102,"Census Tract 1801.02, Bexar County, Texas",1888,206,504,131,1384,163
1400000US48029180201,48029180201,"Census Tract 1802.01, Bexar County, Texas",4628,539,1128,377,3500,611
1400000US48029180202,48029180202,"Census Tract 1802.02, Bexar County, Texas",5379,690,897,262,4482,711
1400000US48029180300,48029180300,"Census Tract 1803, Bexar County, Texas",3811,571,446,148,3365,540
1400000US48029180400,48029180400,"Census Tract 1804, Bexar County, Texas",3861,559,551,232,3310,533
1400000US48029180501,48029180501,"Census Tract 1805.01, Bexar County, Texas",4527,412,847,230,3680,464
1400000US48029180503,48029180503,"Census Tract 1805.03, Bexar County, Texas",4475,513,585,275,3890,487
1400000US48029180504,48029180504,"Census Tract 1805.04, Bexar County, Texas",4402,397,533,222,3869,376
1400000US48029180602,48029180602,"Census Tract 1806.02, Bexar County, Texas",2887,378,796,228,2091,403
1400000US48029180603,48029180603,"Census Tract 1806.03, Bexar County, Texas",1658,355,620,231,1038,344
1400000US48029180604,48029180604,"Census Tract 1806.04, Bexar County, Texas",6098,692,1727,485,4371,722
1400000US48029180701,48029180701,"Census Tract 1807.01, Bexar County, Texas",3984,464,2008,271,1976,415
1400000US48029180702,48029180702,"Census Tract 1807.02, Bexar County, Texas",6482,598,2611,433,3871,569
1400000US48029180800,48029180800,"Census Tract 1808, Bexar County, Texas",2652,191,902,206,1750,234
1400000US48029180901,48029180901,"Census Tract 1809.01, Bexar County, Texas",5377,563,1176,323,4201,538
1400000US48029180902,48029180902,"Census Tract 1809.02, Bexar County, Texas",8218,1023,1149,248,7069,1026
1400000US48029181001,48029181001,"Census Tract 1810.01, Bexar County, Texas",3604,417,1091,212,2513,388
1400000US48029181003,48029181003,"Census Tract 1810.03, Bexar County, Texas",6026,878,3337,644,2689,641
1400000US48029181004,48029181004,"Census Tract 1810.04, Bexar County, Texas",4599,500,2901,431,1698,380
1400000US48029181005,48029181005,"Census Tract 1810.05, Bexar County, Texas",3589,491,1338,340,2251,463
1400000US48029181100,48029181100,"Census Tract 1811, Bexar County, Texas",6249,447,2849,305,3400,499
1400000US48029181200,48029181200,"Census Tract 1812, Bexar County, Texas",4653,299,2971,252,1682,264
1400000US48029181301,48029181301,"Census Tract 1813.01, Bexar County, Texas",3976,492,2444,471,1532,321
1400000US48029181302,48029181302,"Census Tract 1813.02, Bexar County, Texas",5742,467,2577,449,3165,468
1400000US48029181303,48029181303,"Census Tract 1813.03, Bexar County, Texas",2974,520,1985,474,989,213
1400000US48029181402,48029181402,"Census Tract 1814.02, Bexar County, Texas",1877,261,1012,222,865,174
1400000US48029181403,48029181403,"Census Tract 1814.03, Bexar County, Texas",6128,685,2753,458,3375,650
1400000US48029181404,48029181404,"Census Tract 1814.04, Bexar County, Texas",4197,447,2873,465,1324,276
1400000US48029181503,48029181503,"Census Tract 1815.03, Bexar County, Texas",6833,480,3795,432,3038,527
1400000US48029181504,48029181504,"Census Tract 1815.04, Bexar County, Texas",5868,518,2711,478,3157,462
1400000US48029181505,48029181505,"Census Tract 1815.05, Bexar County, Texas",4619,387,2088,335,2531,472
1400000US48029181506,48029181506,"Census Tract 1815.06, Bexar County, Texas",4483,580,1862,279,2621,599
1400000US48029181601,48029181601,"Census Tract 1816.01, Bexar County, Texas",3119,245,638,147,2481,263
1400000US48029181602,48029181602,"Census Tract 1816.02, Bexar County, Texas",6081,609,1116,336,4965,680
1400000US48029181703,48029181703,"Census Tract 1817.03, Bexar County, Texas",6995,478,4164,621,2831,617
1400000US48029181704,48029181704,"Census Tract 1817.04, Bexar County, Texas",5947,545,2130,350,3817,572
1400000US48029181705,48029181705,"Census Tract 1817.05, Bexar County, Texas",4870,433,1849,354,3021,413
1400000US48029181711,48029181711,"Census Tract 1817.11, Bexar County, Texas",7750,551,3684,441,4066,412
1400000US48029181712,48029181712,"Census Tract 1817.12, Bexar County, Texas",3832,326,1757,291,2075,379
1400000US48029181713,48029181713,"Census Tract 1817.13, Bexar County, Texas",7531,677,2958,656,4573,756
1400000US48029181715,48029181715,"Census Tract 1817.15, Bexar County, Texas",6691,541,1900,390,4791,497
1400000US48029181716,48029181716,"Census Tract 1817.16, Bexar County, Texas",7063,595,2488,511,4575,522
1400000US48029181718,48029181718,"Census Tract 1817.18, Bexar County, Texas",4869,270,2724,309,2145,382
1400000US48029181720,48029181720,"Census Tract 1817.20, Bexar County, Texas",4139,311,2611,276,1528,236
1400000US48029181721,48029181721,"Census Tract 1817.21, Bexar County, Texas",3811,293,1761,333,2050,269
1400000US48029181722,48029181722,"Census Tract 1817.22, Bexar County, Texas",4529,475,2241,258,2288,425
1400000US48029181723,48029181723,"Census Tract 1817.23, Bexar County, Texas",5000,376,2179,334,2821,361
1400000US48029181724,48029181724,"Census Tract 1817.24, Bexar County, Texas",4851,670,2705,568,2146,720
1400000US48029181725,48029181725,"Census Tract 1817.25, Bexar County, Texas",5258,525,1928,434,3330,627
1400000US48029181726,48029181726,"Census Tract 1817.26, Bexar County, Texas",9458,437,4601,457,4857,450
1400000US48029181727,48029181727,"Census Tract 1817.27, Bexar County, Texas",3569,335,1131,340,2438,450
1400000US48029181728,48029181728,"Census Tract 1817.28, Bexar County, Texas",9724,863,3480,626,6244,897
1400000US48029181729,48029181729,"Census Tract 1817.29, Bexar County, Texas",3674,402,1646,274,2028,362
1400000US48029181730,48029181730,"Census Tract 1817.30, Bexar County, Texas",4464,614,1350,272,3114,619
1400000US48029181731,48029181731,"Census Tract 1817.31, Bexar County, Texas",6485,622,2707,462,3778,691
1400000US48029181808,48029181808,"Census Tract 1818.08, Bexar County, Texas",1283,198,773,143,510,159
1400000US48029181809,48029181809,"Census Tract 1818.09, Bexar County, Texas",6089,429,1949,314,4140,476
1400000US48029181811,48029181811,"Census Tract 1818.11, Bexar County, Texas",4166,255,2420,239,1746,274
1400000US48029181813,48029181813,"Census Tract 1818.13, Bexar County, Texas",5668,726,2926,622,2742,628
1400000US48029181814,48029181814,"Census Tract 1818.14, Bexar County, Texas",3056,314,1664,304,1392,293
1400000US48029181815,48029181815,"Census Tract 1818.15, Bexar County, Texas",3507,277,1904,299,1603,333
1400000US48029181816,48029181816,"Census Tract 1818.16, Bexar County, Texas",4332,362,1992,310,2340,410
1400000US48029181817,48029181817,"Census Tract 1818.17, Bexar County, Texas",3428,329,1363,371,2065,325
1400000US48029181818,48029181818,"Census Tract 1818.18, Bexar County, Texas",4817,441,2648,512,2169,434
1400000US48029181819,48029181819,"Census Tract 1818.19, Bexar County, Texas",5686,454,2725,381,2961,600
1400000US48029181820,48029181820,"Census Tract 1818.20, Bexar County, Texas",5364,516,3510,541,1854,405
1400000US48029181821,48029181821,"Census Tract 1818.21, Bexar County, Texas",3004,289,1509,279,1495,208
1400000US48029181822,48029181822,"Census Tract 1818.22, Bexar County, Texas",5162,299,2572,310,2590,307
1400000US48029181823,48029181823,"Census Tract 1818.23, Bexar County, Texas",2606,445,1413,257,1193,424
1400000US48029181824,48029181824,"Census Tract 1818.24, Bexar County, Texas",5318,468,2813,412,2505,346
1400000US48029181825,48029181825,"Census Tract 1818.25, Bexar County, Texas",3080,259,1904,252,1176,265
1400000US48029181826,48029181826,"Census Tract 1818.26, Bexar County, Texas",6673,392,3781,418,2892,429
1400000US48029181901,48029181901,"Census Tract 1819.01, Bexar County, Texas",3478,385,2357,363,1121,291
1400000US48029181902,48029181902,"Census Tract 1819.02, Bexar County, Texas",5755,416,4142,414,1613,276
1400000US48029182001,48029182001,"Census Tract 1820.01, Bexar County, Texas",5038,377,3444,380,1594,423
1400000US48029182002,48029182002,"Census Tract 1820.02, Bexar County, Texas",9261,435,6040,537,3221,558
1400000US48029182003,48029182003,"Census Tract 1820.03, Bexar County, Texas",3076,347,2098,350,978,283
1400000US48029182101,48029182101,"Census Tract 1821.01, Bexar County, Texas",6560,332,5586,333,974,198
1400000US48029182102,48029182102,"Census Tract 1821.02, Bexar County, Texas",6803,444,4821,400,1982,432
1400000US48029182103,48029182103,"Census Tract 1821.03, Bexar County, Texas",2093,310,1281,179,812,229
1400000US48029182105,48029182105,"Census Tract 1821.05, Bexar County, Texas",2091,246,1288,186,803,173
1400000US48029182106,48029182106,"Census Tract 1821.06, Bexar County, Texas",5900,503,3765,402,2135,344
1400000US48029190100,48029190100,"Census Tract 1901, Bexar County, Texas",3362,399,781,156,2581,433
1400000US48029190200,48029190200,"Census Tract 1902, Bexar County, Texas",4520,423,2262,338,2258,357
1400000US48029190400,48029190400,"Census Tract 1904, Bexar County, Texas",4133,327,3128,307,1005,209
1400000US48029190501,48029190501,"Census Tract 1905.01, Bexar County, Texas",2793,391,517,119,2276,410
1400000US48029190503,48029190503,"Census Tract 1905.03, Bexar County, Texas",3352,402,942,247,2410,493
1400000US48029190504,48029190504,"Census Tract 1905.04, Bexar County, Texas",2678,479,422,142,2256,470
1400000US48029190601,48029190601,"Census Tract 1906.01, Bexar County, Texas",3748,356,228,107,3520,366
1400000US48029190603,48029190603,"Census Tract 1906.03, Bexar County, Texas",3069,532,482,265,2587,555
1400000US48029190604,48029190604,"Census Tract 1906.04, Bexar County, Texas",4298,621,207,122,4091,640
1400000US48029190700,48029190700,"Census Tract 1907, Bexar County, Texas",2769,258,918,186,1851,240
1400000US48029190800,48029190800,"Census Tract 1908, Bexar County, Texas",2122,168,1840,192,282,98
1400000US48029190901,48029190901,"Census Tract 1909.01, Bexar County, Texas",5416,721,1821,363,3595,798
1400000US48029190902,48029190902,"Census Tract 1909.02, Bexar County, Texas",3799,351,1249,298,2550,411
1400000US48029191003,48029191003,"Census Tract 1910.03, Bexar County, Texas",7201,788,2331,639,4870,706
1400000US48029191004,48029191004,"Census Tract 1910.04, Bexar County, Texas",3999,533,738,175,3261,544
1400000US48029191005,48029191005,"Census Tract 1910.05, Bexar County, Texas",1981,427,273,123,1708,458
1400000US48029191006,48029191006,"Census Tract 1910.06, Bexar County, Texas",6676,905,909,532,5767,805
1400000US48029191101,48029191101,"Census Tract 1911.01, Bexar County, Texas",1543,102,968,134,575,108
1400000US48029191102,48029191102,"Census Tract 1911.02, Bexar County, Texas",2621,102,1742,226,879,213
1400000US48029191201,48029191201,"Census Tract 1912.01, Bexar County, Texas",3143,399,1523,352,1620,421
1400000US48029191202,48029191202,"Census Tract 1912.02, Bexar County, Texas",4897,618,2067,327,2830,571
1400000US48029191303,48029191303,"Census Tract 1913.03, Bexar County, Texas",1448,215,776,154,672,208
1400000US48029191304,48029191304,"Census Tract 1913.04, Bexar County, Texas",2615,649,765,177,1850,708
1400000US48029191405,48029191405,"Census Tract 1914.05, Bexar County, Texas",7924,494,5032,446,2892,477
1400000US48029191406,48029191406,"Census Tract 1914.06, Bexar County, Texas",6970,495,5336,517,1634,387
1400000US48029191408,48029191408,"Census Tract 1914.08, Bexar County, Texas",3003,335,1148,228,1855,369
1400000US48029191409,48029191409,"Census Tract 1914.09, Bexar County, Texas",6426,738,2274,434,4152,740
1400000US48029191410,48029191410,"Census Tract 1914.10, Bexar County, Texas",4922,501,2695,408,2227,448
1400000US48029191411,48029191411,"Census Tract 1914.11, Bexar County, Texas",4117,415,2801,360,1316,354
1400000US48029191412,48029191412,"Census Tract 1914.12, Bexar County, Texas",2113,177,1601,150,512,163
1400000US48029191413,48029191413,"Census Tract 1914.13, Bexar County, Texas",6260,470,4152,517,2108,527
1400000US48029191503,48029191503,"Census Tract 1915.03, Bexar County, Texas",4835,438,3477,444,1358,293
1400000US48029191504,48029191504,"Census Tract 1915.04, Bexar County, Texas",2550,134,1845,163,705,133
1400000US48029191505,48029191505,"Census Tract 1915.05, Bexar County, Texas",2222,193,1715,233,507,133
1400000US48029191506,48029191506,"Census Tract 1915.06, Bexar County, Texas",4353,621,2336,305,2017,568
1400000US48029191701,48029191701,"Census Tract 1917.01, Bexar County, Texas",1605,152,1274,149,331,118
1400000US48029191702,48029191702,"Census Tract 1917.02, Bexar County, Texas",7397,652,6065,655,1332,277
1400000US48029191804,48029191804,"Census Tract 1918.04, Bexar County, Texas",5892,449,4639,452,1253,291
1400000US48029191806,48029191806,"Census Tract 1918.06, Bexar County, Texas",8440,562,6703,542,1737,415
1400000US48029191807,48029191807,"Census Tract 1918.07, Bexar County, Texas",3779,419,2997,463,782,261
1400000US48029191808,48029191808,"Census Tract 1918.08, Bexar County, Texas",3591,329,2586,408,1005,348
1400000US48029191809,48029191809,"Census Tract 1918.09, Bexar County, Texas",5676,719,3880,562,1796,686
1400000US48029191810,48029191810,"Census Tract 1918.10, Bexar County, Texas",5250,523,3612,620,1638,730
1400000US48029191811,48029191811,"Census Tract 1918.11, Bexar County, Texas",3783,578,2691,582,1092,554
1400000US48029191812,48029191812,"Census Tract 1918.12, Bexar County, Texas",4518,508,3474,671,1044,646
1400000US48029191813,48029191813,"Census Tract 1918.13, Bexar County, Texas",6439,483,4063,501,2376,661
1400000US48029191814,48029191814,"Census Tract 1918.14, Bexar County, Texas",4083,537,2720,400,1363,416
1400000US48029191815,48029191815,"Census Tract 1918.15, Bexar County, Texas",5576,490,3619,364,1957,392
1400000US48029191816,48029191816,"Census Tract 1918.16, Bexar County, Texas",2411,279,1618,288,793,294
1400000US48029191817,48029191817,"Census Tract 1918.17, Bexar County, Texas",10315,693,7019,584,3296,513
1400000US48029191900,48029191900,"Census Tract 1919, Bexar County, Texas",4911,509,1361,345,3550,446
1400000US48029192000,48029192000,"Census Tract 1920, Bexar County, Texas",4846,1000,2416,484,2430,785
1400000US48029192100,48029192100,"Census Tract 1921, Bexar County, Texas",2162,181,974,186,1188,145
1400000US48029192200,48029192200,"Census Tract 1922, Bexar County, Texas",1591,264,520,168,1071,241
1400000US48029192300,48029192300,"Census Tract 1923, Bexar County, Texas",4437,333,3030,380,1407,331
1400000US48029980001,48029980001,"Census Tract 9800.01, Bexar County, Texas",0,13,0,13,0,13
1400000US48029980002,48029980002,"Census Tract 9800.02, Bexar County, Texas",0,13,0,13,0,13
1400000US48029980003,48029980003,"Census Tract 9800.03, Bexar County, Texas",1444,182,1060,176,384,155
1400000US48029980004,48029980004,"Census Tract 9800.04, Bexar County, Texas",0,13,0,13,0,13
1400000US48029980005,48029980005,"Census Tract 9800.05, Bexar County, Texas",0,13,0,13,0,13
1400000US48029980100,48029980100,"Census Tract 9801, Bexar County, Texas",482,136,395,135,87,59
1400000US48031950100,48031950100,"Census Tract 9501, Blanco County, Texas",4840,375,3995,352,845,260
1400000US48031950200,48031950200,"Census Tract 9502, Blanco County, Texas",5585,375,4480,352,1105,260
1400000US48033950100,48033950100,"Census Tract 9501, Borden County, Texas",642,110,556,106,86,61
1400000US48035950100,48035950100,"Census Tract 9501, Bosque County, Texas",4077,315,3374,316,703,172
1400000US48035950200,48035950200,"Census Tract 9502, Bosque County, Texas",1518,170,1094,154,424,111
1400000US48035950300,48035950300,"Census Tract 9503, Bosque County, Texas",1760,203,1631,208,129,77
1400000US48035950400,48035950400,"Census Tract 9504, Bosque County, Texas",3715,328,3397,344,318,141
1400000US48035950500,48035950500,"Census Tract 9505, Bosque County, Texas",2922,146,1985,290,937,266
1400000US48035950600,48035950600,"Census Tract 9506, Bosque County, Texas",1693,238,1663,236,30,32
1400000US48035950700,48035950700,"Census Tract 9507, Bosque County, Texas",2429,195,2052,222,377,144
1400000US48037010100,48037010100,"Census Tract 101, Bowie County, Texas",5493,612,5036,599,457,206
1400000US48037010400,48037010400,"Census Tract 104, Bowie County, Texas",4628,670,4537,679,91,89
1400000US48037010500,48037010500,"Census Tract 105, Bowie County, Texas",3232,464,2785,404,447,181
1400000US48037010600,48037010600,"Census Tract 106, Bowie County, Texas",2124,400,1988,391,136,109
1400000US48037010700,48037010700,"Census Tract 107, Bowie County, Texas",4647,541,4315,542,332,152
1400000US48037010800,48037010800,"Census Tract 108, Bowie County, Texas",4457,481,4106,512,351,252
1400000US48037010901,48037010901,"Census Tract 109.01, Bowie County, Texas",6369,648,6246,649,123,85
1400000US48037010902,48037010902,"Census Tract 109.02, Bowie County, Texas",6662,575,5987,578,675,261
1400000US48037011000,48037011000,"Census Tract 110, Bowie County, Texas",7848,495,7472,531,376,161
1400000US48037011100,48037011100,"Census Tract 111, Bowie County, Texas",7141,599,6500,564,641,139
1400000US48037011200,48037011200,"Census Tract 112, Bowie County, Texas",6057,398,5758,381,299,173
1400000US48037011300,48037011300,"Census Tract 113, Bowie County, Texas",5650,432,5220,503,430,276
1400000US48037011401,48037011401,"Census Tract 114.01, Bowie County, Texas",7615,744,7182,710,433,308
1400000US48037011402,48037011402,"Census Tract 114.02, Bowie County, Texas",2474,279,2398,269,76,60
1400000US48037011501,48037011501,"Census Tract 115.01, Bowie County, Texas",6285,571,5755,526,530,154
1400000US48037011502,48037011502,"Census Tract 115.02, Bowie County, Texas",3216,433,3037,436,179,239
1400000US48037011600,48037011600,"Census Tract 116, Bowie County, Texas",5771,509,5452,494,319,142
1400000US48037011700,48037011700,"Census Tract 117, Bowie County, Texas",2791,316,2583,309,208,137
1400000US48039660100,48039660100,"Census Tract 6601, Brazoria County, Texas",4726,411,3921,365,805,227
1400000US48039660200,48039660200,"Census Tract 6602, Brazoria County, Texas",5826,592,4625,525,1201,558
1400000US48039660300,48039660300,"Census Tract 6603, Brazoria County, Texas",9819,585,7504,603,2315,741
1400000US48039660400,48039660400,"Census Tract 6604, Brazoria County, Texas",8924,542,6878,579,2046,351
1400000US48039660500,48039660500,"Census Tract 6605, Brazoria County, Texas",8298,790,5591,693,2707,623
1400000US48039660601,48039660601,"Census Tract 6606.01, Brazoria County, Texas",12120,800,10923,832,1197,427
1400000US48039660602,48039660602,"Census Tract 6606.02, Brazoria County, Texas",27406,1400,20806,1434,6600,1367
1400000US48039660701,48039660701,"Census Tract 6607.01, Brazoria County, Texas",15525,905,13731,1044,1794,476
1400000US48039660702,48039660702,"Census Tract 6607.02, Brazoria County, Texas",11862,603,9398,740,2464,640
1400000US48039660801,48039660801,"Census Tract 6608.01, Brazoria County, Texas",8893,646,6012,398,2881,593
1400000US48039660802,48039660802,"Census Tract 6608.02, Brazoria County, Texas",7582,630,5433,563,2149,544
1400000US48039660900,48039660900,"Census Tract 6609, Brazoria County, Texas",6386,765,2984,569,3402,818
1400000US48039661000,48039661000,"Census Tract 6610, Brazoria County, Texas",7372,902,4276,444,3096,822
1400000US48039661100,48039661100,"Census Tract 6611, Brazoria County, Texas",3098,426,1921,367,1177,366
1400000US48039661200,48039661200,"Census Tract 6612, Brazoria County, Texas",3783,382,2801,381,982,272
1400000US48039661300,48039661300,"Census Tract 6613, Brazoria County, Texas",2326,294,1209,261,1117,280
1400000US48039661400,48039661400,"Census Tract 6614, Brazoria County, Texas",6588,710,4549,534,2039,516
1400000US48039661501,48039661501,"Census Tract 6615.01, Brazoria County, Texas",5242,601,3210,382,2032,539
1400000US48039661502,48039661502,"Census Tract 6615.02, Brazoria County, Texas",4534,328,3554,351,980,240
1400000US48039661601,48039661601,"Census Tract 6616.01, Brazoria County, Texas",6107,760,4151,525,1956,556
1400000US48039661602,48039661602,"Census Tract 6616.02, Brazoria County, Texas",3910,625,2114,331,1796,650
1400000US48039661700,48039661700,"Census Tract 6617, Brazoria County, Texas",2480,342,2065,301,415,266
1400000US48039661800,48039661800,"Census Tract 6618, Brazoria County, Texas",6560,722,4238,505,2322,733
1400000US48039661900,48039661900,"Census Tract 6619, Brazoria County, Texas",12488,767,8030,575,4458,640
1400000US48039662000,48039662000,"Census Tract 6620, Brazoria County, Texas",6316,601,4894,519,1422,444
1400000US48039662100,48039662100,"Census Tract 6621, Brazoria County, Texas",5080,484,3288,449,1792,346
1400000US48039662200,48039662200,"Census Tract 6622, Brazoria County, Texas",6352,557,4549,556,1803,349
1400000US48039662300,48039662300,"Census Tract 6623, Brazoria County, Texas",4359,390,3279,438,1080,346
1400000US48039662400,48039662400,"Census Tract 6624, Brazoria County, Texas",6093,438,4606,365,1487,387
1400000US48039662500,48039662500,"Census Tract 6625, Brazoria County, Texas",2654,244,1855,242,799,122
1400000US48039662600,48039662600,"Census Tract 6626, Brazoria County, Texas",3004,402,2468,359,536,235
1400000US48039662700,48039662700,"Census Tract 6627, Brazoria County, Texas",2478,335,2123,341,355,207
1400000US48039662800,48039662800,"Census Tract 6628, Brazoria County, Texas",6175,506,5002,648,1173,417
1400000US48039662900,48039662900,"Census Tract 6629, Brazoria County, Texas",4561,405,3734,417,827,268
1400000US48039663000,48039663000,"Census Tract 6630, Brazoria County, Texas",3986,352,3184,341,802,220
1400000US48039663100,48039663100,"Census Tract 6631, Brazoria County, Texas",5996,568,5011,472,985,326
1400000US48039663200,48039663200,"Census Tract 6632, Brazoria County, Texas",4838,420,3870,432,968,280
1400000US48039663300,48039663300,"Census Tract 6633, Brazoria County, Texas",2407,311,1469,204,938,286
1400000US48039663400,48039663400,"Census Tract 6634, Brazoria County, Texas",6662,534,5622,593,1040,387
1400000US48039663500,48039663500,"Census Tract 6635, Brazoria County, Texas",6128,490,4739,744,1389,579
1400000US48039663600,48039663600,"Census Tract 6636, Brazoria County, Texas",4966,442,4246,456,720,186
1400000US48039663700,48039663700,"Census Tract 6637, Brazoria County, Texas",3505,146,2565,234,940,193
1400000US48039663800,48039663800,"Census Tract 6638, Brazoria County, Texas",5647,415,3212,434,2435,469
1400000US48039663900,48039663900,"Census Tract 6639, Brazoria County, Texas",2225,204,994,159,1231,210
1400000US48039664000,48039664000,"Census Tract 6640, Brazoria County, Texas",4122,428,2186,355,1936,420
1400000US48039664100,48039664100,"Census Tract 6641, Brazoria County, Texas",5493,642,3199,444,2294,649
1400000US48039664200,48039664200,"Census Tract 6642, Brazoria County, Texas",1990,241,1628,219,362,137
1400000US48039664300,48039664300,"Census Tract 6643, Brazoria County, Texas",5559,581,2082,422,3477,636
1400000US48039664400,48039664400,"Census Tract 6644, Brazoria County, Texas",6483,586,3158,740,3325,701
1400000US48039664501,48039664501,"Census Tract 6645.01, Brazoria County, Texas",4879,605,3884,511,995,338
1400000US48039990000,48039990000,"Census Tract 9900, Brazoria County, Texas",0,13,0,13,0,13
1400000US48041000101,48041000101,"Census Tract 1.01, Brazos County, Texas",7914,714,6027,570,1887,788
1400000US48041000102,48041000102,"Census Tract 1.02, Brazos County, Texas",6388,518,5629,546,759,261
1400000US48041000103,48041000103,"Census Tract 1.03, Brazos County, Texas",1496,281,1454,304,42,61
1400000US48041000201,48041000201,"Census Tract 2.01, Brazos County, Texas",5880,521,4609,582,1271,432
1400000US48041000202,48041000202,"Census Tract 2.02, Brazos County, Texas",7164,686,4698,520,2466,471
1400000US48041000300,48041000300,"Census Tract 3, Brazos County, Texas",7544,803,3833,742,3711,955
1400000US48041000400,48041000400,"Census Tract 4, Brazos County, Texas",4906,493,3337,443,1569,283
1400000US48041000500,48041000500,"Census Tract 5, Brazos County, Texas",6141,657,3150,446,2991,540
1400000US48041000603,48041000603,"Census Tract 6.03, Brazos County, Texas",5288,765,1730,413,3558,694
1400000US48041000604,48041000604,"Census Tract 6.04, Brazos County, Texas",5749,736,1623,519,4126,655
1400000US48041000700,48041000700,"Census Tract 7, Brazos County, Texas",2535,261,1359,217,1176,218
1400000US48041000800,48041000800,"Census Tract 8, Brazos County, Texas",5271,455,3761,421,1510,431
1400000US48041000900,48041000900,"Census Tract 9, Brazos County, Texas",2890,446,1633,540,1257,411
1400000US48041001000,48041001000,"Census Tract 10, Brazos County, Texas",7671,767,5719,686,1952,649
1400000US48041001100,48041001100,"Census Tract 11, Brazos County, Texas",4467,521,3716,541,751,246
1400000US48041001301,48041001301,"Census Tract 13.01, Brazos County, Texas",2837,225,2343,243,494,214
1400000US48041001302,48041001302,"Census Tract 13.02, Brazos County, Texas",4038,371,3540,364,498,174
1400000US48041001303,48041001303,"Census Tract 13.03, Brazos County, Texas",5668,667,4253,499,1415,551
1400000US48041001400,48041001400,"Census Tract 14, Brazos County, Texas",3485,703,3242,711,243,147
1400000US48041001601,48041001601,"Census Tract 16.01, Brazos County, Texas",5495,666,5142,633,353,178
1400000US48041001604,48041001604,"Census Tract 16.04, Brazos County, Texas",4766,587,4123,605,643,296
1400000US48041001605,48041001605,"Census Tract 16.05, Brazos County, Texas",3629,377,2889,483,740,305
1400000US48041001606,48041001606,"Census Tract 16.06, Brazos County, Texas",3010,353,2269,348,741,407
1400000US48041001701,48041001701,"Census Tract 17.01, Brazos County, Texas",4515,526,3818,510,697,232
1400000US48041001702,48041001702,"Census Tract 17.02, Brazos County, Texas",2322,438,1872,412,450,276
1400000US48041001801,48041001801,"Census Tract 18.01, Brazos County, Texas",4532,607,3780,526,752,336
1400000US48041001803,48041001803,"Census Tract 18.03, Brazos County, Texas",6674,485,6125,555,549,292
1400000US48041001804,48041001804,"Census Tract 18.04, Brazos County, Texas",1258,298,1101,268,157,101
1400000US48041001900,48041001900,"Census Tract 19, Brazos County, Texas",5179,473,4544,458,635,238
1400000US48041002001,48041002001,"Census Tract 20.01, Brazos County, Texas",4354,242,3988,280,366,141
1400000US48041002002,48041002002,"Census Tract 20.02, Brazos County, Texas",5937,440,5414,477,523,173
1400000US48041002006,48041002006,"Census Tract 20.06, Brazos County, Texas",1557,210,1287,171,270,131
1400000US48041002007,48041002007,"Census Tract 20.07, Brazos County, Texas",6182,595,5329,675,853,383
1400000US48041002008,48041002008,"Census Tract 20.08, Brazos County, Texas",6094,475,5404,483,690,335
1400000US48041002009,48041002009,"Census Tract 20.09, Brazos County, Texas",4372,315,3931,407,441,304
1400000US48041002010,48041002010,"Census Tract 20.10, Brazos County, Texas",2595,333,2115,297,480,279
1400000US48041002011,48041002011,"Census Tract 20.11, Brazos County, Texas",2472,269,2192,317,280,172
1400000US48041002012,48041002012,"Census Tract 20.12, Brazos County, Texas",5445,713,4407,615,1038,376
1400000US48041002013,48041002013,"Census Tract 20.13, Brazos County, Texas",4834,633,3935,509,899,445
1400000US48041002014,48041002014,"Census Tract 20.14, Brazos County, Texas",1203,229,1106,223,97,117
1400000US48041002015,48041002015,"Census Tract 20.15, Brazos County, Texas",10314,651,8487,554,1827,236
1400000US48041980000,48041980000,"Census Tract 9800, Brazos County, Texas",16,10,10,14,6,11
1400000US48043950300,48043950300,"Census Tract 9503, Brewster County, Texas",4072,341,2607,237,1465,295
1400000US48043950400,48043950400,"Census Tract 9504, Brewster County, Texas",1854,287,333,135,1521,282
1400000US48043950500,48043950500,"Census Tract 9505, Brewster County, Texas",3249,272,2292,236,957,249
1400000US48045950200,48045950200,"Census Tract 9502, Briscoe County, Texas",1674,112,1230,105,444,96
1400000US48047950100,48047950100,"Census Tract 9501, Brooks County, Texas",2269,343,127,75,2142,343
1400000US48047950200,48047950200,"Census Tract 9502, Brooks County, Texas",4967,343,473,146,4494,384
1400000US48049950100,48049950100,"Census Tract 9501, Brown County, Texas",2059,289,1900,292,159,104
1400000US48049950200,48049950200,"Census Tract 9502, Brown County, Texas",3913,394,3362,388,551,264
1400000US48049950300,48049950300,"Census Tract 9503, Brown County, Texas",3405,376,3096,361,309,150
1400000US48049950500,48049950500,"Census Tract 9505, Brown County, Texas",3309,369,2710,366,599,196
1400000US48049950600,48049950600,"Census Tract 9506, Brown County, Texas",2592,284,1810,286,782,311
1400000US48049950700,48049950700,"Census Tract 9507, Brown County, Texas",1550,247,915,207,635,159
1400000US48049950800,48049950800,"Census Tract 9508, Brown County, Texas",2500,340,1757,351,743,234
1400000US48049950900,48049950900,"Census Tract 9509, Brown County, Texas",4727,397,3746,420,981,239
1400000US48049951000,48049951000,"Census Tract 9510, Brown County, Texas",2125,282,1651,292,474,152
1400000US48049951100,48049951100,"Census Tract 9511, Brown County, Texas",4278,388,3510,381,768,165
1400000US48049951200,48049951200,"Census Tract 9512, Brown County, Texas",4250,364,3630,335,620,251
1400000US48049951300,48049951300,"Census Tract 9513, Brown County, Texas",3310,456,2426,432,884,310
1400000US48051970100,48051970100,"Census Tract 9701, Burleson County, Texas",1509,380,1171,393,338,268
1400000US48051970200,48051970200,"Census Tract 9702, Burleson County, Texas",4699,633,3735,443,964,543
1400000US48051970300,48051970300,"Census Tract 9703, Burleson County, Texas",4070,211,3156,314,914,300
1400000US48051970400,48051970400,"Census Tract 9704, Burleson County, Texas",3112,380,2779,340,333,236
1400000US48051970500,48051970500,"Census Tract 9705, Burleson County, Texas",3770,537,3143,432,627,328
1400000US48053960100,48053960100,"Census Tract 9601, Burnet County, Texas",5741,473,4465,503,1276,319
1400000US48053960200,48053960200,"Census Tract 9602, Burnet County, Texas",2720,432,2483,362,237,230
1400000US48053960300,48053960300,"Census Tract 9603, Burnet County, Texas",6751,373,5465,509,1286,365
1400000US48053960400,48053960400,"Census Tract 9604, Burnet County, Texas",5389,569,4459,525,930,347
1400000US48053960500,48053960500,"Census Tract 9605, Burnet County, Texas",6040,312,3945,418,2095,380
1400000US48053960600,48053960600,"Census Tract 9606, Burnet County, Texas",3652,279,3485,284,167,144
1400000US48053960700,48053960700,"Census Tract 9607, Burnet County, Texas",6683,287,4600,586,2083,492
1400000US48053960800,48053960800,"Census Tract 9608, Burnet County, Texas",5970,661,5396,633,574,195
1400000US48055960101,48055960101,"Census Tract 9601.01, Caldwell County, Texas",5922,860,2496,337,3426,719
1400000US48055960102,48055960102,"Census Tract 9601.02, Caldwell County, Texas",3498,580,2655,332,843,489
1400000US48055960200,48055960200,"Census Tract 9602, Caldwell County, Texas",5312,380,2592,346,2720,363
1400000US48055960300,48055960300,"Census Tract 9603, Caldwell County, Texas",4270,414,2440,357,1830,427
1400000US48055960400,48055960400,"Census Tract 9604, Caldwell County, Texas",3427,419,1373,231,2054,377
1400000US48055960500,48055960500,"Census Tract 9605, Caldwell County, Texas",7613,674,3390,449,4223,555
1400000US48055960600,48055960600,"Census Tract 9606, Caldwell County, Texas",2397,366,2017,319,380,158
1400000US48055960700,48055960700,"Census Tract 9607, Caldwell County, Texas",5713,209,3148,400,2565,410
1400000US48057000100,48057000100,"Census Tract 1, Calhoun County, Texas",5438,441,3196,395,2242,368
1400000US48057000200,48057000200,"Census Tract 2, Calhoun County, Texas",4248,500,1135,251,3113,465
1400000US48057000300,48057000300,"Census Tract 3, Calhoun County, Texas",1382,249,1070,219,312,155
1400000US48057000400,48057000400,"Census Tract 4, Calhoun County, Texas",7016,599,3590,452,3426,515
1400000US48057000500,48057000500,"Census Tract 5, Calhoun County, Texas",3282,484,2416,403,866,388
1400000US48057990000,48057990000,"Census Tract 9900, Calhoun County, Texas",0,13,0,13,0,13
1400000US48059030101,48059030101,"Census Tract 301.01, Callahan County, Texas",4865,342,4551,348,314,144
1400000US48059030102,48059030102,"Census Tract 301.02, Callahan County, Texas",4396,333,4019,348,377,143
1400000US48059030200,48059030200,"Census Tract 302, Callahan County, Texas",4260,306,3862,302,398,140
1400000US48061010100,48061010100,"Census Tract 101, Cameron County, Texas",7363,866,1214,304,6149,837
1400000US48061010201,48061010201,"Census Tract 102.01, Cameron County, Texas",1966,451,234,175,1732,424
1400000US48061010203,48061010203,"Census Tract 102.03, Cameron County, Texas",7645,725,1645,329,6000,712
1400000US48061010301,48061010301,"Census Tract 103.01, Cameron County, Texas",5180,590,650,300,4530,555
1400000US48061010302,48061010302,"Census Tract 103.02, Cameron County, Texas",7776,818,2314,602,5462,684
1400000US48061010401,48061010401,"Census Tract 104.01, Cameron County, Texas",5657,513,511,156,5146,486
1400000US48061010402,48061010402,"Census Tract 104.02, Cameron County, Texas",6574,1079,1913,313,4661,1106
1400000US48061010500,48061010500,"Census Tract 105, Cameron County, Texas",2641,393,85,65,2556,401
1400000US48061010601,48061010601,"Census Tract 106.01, Cameron County, Texas",8290,660,1185,362,7105,704
1400000US48061010602,48061010602,"Census Tract 106.02, Cameron County, Texas",1764,207,709,207,1055,264
1400000US48061010700,48061010700,"Census Tract 107, Cameron County, Texas",2735,403,648,169,2087,378
1400000US48061010800,48061010800,"Census Tract 108, Cameron County, Texas",7069,674,1928,378,5141,692
1400000US48061010900,48061010900,"Census Tract 109, Cameron County, Texas",1386,234,173,89,1213,236
1400000US48061011000,48061011000,"Census Tract 110, Cameron County, Texas",3206,568,31,28,3175,569
1400000US48061011100,48061011100,"Census Tract 111, Cameron County, Texas",2311,389,44,33,2267,393
1400000US48061011200,48061011200,"Census Tract 112, Cameron County, Texas",1980,564,218,117,1762,573
1400000US48061011301,48061011301,"Census Tract 113.01, Cameron County, Texas",1818,322,686,123,1132,323
1400000US48061011302,48061011302,"Census Tract 113.02, Cameron County, Texas",4176,497,1838,391,2338,454
1400000US48061011400,48061011400,"Census Tract 114, Cameron County, Texas",7286,1116,634,152,6652,1145
1400000US48061011500,48061011500,"Census Tract 115, Cameron County, Texas",5393,535,233,96,5160,540
1400000US48061011600,48061011600,"Census Tract 116, Cameron County, Texas",6249,548,136,103,6113,564
1400000US48061011700,48061011700,"Census Tract 117, Cameron County, Texas",6821,692,244,124,6577,722
1400000US48061011801,48061011801,"Census Tract 118.01, Cameron County, Texas",5408,573,957,251,4451,592
1400000US48061011802,48061011802,"Census Tract 118.02, Cameron County, Texas",4209,497,252,105,3957,508
1400000US48061011901,48061011901,"Census Tract 119.01, Cameron County, Texas",6245,584,930,244,5315,621
1400000US48061011902,48061011902,"Census Tract 119.02, Cameron County, Texas",4369,889,905,252,3464,933
1400000US48061011903,48061011903,"Census Tract 119.03, Cameron County, Texas",2650,396,147,67,2503,400
1400000US48061012001,48061012001,"Census Tract 120.01, Cameron County, Texas",5699,639,1985,366,3714,592
1400000US48061012002,48061012002,"Census Tract 120.02, Cameron County, Texas",6344,869,1448,718,4896,678
1400000US48061012101,48061012101,"Census Tract 121.01, Cameron County, Texas",4935,644,1613,463,3322,574
1400000US48061012102,48061012102,"Census Tract 121.02, Cameron County, Texas",5920,791,204,131,5716,780
1400000US48061012200,48061012200,"Census Tract 122, Cameron County, Texas",12249,1168,1162,646,11087,1203
1400000US48061012301,48061012301,"Census Tract 123.01, Cameron County, Texas",4542,408,2248,342,2294,468
1400000US48061012304,48061012304,"Census Tract 123.04, Cameron County, Texas",4869,130,1092,246,3777,246
1400000US48061012305,48061012305,"Census Tract 123.05, Cameron County, Texas",3304,209,2712,336,592,269
1400000US48061012401,48061012401,"Census Tract 124.01, Cameron County, Texas",6277,588,570,221,5707,612
1400000US48061012402,48061012402,"Census Tract 124.02, Cameron County, Texas",4909,449,808,338,4101,429
1400000US48061012504,48061012504,"Census Tract 125.04, Cameron County, Texas",16078,992,1023,303,15055,1045
1400000US48061012505,48061012505,"Census Tract 125.05, Cameron County, Texas",9675,979,305,221,9370,982
1400000US48061012506,48061012506,"Census Tract 125.06, Cameron County, Texas",3660,452,1040,190,2620,427
1400000US48061012507,48061012507,"Census Tract 125.07, Cameron County, Texas",6319,763,322,157,5997,787
1400000US48061012508,48061012508,"Census Tract 125.08, Cameron County, Texas",2889,585,501,234,2388,542
1400000US48061012607,48061012607,"Census Tract 126.07, Cameron County, Texas",2764,430,6,10,2758,430
1400000US48061012608,48061012608,"Census Tract 126.08, Cameron County, Texas",4300,455,525,198,3775,449
1400000US48061012609,48061012609,"Census Tract 126.09, Cameron County, Texas",8828,893,259,271,8569,928
1400000US48061012612,48061012612,"Census Tract 126.12, Cameron County, Texas",6147,413,535,208,5612,404
1400000US48061012613,48061012613,"Census Tract 126.13, Cameron County, Texas",4874,554,647,206,4227,539
1400000US48061012700,48061012700,"Census Tract 127, Cameron County, Texas",5628,545,535,340,5093,588
1400000US48061012800,48061012800,"Census Tract 128, Cameron County, Texas",4624,424,102,99,4522,426
1400000US48061012900,48061012900,"Census Tract 129, Cameron County, Texas",4256,497,590,170,3666,502
1400000US48061013002,48061013002,"Census Tract 130.02, Cameron County, Texas",4406,503,532,185,3874,465
1400000US48061013003,48061013003,"Census Tract 130.03, Cameron County, Texas",2021,255,51,33,1970,250
1400000US48061013004,48061013004,"Census Tract 130.04, Cameron County, Texas",2961,370,285,96,2676,371
1400000US48061013102,48061013102,"Census Tract 131.02, Cameron County, Texas",3420,314,322,93,3098,297
1400000US48061013104,48061013104,"Census Tract 131.04, Cameron County, Texas",3973,359,329,111,3644,412
1400000US48061013106,48061013106,"Census Tract 131.06, Cameron County, Texas",4129,691,126,91,4003,702
1400000US48061013203,48061013203,"Census Tract 132.03, Cameron County, Texas",2046,507,86,53,1960,522
1400000US48061013204,48061013204,"Census Tract 132.04, Cameron County, Texas",2044,434,119,76,1925,418
1400000US48061013205,48061013205,"Census Tract 132.05, Cameron County, Texas",3734,490,100,64,3634,497
1400000US48061013206,48061013206,"Census Tract 132.06, Cameron County, Texas",3397,636,61,55,3336,629
1400000US48061013207,48061013207,"Census Tract 132.07, Cameron County, Texas",4535,712,278,128,4257,728
1400000US48061013303,48061013303,"Census Tract 133.03, Cameron County, Texas",4285,440,267,147,4018,424
1400000US48061013305,48061013305,"Census Tract 133.05, Cameron County, Texas",4253,608,67,62,4186,611
1400000US48061013306,48061013306,"Census Tract 133.06, Cameron County, Texas",3043,409,0,13,3043,409
1400000US48061013307,48061013307,"Census Tract 133.07, Cameron County, Texas",1679,275,21,33,1658,281
1400000US48061013308,48061013308,"Census Tract 133.08, Cameron County, Texas",3110,373,74,57,3036,364
1400000US48061013309,48061013309,"Census Tract 133.09, Cameron County, Texas",3437,372,38,49,3399,383
1400000US48061013401,48061013401,"Census Tract 134.01, Cameron County, Texas",2242,373,97,94,2145,384
1400000US48061013402,48061013402,"Census Tract 134.02, Cameron County, Texas",1790,296,15,22,1775,295
1400000US48061013500,48061013500,"Census Tract 135, Cameron County, Texas",2578,210,364,126,2214,218
1400000US48061013600,48061013600,"Census Tract 136, Cameron County, Texas",3314,397,330,172,2984,406
1400000US48061013700,48061013700,"Census Tract 137, Cameron County, Texas",3760,546,194,171,3566,585
1400000US48061013801,48061013801,"Census Tract 138.01, Cameron County, Texas",3075,425,113,72,2962,416
1400000US48061013802,48061013802,"Census Tract 138.02, Cameron County, Texas",3551,441,120,124,3431,416
1400000US48061013901,48061013901,"Census Tract 139.01, Cameron County, Texas",3238,382,16,25,3222,382
1400000US48061013902,48061013902,"Census Tract 139.02, Cameron County, Texas",4250,568,70,71,4180,560
1400000US48061013903,48061013903,"Census Tract 139.03, Cameron County, Texas",4885,543,89,152,4796,571
1400000US48061014001,48061014001,"Census Tract 140.01, Cameron County, Texas",1967,353,253,103,1714,344
1400000US48061014002,48061014002,"Census Tract 140.02, Cameron County, Texas",2716,379,28,22,2688,374
1400000US48061014100,48061014100,"Census Tract 141, Cameron County, Texas",11820,1103,342,193,11478,1075
1400000US48061014200,48061014200,"Census Tract 142, Cameron County, Texas",5042,727,543,239,4499,752
1400000US48061014300,48061014300,"Census Tract 143, Cameron County, Texas",4322,429,184,72,4138,437
1400000US48061014400,48061014400,"Census Tract 144, Cameron County, Texas",14296,1119,1265,329,13031,1110
1400000US48061014500,48061014500,"Census Tract 145, Cameron County, Texas",9243,688,1170,291,8073,727
1400000US48061980001,48061980001,"Census Tract 9800.01, Cameron County, Texas",0,13,0,13,0,13
1400000US48061980100,48061980100,"Census Tract 9801, Cameron County, Texas",0,13,0,13,0,13
1400000US48061990000,48061990000,"Census Tract 9900, Cameron County, Texas",0,13,0,13,0,13
1400000US48063950101,48063950101,"Census Tract 9501.01, Camp County, Texas",3330,446,2900,411,430,219
1400000US48063950102,48063950102,"Census Tract 9501.02, Camp County, Texas",4171,449,3624,441,547,322
1400000US48063950200,48063950200,"Census Tract 9502, Camp County, Texas",4888,150,3246,285,1642,295
1400000US48065950100,48065950100,"Census Tract 9501, Carson County, Texas",2419,180,2317,184,102,58
1400000US48065950200,48065950200,"Census Tract 9502, Carson County, Texas",3796,180,3347,184,449,58
1400000US48067950100,48067950100,"Census Tract 9501, Cass County, Texas",6206,458,5977,468,229,159
1400000US48067950200,48067950200,"Census Tract 9502, Cass County, Texas",2756,349,2733,347,23,28
1400000US48067950300,48067950300,"Census Tract 9503, Cass County, Texas",1887,261,1868,259,19,31
1400000US48067950400,48067950400,"Census Tract 9504, Cass County, Texas",5233,189,5137,220,96,113
1400000US48067950500,48067950500,"Census Tract 9505, Cass County, Texas",2838,320,2774,320,64,54
1400000US48067950600,48067950600,"Census Tract 9506, Cass County, Texas",6363,449,5944,453,419,136
1400000US48067950700,48067950700,"Census Tract 9507, Cass County, Texas",5041,397,4806,412,235,133
1400000US48069950100,48069950100,"Census Tract 9501, Castro County, Texas",1394,197,1081,197,313,153
1400000US48069950200,48069950200,"Census Tract 9502, Castro County, Texas",4348,17,1369,177,2979,178
1400000US48069950300,48069950300,"Census Tract 9503, Castro County, Texas",2242,196,779,172,1463,201
1400000US48071710100,48071710100,"Census Tract 7101, Chambers County, Texas",7042,509,6286,452,756,264
1400000US48071710200,48071710200,"Census Tract 7102, Chambers County, Texas",16798,661,13025,585,3773,399
1400000US48071710300,48071710300,"Census Tract 7103, Chambers County, Texas",2249,438,1920,386,329,225
1400000US48071710401,48071710401,"Census Tract 7104.01, Chambers County, Texas",5281,638,4176,565,1105,340
1400000US48071710500,48071710500,"Census Tract 7105, Chambers County, Texas",3192,493,2477,321,715,365
1400000US48071710600,48071710600,"Census Tract 7106, Chambers County, Texas",0,13,0,13,0,13
1400000US48071990000,48071990000,"Census Tract 9900, Chambers County, Texas",0,13,0,13,0,13
1400000US48073950100,48073950100,"Census Tract 9501, Cherokee County, Texas",4207,341,2979,254,1228,247
1400000US48073950200,48073950200,"Census Tract 9502, Cherokee County, Texas",5317,569,5164,535,153,149
1400000US48073950300,48073950300,"Census Tract 9503, Cherokee County, Texas",7261,810,5258,717,2003,690
1400000US48073950400,48073950400,"Census Tract 9504, Cherokee County, Texas",1860,328,1428,310,432,180
1400000US48073950500,48073950500,"Census Tract 9505, Cherokee County, Texas",3799,462,2035,409,1764,419
1400000US48073950600,48073950600,"Census Tract 9506, Cherokee County, Texas",5612,522,4131,496,1481,489
1400000US48073950700,48073950700,"Census Tract 9507, Cherokee County, Texas",3958,358,2458,320,1500,325
1400000US48073950801,48073950801,"Census Tract 9508.01, Cherokee County, Texas",5750,755,5240,716,510,402
1400000US48073950802,48073950802,"Census Tract 9508.02, Cherokee County, Texas",3724,613,3202,575,522,253
1400000US48073950900,48073950900,"Census Tract 9509, Cherokee County, Texas",3785,386,3283,350,502,178
1400000US48073951000,48073951000,"Census Tract 9510, Cherokee County, Texas",3754,426,3509,434,245,212
1400000US48073951100,48073951100,"Census Tract 9511, Cherokee County, Texas",1663,209,1558,193,105,86
1400000US48075950100,48075950100,"Census Tract 9501, Childress County, Texas",2232,280,1562,290,670,123
1400000US48075950200,48075950200,"Census Tract 9502, Childress County, Texas",4815,280,3879,439,936,411
1400000US48077030200,48077030200,"Census Tract 302, Clay County, Texas",3427,168,3363,169,64,40
1400000US48077030301,48077030301,"Census Tract 303.01, Clay County, Texas",4513,235,4176,230,337,79
1400000US48077030302,48077030302,"Census Tract 303.02, Clay County, Texas",2778,206,2676,187,102,74
1400000US48079950100,48079950100,"Census Tract 9501, Cochran County, Texas",3087,,1426,,1661,
1400000US48081950100,48081950100,"Census Tract 9501, Coke County, Texas",1799,159,1515,147,284,78
1400000US48081950200,48081950200,"Census Tract 9502, Coke County, Texas",1499,159,1151,147,348,79
1400000US48083950300,48083950300,"Census Tract 9503, Coleman County, Texas",4648,68,3676,202,972,192
1400000US48083950600,48083950600,"Census Tract 9506, Coleman County, Texas",1301,161,1153,189,148,119
1400000US48083950700,48083950700,"Census Tract 9507, Coleman County, Texas",2868,153,2539,193,329,157
1400000US48085030100,48085030100,"Census Tract 301, Collin County, Texas",6316,535,5823,514,493,200
1400000US48085030201,48085030201,"Census Tract 302.01, Collin County, Texas",2308,353,2151,321,157,88
1400000US48085030202,48085030202,"Census Tract 302.02, Collin County, Texas",2108,220,1983,228,125,88
1400000US48085030203,48085030203,"Census Tract 302.03, Collin County, Texas",13828,720,10718,820,3110,757
1400000US48085030301,48085030301,"Census Tract 303.01, Collin County, Texas",2583,241,2242,271,341,171
1400000US48085030302,48085030302,"Census Tract 303.02, Collin County, Texas",1967,224,1967,224,0,13
1400000US48085030303,48085030303,"Census Tract 303.03, Collin County, Texas",4793,298,4569,332,224,148
1400000US48085030304,48085030304,"Census Tract 303.04, Collin County, Texas",2722,340,2200,252,522,333
1400000US48085030305,48085030305,"Census Tract 303.05, Collin County, Texas",8109,499,6601,546,1508,436
1400000US48085030403,48085030403,"Census Tract 304.03, Collin County, Texas",4959,273,4239,384,720,278
1400000US48085030404,48085030404,"Census Tract 304.04, Collin County, Texas",5766,391,4703,491,1063,351
1400000US48085030405,48085030405,"Census Tract 304.05, Collin County, Texas",4506,316,3869,295,637,272
1400000US48085030406,48085030406,"Census Tract 304.06, Collin County, Texas",2574,363,1841,299,733,346
1400000US48085030407,48085030407,"Census Tract 304.07, Collin County, Texas",3743,259,3096,278,647,394
1400000US48085030408,48085030408,"Census Tract 304.08, Collin County, Texas",6531,724,4112,491,2419,774
1400000US48085030504,48085030504,"Census Tract 305.04, Collin County, Texas",2370,328,2158,359,212,126
1400000US48085030505,48085030505,"Census Tract 305.05, Collin County, Texas",2857,471,2759,464,98,83
1400000US48085030506,48085030506,"Census Tract 305.06, Collin County, Texas",2814,250,2609,296,205,147
1400000US48085030507,48085030507,"Census Tract 305.07, Collin County, Texas",1779,77,1668,109,111,96
1400000US48085030508,48085030508,"Census Tract 305.08, Collin County, Texas",5744,573,5460,557,284,209
1400000US48085030509,48085030509,"Census Tract 305.09, Collin County, Texas",2403,148,2036,225,367,178
1400000US48085030510,48085030510,"Census Tract 305.10, Collin County, Texas",2777,217,2553,280,224,152
1400000US48085030511,48085030511,"Census Tract 305.11, Collin County, Texas",4834,331,4050,389,784,213
1400000US48085030512,48085030512,"Census Tract 305.12, Collin County, Texas",4413,338,4116,261,297,232
1400000US48085030513,48085030513,"Census Tract 305.13, Collin County, Texas",3948,399,3492,464,456,320
1400000US48085030514,48085030514,"Census Tract 305.14, Collin County, Texas",6942,350,6074,386,868,304
1400000US48085030515,48085030515,"Census Tract 305.15, Collin County, Texas",6529,638,5740,583,789,352
1400000US48085030516,48085030516,"Census Tract 305.16, Collin County, Texas",5119,293,4091,384,1028,378
1400000US48085030517,48085030517,"Census Tract 305.17, Collin County, Texas",5759,355,5214,392,545,304
1400000US48085030518,48085030518,"Census Tract 305.18, Collin County, Texas",1803,212,1339,255,464,292
1400000US48085030519,48085030519,"Census Tract 305.19, Collin County, Texas",1440,197,1316,218,124,88
1400000US48085030520,48085030520,"Census Tract 305.20, Collin County, Texas",4378,334,3630,338,748,178
1400000US48085030521,48085030521,"Census Tract 305.21, Collin County, Texas",3155,304,2291,355,864,377
1400000US48085030522,48085030522,"Census Tract 305.22, Collin County, Texas",3983,353,3194,362,789,392
1400000US48085030523,48085030523,"Census Tract 305.23, Collin County, Texas",7842,650,6827,596,1015,615
1400000US48085030524,48085030524,"Census Tract 305.24, Collin County, Texas",2212,162,1843,271,369,205
1400000US48085030525,48085030525,"Census Tract 305.25, Collin County, Texas",6424,365,5955,392,469,189
1400000US48085030526,48085030526,"Census Tract 305.26, Collin County, Texas",7568,591,6973,561,595,300
1400000US48085030527,48085030527,"Census Tract 305.27, Collin County, Texas",3888,421,3161,375,727,276
1400000US48085030528,48085030528,"Census Tract 305.28, Collin County, Texas",7116,702,6619,727,497,215
1400000US48085030529,48085030529,"Census Tract 305.29, Collin County, Texas",3573,421,3214,432,359,277
1400000US48085030530,48085030530,"Census Tract 305.30, Collin County, Texas",6448,378,6283,380,165,115
1400000US48085030531,48085030531,"Census Tract 305.31, Collin County, Texas",5415,334,4985,437,430,239
1400000US48085030601,48085030601,"Census Tract 306.01, Collin County, Texas",8833,517,8515,543,318,171
1400000US48085030603,48085030603,"Census Tract 306.03, Collin County, Texas",7206,887,5725,754,1481,688
1400000US48085030604,48085030604,"Census Tract 306.04, Collin County, Texas",2961,222,2630,210,331,113
1400000US48085030605,48085030605,"Census Tract 306.05, Collin County, Texas",5962,455,4790,409,1172,399
1400000US48085030701,48085030701,"Census Tract 307.01, Collin County, Texas",3478,724,2054,441,1424,547
1400000US48085030702,48085030702,"Census Tract 307.02, Collin County, Texas",4460,484,2715,302,1745,451
1400000US48085030801,48085030801,"Census Tract 308.01, Collin County, Texas",3679,545,2653,341,1026,413
1400000US48085030802,48085030802,"Census Tract 308.02, Collin County, Texas",5944,902,3285,584,2659,832
1400000US48085030900,48085030900,"Census Tract 309, Collin County, Texas",9636,970,3986,590,5650,997
1400000US48085031001,48085031001,"Census Tract 310.01, Collin County, Texas",6669,500,5123,490,1546,477
1400000US48085031003,48085031003,"Census Tract 310.03, Collin County, Texas",4115,340,3205,303,910,264
1400000US48085031004,48085031004,"Census Tract 310.04, Collin County, Texas",5431,489,4317,471,1114,500
1400000US48085031100,48085031100,"Census Tract 311, Collin County, Texas",9876,911,8132,941,1744,552
1400000US48085031201,48085031201,"Census Tract 312.01, Collin County, Texas",5140,451,4366,408,774,203
1400000US48085031202,48085031202,"Census Tract 312.02, Collin County, Texas",3964,587,3370,528,594,360
1400000US48085031308,48085031308,"Census Tract 313.08, Collin County, Texas",6198,573,5419,420,779,303
1400000US48085031309,48085031309,"Census Tract 313.09, Collin County, Texas",9484,594,8132,600,1352,334
1400000US48085031310,48085031310,"Census Tract 313.10, Collin County, Texas",9131,530,7882,526,1249,338
1400000US48085031311,48085031311,"Census Tract 313.11, Collin County, Texas",9072,541,7888,549,1184,336
1400000US48085031312,48085031312,"Census Tract 313.12, Collin County, Texas",6260,454,5879,401,381,255
1400000US48085031313,48085031313,"Census Tract 313.13, Collin County, Texas",12067,563,11115,651,952,329
1400000US48085031314,48085031314,"Census Tract 313.14, Collin County, Texas",2133,565,2028,554,105,68
1400000US48085031315,48085031315,"Census Tract 313.15, Collin County, Texas",16519,864,14012,909,2507,554
1400000US48085031316,48085031316,"Census Tract 313.16, Collin County, Texas",6384,398,5695,406,689,304
1400000US48085031317,48085031317,"Census Tract 313.17, Collin County, Texas",7774,493,7011,503,763,400
1400000US48085031405,48085031405,"Census Tract 314.05, Collin County, Texas",17014,612,16085,646,929,370
1400000US48085031406,48085031406,"Census Tract 314.06, Collin County, Texas",16580,807,14779,887,1801,520
1400000US48085031407,48085031407,"Census Tract 314.07, Collin County, Texas",7875,554,7451,495,424,269
1400000US48085031408,48085031408,"Census Tract 314.08, Collin County, Texas",3407,272,2977,286,430,198
1400000US48085031409,48085031409,"Census Tract 314.09, Collin County, Texas",10305,511,9108,430,1197,469
1400000US48085031410,48085031410,"Census Tract 314.10, Collin County, Texas",8572,497,8064,482,508,209
1400000US48085031411,48085031411,"Census Tract 314.11, Collin County, Texas",5158,421,4570,481,588,340
1400000US48085031504,48085031504,"Census Tract 315.04, Collin County, Texas",6339,388,5750,432,589,180
1400000US48085031505,48085031505,"Census Tract 315.05, Collin County, Texas",8058,356,7783,385,275,177
1400000US48085031506,48085031506,"Census Tract 315.06, Collin County, Texas",7986,582,5927,568,2059,532
1400000US48085031507,48085031507,"Census Tract 315.07, Collin County, Texas",3984,306,3696,341,288,201
1400000US48085031508,48085031508,"Census Tract 315.08, Collin County, Texas",5461,487,4675,472,786,402
1400000US48085031611,48085031611,"Census Tract 316.11, Collin County, Texas",3601,315,2909,349,692,286
1400000US48085031612,48085031612,"Census Tract 316.12, Collin County, Texas",6557,525,5702,529,855,396
1400000US48085031613,48085031613,"Census Tract 316.13, Collin County, Texas",5351,305,4829,343,522,204
1400000US48085031621,48085031621,"Census Tract 316.21, Collin County, Texas",5509,509,5234,487,275,140
1400000US48085031622,48085031622,"Census Tract 316.22, Collin County, Texas",5382,469,4849,432,533,283
1400000US48085031623,48085031623,"Census Tract 316.23, Collin County, Texas",3105,193,2306,311,799,215
1400000US48085031624,48085031624,"Census Tract 316.24, Collin County, Texas",3724,357,2292,226,1432,382
1400000US48085031625,48085031625,"Census Tract 316.25, Collin County, Texas",4208,232,3963,243,245,94
1400000US48085031626,48085031626,"Census Tract 316.26, Collin County, Texas",2480,150,2265,218,215,172
1400000US48085031627,48085031627,"Census Tract 316.27, Collin County, Texas",5047,287,4301,266,746,259
1400000US48085031628,48085031628,"Census Tract 316.28, Collin County, Texas",3616,294,2899,309,717,186
1400000US48085031629,48085031629,"Census Tract 316.29, Collin County, Texas",3406,427,2591,385,815,248
1400000US48085031630,48085031630,"Census Tract 316.30, Collin County, Texas",4306,259,3970,248,336,151
1400000US48085031631,48085031631,"Census Tract 316.31, Collin County, Texas",4690,362,4057,448,633,414
1400000US48085031632,48085031632,"Census Tract 316.32, Collin County, Texas",5945,383,5578,389,367,144
1400000US48085031633,48085031633,"Census Tract 316.33, Collin County, Texas",3644,278,3138,306,506,302
1400000US48085031634,48085031634,"Census Tract 316.34, Collin County, Texas",3059,371,2486,319,573,177
1400000US48085031635,48085031635,"Census Tract 316.35, Collin County, Texas",4183,390,3308,455,875,219
1400000US48085031636,48085031636,"Census Tract 316.36, Collin County, Texas",6433,434,5842,400,591,212
1400000US48085031637,48085031637,"Census Tract 316.37, Collin County, Texas",6998,333,6644,381,354,191
1400000US48085031638,48085031638,"Census Tract 316.38, Collin County, Texas",7274,282,6941,285,333,121
1400000US48085031639,48085031639,"Census Tract 316.39, Collin County, Texas",5898,331,5437,351,461,154
1400000US48085031640,48085031640,"Census Tract 316.40, Collin County, Texas",7066,613,6426,606,640,294
1400000US48085031641,48085031641,"Census Tract 316.41, Collin County, Texas",6632,301,6291,308,341,129
1400000US48085031642,48085031642,"Census Tract 316.42, Collin County, Texas",4650,230,4564,225,86,65
1400000US48085031643,48085031643,"Census Tract 316.43, Collin County, Texas",4232,261,3550,245,682,217
1400000US48085031645,48085031645,"Census Tract 316.45, Collin County, Texas",2057,132,1964,140,93,77
1400000US48085031646,48085031646,"Census Tract 316.46, Collin County, Texas",5458,285,5136,301,322,131
1400000US48085031647,48085031647,"Census Tract 316.47, Collin County, Texas",3448,304,3100,358,348,241
1400000US48085031648,48085031648,"Census Tract 316.48, Collin County, Texas",7160,522,6566,568,594,305
1400000US48085031649,48085031649,"Census Tract 316.49, Collin County, Texas",4636,300,4487,310,149,86
1400000US48085031652,48085031652,"Census Tract 316.52, Collin County, Texas",7811,547,7422,586,389,224
1400000US48085031653,48085031653,"Census Tract 316.53, Collin County, Texas",6465,428,5750,492,715,242
1400000US48085031654,48085031654,"Census Tract 316.54, Collin County, Texas",3783,189,3658,205,125,122
1400000US48085031655,48085031655,"Census Tract 316.55, Collin County, Texas",4521,372,4014,448,507,278
1400000US48085031656,48085031656,"Census Tract 316.56, Collin County, Texas",2337,251,1936,480,401,398
1400000US48085031657,48085031657,"Census Tract 316.57, Collin County, Texas",1169,295,1122,297,47,53
1400000US48085031658,48085031658,"Census Tract 316.58, Collin County, Texas",4003,440,3492,443,511,256
1400000US48085031659,48085031659,"Census Tract 316.59, Collin County, Texas",1730,375,1560,412,170,138
1400000US48085031660,48085031660,"Census Tract 316.60, Collin County, Texas",3766,519,3609,543,157,96
1400000US48085031661,48085031661,"Census Tract 316.61, Collin County, Texas",3015,212,2919,231,96,72
1400000US48085031662,48085031662,"Census Tract 316.62, Collin County, Texas",5147,385,4976,421,171,155
1400000US48085031663,48085031663,"Census Tract 316.63, Collin County, Texas",3293,366,3128,381,165,144
1400000US48085031664,48085031664,"Census Tract 316.64, Collin County, Texas",4203,314,3575,362,628,323
1400000US48085031704,48085031704,"Census Tract 317.04, Collin County, Texas",3638,284,2980,288,658,265
1400000US48085031706,48085031706,"Census Tract 317.06, Collin County, Texas",2319,150,2122,184,197,243
1400000US48085031708,48085031708,"Census Tract 317.08, Collin County, Texas",3630,310,3279,306,351,138
1400000US48085031709,48085031709,"Census Tract 317.09, Collin County, Texas",4518,313,4305,308,213,158
1400000US48085031711,48085031711,"Census Tract 317.11, Collin County, Texas",2834,302,2703,300,131,112
1400000US48085031712,48085031712,"Census Tract 317.12, Collin County, Texas",5013,491,4364,447,649,406
1400000US48085031713,48085031713,"Census Tract 317.13, Collin County, Texas",3904,402,3250,473,654,285
1400000US48085031714,48085031714,"Census Tract 317.14, Collin County, Texas",5184,522,4489,477,695,378
1400000US48085031715,48085031715,"Census Tract 317.15, Collin County, Texas",2445,212,2387,205,58,65
1400000US48085031716,48085031716,"Census Tract 317.16, Collin County, Texas",1984,255,1634,211,350,216
1400000US48085031717,48085031717,"Census Tract 317.17, Collin County, Texas",2640,568,2281,597,359,192
1400000US48085031718,48085031718,"Census Tract 317.18, Collin County, Texas",2744,365,2567,364,177,126
1400000US48085031719,48085031719,"Census Tract 317.19, Collin County, Texas",1868,168,1719,214,149,133
1400000US48085031720,48085031720,"Census Tract 317.20, Collin County, Texas",4511,663,2372,651,2139,775
1400000US48085031802,48085031802,"Census Tract 318.02, Collin County, Texas",5985,524,5082,534,903,317
1400000US48085031804,48085031804,"Census Tract 318.04, Collin County, Texas",3830,422,3490,390,340,192
1400000US48085031805,48085031805,"Census Tract 318.05, Collin County, Texas",5157,259,4793,262,364,162
1400000US48085031806,48085031806,"Census Tract 318.06, Collin County, Texas",1526,278,1332,274,194,112
1400000US48085031807,48085031807,"Census Tract 318.07, Collin County, Texas",4934,403,4494,407,440,427
1400000US48085031900,48085031900,"Census Tract 319, Collin County, Texas",4058,460,1750,258,2308,477
1400000US48085032003,48085032003,"Census Tract 320.03, Collin County, Texas",5652,480,2764,373,2888,533
1400000US48085032004,48085032004,"Census Tract 320.04, Collin County, Texas",8199,859,4503,424,3696,964
1400000US48085032008,48085032008,"Census Tract 320.08, Collin County, Texas",3799,300,2728,236,1071,297
1400000US48085032009,48085032009,"Census Tract 320.09, Collin County, Texas",6904,383,6328,359,576,204
1400000US48085032010,48085032010,"Census Tract 320.10, Collin County, Texas",4088,583,2707,409,1381,515
1400000US48085032011,48085032011,"Census Tract 320.11, Collin County, Texas",5661,424,5035,487,626,315
1400000US48085032012,48085032012,"Census Tract 320.12, Collin County, Texas",4334,336,1925,294,2409,445
1400000US48085032013,48085032013,"Census Tract 320.13, Collin County, Texas",6762,845,3855,434,2907,816
1400000US48087950300,48087950300,"Census Tract 9503, Collingsworth County, Texas",3050,,2090,126,960,126
1400000US48089750100,48089750100,"Census Tract 7501, Colorado County, Texas",4890,312,2806,399,2084,293
1400000US48089750200,48089750200,"Census Tract 7502, Colorado County, Texas",1904,326,1593,321,311,131
1400000US48089750300,48089750300,"Census Tract 7503, Colorado County, Texas",4687,392,3866,351,821,249
1400000US48089750400,48089750400,"Census Tract 7504, Colorado County, Texas",4928,516,3947,426,981,271
1400000US48089750500,48089750500,"Census Tract 7505, Colorado County, Texas",4375,411,3142,350,1233,311
1400000US48091310100,48091310100,"Census Tract 3101, Comal County, Texas",3405,362,2080,346,1325,271
1400000US48091310200,48091310200,"Census Tract 3102, Comal County, Texas",2546,324,1362,270,1184,246
1400000US48091310300,48091310300,"Census Tract 3103, Comal County, Texas",6442,468,5435,444,1007,324
1400000US48091310401,48091310401,"Census Tract 3104.01, Comal County, Texas",5345,492,1420,249,3925,441
1400000US48091310403,48091310403,"Census Tract 3104.03, Comal County, Texas",5651,459,3612,473,2039,382
1400000US48091310404,48091310404,"Census Tract 3104.04, Comal County, Texas",4202,253,2646,217,1556,238
1400000US48091310501,48091310501,"Census Tract 3105.01, Comal County, Texas",3571,291,2140,256,1431,240
1400000US48091310502,48091310502,"Census Tract 3105.02, Comal County, Texas",5239,504,2911,593,2328,438
1400000US48091310503,48091310503,"Census Tract 3105.03, Comal County, Texas",3166,250,2327,309,839,220
1400000US48091310603,48091310603,"Census Tract 3106.03, Comal County, Texas",2503,367,2098,271,405,195
1400000US48091310604,48091310604,"Census Tract 3106.04, Comal County, Texas",2596,243,2391,311,205,152
1400000US48091310605,48091310605,"Census Tract 3106.05, Comal County, Texas",4980,405,4431,405,549,270
1400000US48091310606,48091310606,"Census Tract 3106.06, Comal County, Texas",3886,374,3574,349,312,163
1400000US48091310607,48091310607,"Census Tract 3106.07, Comal County, Texas",4879,477,4316,472,563,230
1400000US48091310608,48091310608,"Census Tract 3106.08, Comal County, Texas",3461,461,2807,440,654,227
1400000US48091310701,48091310701,"Census Tract 3107.01, Comal County, Texas",6170,540,5423,582,747,324
1400000US48091310702,48091310702,"Census Tract 3107.02, Comal County, Texas",5363,479,4596,427,767,293
1400000US48091310703,48091310703,"Census Tract 3107.03, Comal County, Texas",5260,440,4137,426,1123,410
1400000US48091310704,48091310704,"Census Tract 3107.04, Comal County, Texas",5475,587,4046,458,1429,652
1400000US48091310801,48091310801,"Census Tract 3108.01, Comal County, Texas",4767,322,4168,328,599,172
1400000US48091310802,48091310802,"Census Tract 3108.02, Comal County, Texas",6000,749,3980,434,2020,638
1400000US48091310901,48091310901,"Census Tract 3109.01, Comal County, Texas",3824,359,3461,318,363,188
1400000US48091310902,48091310902,"Census Tract 3109.02, Comal County, Texas",6368,636,4649,413,1719,423
1400000US48091310903,48091310903,"Census Tract 3109.03, Comal County, Texas",3886,348,3560,403,326,208
1400000US48093950100,48093950100,"Census Tract 9501, Comanche County, Texas",4431,300,3521,262,910,228
1400000US48093950200,48093950200,"Census Tract 9502, Comanche County, Texas",3325,276,2732,261,593,180
1400000US48093950300,48093950300,"Census Tract 9503, Comanche County, Texas",4231,224,2711,223,1520,239
1400000US48093950400,48093950400,"Census Tract 9504, Comanche County, Texas",1888,265,1331,184,557,233
1400000US48095950300,48095950300,"Census Tract 9503, Concho County, Texas",4073,,1906,,2167,
1400000US48097000100,48097000100,"Census Tract 1, Cooke County, Texas",5222,396,4921,422,301,139
1400000US48097000200,48097000200,"Census Tract 2, Cooke County, Texas",5124,294,4897,292,227,114
1400000US48097000400,48097000400,"Census Tract 4, Cooke County, Texas",1872,298,1547,215,325,224
1400000US48097000500,48097000500,"Census Tract 5, Cooke County, Texas",3822,428,2221,316,1601,346
1400000US48097000600,48097000600,"Census Tract 6, Cooke County, Texas",4953,466,3593,336,1360,415
1400000US48097000700,48097000700,"Census Tract 7, Cooke County, Texas",6850,437,6338,488,512,214
1400000US48097000900,48097000900,"Census Tract 9, Cooke County, Texas",4938,351,4628,369,310,154
1400000US48097001100,48097001100,"Census Tract 11, Cooke County, Texas",5646,535,4286,418,1360,430
1400000US48099010101,48099010101,"Census Tract 101.01, Coryell County, Texas",3037,398,2749,356,288,150
1400000US48099010102,48099010102,"Census Tract 101.02, Coryell County, Texas",2880,306,2638,319,242,129
1400000US48099010201,48099010201,"Census Tract 102.01, Coryell County, Texas",5333,565,4008,473,1325,237
1400000US48099010202,48099010202,"Census Tract 102.02, Coryell County, Texas",6285,726,5461,632,824,331
1400000US48099010300,48099010300,"Census Tract 103, Coryell County, Texas",3388,440,2470,365,918,430
1400000US48099010400,48099010400,"Census Tract 104, Coryell County, Texas",4198,645,3770,573,428,188
1400000US48099010501,48099010501,"Census Tract 105.01, Coryell County, Texas",5688,533,4454,506,1234,445
1400000US48099010502,48099010502,"Census Tract 105.02, Coryell County, Texas",3655,625,2722,442,933,555
1400000US48099010503,48099010503,"Census Tract 105.03, Coryell County, Texas",4279,858,3812,819,467,132
1400000US48099010504,48099010504,"Census Tract 105.04, Coryell County, Texas",2681,325,2306,279,375,226
1400000US48099010601,48099010601,"Census Tract 106.01, Coryell County, Texas",4564,622,3684,511,880,415
1400000US48099010603,48099010603,"Census Tract 106.03, Coryell County, Texas",5263,601,4549,553,714,239
1400000US48099010604,48099010604,"Census Tract 106.04, Coryell County, Texas",4295,464,3700,451,595,282
1400000US48099010701,48099010701,"Census Tract 107.01, Coryell County, Texas",4384,451,3518,398,866,300
1400000US48099010702,48099010702,"Census Tract 107.02, Coryell County, Texas",3131,413,2681,437,450,264
1400000US48099010802,48099010802,"Census Tract 108.02, Coryell County, Texas",5534,564,5014,565,520,225
1400000US48099010803,48099010803,"Census Tract 108.03, Coryell County, Texas",2821,487,2518,455,303,165
1400000US48099010804,48099010804,"Census Tract 108.04, Coryell County, Texas",4271,646,3430,604,841,415
1400000US48099980000,48099980000,"Census Tract 9800, Coryell County, Texas",41,32,41,32,0,13
1400000US48101950100,48101950100,"Census Tract 9501, Cottle County, Texas",1600,361,1405,306,195,119
1400000US48103950100,48103950100,"Census Tract 9501, Crane County, Texas",4359,,1947,,2412,
1400000US48105950100,48105950100,"Census Tract 9501, Crockett County, Texas",3669,204,1572,204,2097,265
1400000US48107950100,48107950100,"Census Tract 9501, Crosby County, Texas",2269,194,1213,137,1056,135
1400000US48107950200,48107950200,"Census Tract 9502, Crosby County, Texas",2453,157,1008,123,1445,147
1400000US48107950300,48107950300,"Census Tract 9503, Crosby County, Texas",1378,151,674,101,704,133
1400000US48109950300,48109950300,"Census Tract 9503, Culberson County, Texas",2386,,532,144,1854,144
1400000US48111950100,48111950100,"Census Tract 9501, Dallam County, Texas",1584,209,1301,175,283,155
1400000US48111950300,48111950300,"Census Tract 9503, Dallam County, Texas",5150,209,2707,175,2443,155
1400000US48113000100,48113000100,"Census Tract 1, Dallas County, Texas",4068,291,3563,313,505,274
1400000US48113000201,48113000201,"Census Tract 2.01, Dallas County, Texas",2910,246,2609,196,301,199
1400000US48113000202,48113000202,"Census Tract 2.02, Dallas County, Texas",3523,244,3137,261,386,155
1400000US48113000300,48113000300,"Census Tract 3, Dallas County, Texas",4305,370,3534,414,771,263
1400000US48113000401,48113000401,"Census Tract 4.01, Dallas County, Texas",4838,817,1987,628,2851,489
1400000US48113000404,48113000404,"Census Tract 4.04, Dallas County, Texas",3924,541,1618,182,2306,529
1400000US48113000405,48113000405,"Census Tract 4.05, Dallas County, Texas",2465,436,1532,315,933,397
1400000US48113000406,48113000406,"Census Tract 4.06, Dallas County, Texas",7679,751,1306,291,6373,845
1400000US48113000500,48113000500,"Census Tract 5, Dallas County, Texas",4367,571,2410,269,1957,589
1400000US48113000601,48113000601,"Census Tract 6.01, Dallas County, Texas",6587,930,2538,299,4049,910
1400000US48113000603,48113000603,"Census Tract 6.03, Dallas County, Texas",3846,356,3312,315,534,241
1400000US48113000605,48113000605,"Census Tract 6.05, Dallas County, Texas",2084,220,1835,201,249,100
1400000US48113000606,48113000606,"Census Tract 6.06, Dallas County, Texas",3107,376,2942,384,165,81
1400000US48113000701,48113000701,"Census Tract 7.01, Dallas County, Texas",4119,403,3598,430,521,254
1400000US48113000702,48113000702,"Census Tract 7.02, Dallas County, Texas",3167,323,2342,266,825,385
1400000US48113000800,48113000800,"Census Tract 8, Dallas County, Texas",6096,613,2204,353,3892,586
1400000US48113000900,48113000900,"Census Tract 9, Dallas County, Texas",4361,703,1444,286,2917,674
1400000US48113001001,48113001001,"Census Tract 10.01, Dallas County, Texas",1652,185,1267,194,385,93
1400000US48113001002,48113001002,"Census Tract 10.02, Dallas County, Texas",2274,220,1152,196,1122,167
1400000US48113001101,48113001101,"Census Tract 11.01, Dallas County, Texas",3592,448,2480,304,1112,414
1400000US48113001102,48113001102,"Census Tract 11.02, Dallas County, Texas",2202,250,1885,297,317,135
1400000US48113001202,48113001202,"Census Tract 12.02, Dallas County, Texas",3112,383,1961,266,1151,305
1400000US48113001203,48113001203,"Census Tract 12.03, Dallas County, Texas",1649,367,463,103,1186,374
1400000US48113001204,48113001204,"Census Tract 12.04, Dallas County, Texas",2793,411,212,140,2581,415
1400000US48113001301,48113001301,"Census Tract 13.01, Dallas County, Texas",2398,282,1919,254,479,190
1400000US48113001302,48113001302,"Census Tract 13.02, Dallas County, Texas",2169,420,1187,178,982,388
1400000US48113001400,48113001400,"Census Tract 14, Dallas County, Texas",3473,398,1807,299,1666,447
1400000US48113001502,48113001502,"Census Tract 15.02, Dallas County, Texas",3437,490,1143,239,2294,535
1400000US48113001503,48113001503,"Census Tract 15.03, Dallas County, Texas",3305,401,1027,184,2278,376
1400000US48113001504,48113001504,"Census Tract 15.04, Dallas County, Texas",2466,393,1491,303,975,317
1400000US48113001600,48113001600,"Census Tract 16, Dallas County, Texas",4299,636,3233,479,1066,516
1400000US48113001701,48113001701,"Census Tract 17.01, Dallas County, Texas",162,58,149,58,13,22
1400000US48113001703,48113001703,"Census Tract 17.03, Dallas County, Texas",2857,246,2574,274,283,144
1400000US48113001704,48113001704,"Census Tract 17.04, Dallas County, Texas",1168,246,1054,233,114,98
1400000US48113001800,48113001800,"Census Tract 18, Dallas County, Texas",3472,299,3113,304,359,233
1400000US48113001900,48113001900,"Census Tract 19, Dallas County, Texas",4515,488,4003,503,512,236
1400000US48113002000,48113002000,"Census Tract 20, Dallas County, Texas",5944,793,1591,372,4353,814
1400000US48113002100,48113002100,"Census Tract 21, Dallas County, Texas",1339,119,1161,122,178,86
1400000US48113002200,48113002200,"Census Tract 22, Dallas County, Texas",2226,345,1998,351,228,116
1400000US48113002400,48113002400,"Census Tract 24, Dallas County, Texas",3381,458,511,162,2870,497
1400000US48113002500,48113002500,"Census Tract 25, Dallas County, Texas",5059,518,1571,438,3488,453
1400000US48113002701,48113002701,"Census Tract 27.01, Dallas County, Texas",2578,441,2048,409,530,256
1400000US48113002702,48113002702,"Census Tract 27.02, Dallas County, Texas",1365,210,1298,235,67,67
1400000US48113003101,48113003101,"Census Tract 31.01, Dallas County, Texas",2736,313,2440,312,296,103
1400000US48113003400,48113003400,"Census Tract 34, Dallas County, Texas",1298,327,1177,310,121,117
1400000US48113003700,48113003700,"Census Tract 37, Dallas County, Texas",3360,422,3356,422,4,9
1400000US48113003800,48113003800,"Census Tract 38, Dallas County, Texas",1949,337,1909,343,40,53
1400000US48113003901,48113003901,"Census Tract 39.01, Dallas County, Texas",1687,334,1687,334,0,13
1400000US48113003902,48113003902,"Census Tract 39.02, Dallas County, Texas",1819,357,1699,371,120,91
1400000US48113004000,48113004000,"Census Tract 40, Dallas County, Texas",1081,286,1081,286,0,13
1400000US48113004100,48113004100,"Census Tract 41, Dallas County, Texas",1166,349,719,273,447,254
1400000US48113004201,48113004201,"Census Tract 42.01, Dallas County, Texas",4085,457,1787,263,2298,462
1400000US48113004202,48113004202,"Census Tract 42.02, Dallas County, Texas",2198,314,819,133,1379,314
1400000US48113004300,48113004300,"Census Tract 43, Dallas County, Texas",2167,340,381,153,1786,352
1400000US48113004400,48113004400,"Census Tract 44, Dallas County, Texas",3321,358,2325,244,996,345
1400000US48113004500,48113004500,"Census Tract 45, Dallas County, Texas",5886,754,1406,410,4480,702
1400000US48113004600,48113004600,"Census Tract 46, Dallas County, Texas",1455,223,882,147,573,173
1400000US48113004700,48113004700,"Census Tract 47, Dallas County, Texas",3851,569,394,157,3457,564
1400000US48113004800,48113004800,"Census Tract 48, Dallas County, Texas",2843,486,123,113,2720,500
1400000US48113004900,48113004900,"Census Tract 49, Dallas County, Texas",3678,491,2744,422,934,302
1400000US48113005000,48113005000,"Census Tract 50, Dallas County, Texas",4603,542,544,211,4059,627
1400000US48113005100,48113005100,"Census Tract 51, Dallas County, Texas",3216,522,464,214,2752,494
1400000US48113005200,48113005200,"Census Tract 52, Dallas County, Texas",5430,633,680,175,4750,671
1400000US48113005300,48113005300,"Census Tract 53, Dallas County, Texas",7406,686,735,185,6671,707
1400000US48113005400,48113005400,"Census Tract 54, Dallas County, Texas",5453,678,2566,633,2887,539
1400000US48113005500,48113005500,"Census Tract 55, Dallas County, Texas",3730,408,2028,319,1702,393
1400000US48113005600,48113005600,"Census Tract 56, Dallas County, Texas",7748,909,1889,319,5859,957
1400000US48113005700,48113005700,"Census Tract 57, Dallas County, Texas",4312,475,2466,376,1846,459
1400000US48113005901,48113005901,"Census Tract 59.01, Dallas County, Texas",4924,502,3930,473,994,345
1400000US48113005902,48113005902,"Census Tract 59.02, Dallas County, Texas",3602,375,2930,324,672,304
1400000US48113006001,48113006001,"Census Tract 60.01, Dallas County, Texas",4012,471,1103,326,2909,460
1400000US48113006002,48113006002,"Census Tract 60.02, Dallas County, Texas",4466,522,3808,493,658,252
1400000US48113006100,48113006100,"Census Tract 61, Dallas County, Texas",4781,486,2448,400,2333,446
1400000US48113006200,48113006200,"Census Tract 62, Dallas County, Texas",5841,527,2188,440,3653,527
1400000US48113006301,48113006301,"Census Tract 63.01, Dallas County, Texas",5925,413,1186,245,4739,433
1400000US48113006302,48113006302,"Census Tract 63.02, Dallas County, Texas",4052,468,695,132,3357,490
1400000US48113006401,48113006401,"Census Tract 64.01, Dallas County, Texas",2695,372,294,163,2401,443
1400000US48113006402,48113006402,"Census Tract 64.02, Dallas County, Texas",6077,576,458,280,5619,646
1400000US48113006501,48113006501,"Census Tract 65.01, Dallas County, Texas",6036,437,363,144,5673,488
1400000US48113006502,48113006502,"Census Tract 65.02, Dallas County, Texas",3768,315,444,181,3324,350
1400000US48113006700,48113006700,"Census Tract 67, Dallas County, Texas",8030,831,974,432,7056,822
1400000US48113006800,48113006800,"Census Tract 68, Dallas County, Texas",5149,676,1180,294,3969,679
1400000US48113006900,48113006900,"Census Tract 69, Dallas County, Texas",3345,516,843,173,2502,551
1400000US48113007101,48113007101,"Census Tract 71.01, Dallas County, Texas",1830,159,1681,171,149,93
1400000US48113007102,48113007102,"Census Tract 71.02, Dallas County, Texas",6691,736,4283,683,2408,817
1400000US48113007201,48113007201,"Census Tract 72.01, Dallas County, Texas",8836,917,1130,376,7706,1004
1400000US48113007202,48113007202,"Census Tract 72.02, Dallas County, Texas",7790,894,1025,402,6765,896
1400000US48113007301,48113007301,"Census Tract 73.01, Dallas County, Texas",2038,175,1983,180,55,42
1400000US48113007302,48113007302,"Census Tract 73.02, Dallas County, Texas",4630,524,3162,313,1468,490
1400000US48113007601,48113007601,"Census Tract 76.01, Dallas County, Texas",1814,262,1665,237,149,104
1400000US48113007604,48113007604,"Census Tract 76.04, Dallas County, Texas",3229,312,3130,311,99,100
1400000US48113007605,48113007605,"Census Tract 76.05, Dallas County, Texas",1886,162,1828,160,58,39
1400000US48113007700,48113007700,"Census Tract 77, Dallas County, Texas",4759,500,4579,515,180,179
1400000US48113007801,48113007801,"Census Tract 78.01, Dallas County, Texas",2199,142,2085,154,114,76
1400000US48113007804,48113007804,"Census Tract 78.04, Dallas County, Texas",5355,660,4115,606,1240,325
1400000US48113007805,48113007805,"Census Tract 78.05, Dallas County, Texas",3211,250,2742,266,469,133
1400000US48113007809,48113007809,"Census Tract 78.09, Dallas County, Texas",2236,251,1626,203,610,280
1400000US48113007810,48113007810,"Census Tract 78.10, Dallas County, Texas",3796,433,3240,358,556,295
1400000US48113007811,48113007811,"Census Tract 78.11, Dallas County, Texas",4986,641,4168,528,818,432
1400000US48113007812,48113007812,"Census Tract 78.12, Dallas County, Texas",3085,174,2934,230,151,107
1400000US48113007815,48113007815,"Census Tract 78.15, Dallas County, Texas",4621,661,2212,557,2409,588
1400000US48113007818,48113007818,"Census Tract 78.18, Dallas County, Texas",4925,672,1922,440,3003,650
1400000US48113007819,48113007819,"Census Tract 78.19, Dallas County, Texas",1961,341,1198,295,763,251
1400000US48113007820,48113007820,"Census Tract 78.20, Dallas County, Texas",5600,917,2656,572,2944,932
1400000US48113007821,48113007821,"Census Tract 78.21, Dallas County, Texas",3445,634,1867,557,1578,434
1400000US48113007822,48113007822,"Census Tract 78.22, Dallas County, Texas",1055,299,687,160,368,288
1400000US48113007823,48113007823,"Census Tract 78.23, Dallas County, Texas",895,239,533,146,362,214
1400000US48113007824,48113007824,"Census Tract 78.24, Dallas County, Texas",1545,107,1471,139,74,104
1400000US48113007825,48113007825,"Census Tract 78.25, Dallas County, Texas",5460,873,4003,738,1457,540
1400000US48113007826,48113007826,"Census Tract 78.26, Dallas County, Texas",244,117,244,117,0,13
1400000US48113007827,48113007827,"Census Tract 78.27, Dallas County, Texas",2652,375,2284,341,368,207
1400000US48113007902,48113007902,"Census Tract 79.02, Dallas County, Texas",5073,544,4329,416,744,405
1400000US48113007903,48113007903,"Census Tract 79.03, Dallas County, Texas",1716,163,1605,164,111,64
1400000US48113007906,48113007906,"Census Tract 79.06, Dallas County, Texas",2257,280,2138,238,119,94
1400000US48113007909,48113007909,"Census Tract 79.09, Dallas County, Texas",2059,233,1758,252,301,223
1400000US48113007910,48113007910,"Census Tract 79.10, Dallas County, Texas",3130,295,2638,303,492,181
1400000US48113007911,48113007911,"Census Tract 79.11, Dallas County, Texas",2937,353,2475,333,462,213
1400000US48113007912,48113007912,"Census Tract 79.12, Dallas County, Texas",1773,189,1569,184,204,155
1400000US48113007913,48113007913,"Census Tract 79.13, Dallas County, Texas",1887,541,1416,446,471,253
1400000US48113007914,48113007914,"Census Tract 79.14, Dallas County, Texas",2280,308,1983,319,297,132
1400000US48113008000,48113008000,"Census Tract 80, Dallas County, Texas",6229,503,6004,505,225,164
1400000US48113008100,48113008100,"Census Tract 81, Dallas County, Texas",6467,535,5573,522,894,356
1400000US48113008200,48113008200,"Census Tract 82, Dallas County, Texas",4176,325,2818,382,1358,477
1400000US48113008400,48113008400,"Census Tract 84, Dallas County, Texas",8709,845,1480,269,7229,877
1400000US48113008500,48113008500,"Census Tract 85, Dallas County, Texas",5319,398,1359,278,3960,416
1400000US48113008603,48113008603,"Census Tract 86.03, Dallas County, Texas",1180,238,717,182,463,248
1400000US48113008604,48113008604,"Census Tract 86.04, Dallas County, Texas",2832,445,2419,444,413,145
1400000US48113008701,48113008701,"Census Tract 87.01, Dallas County, Texas",3945,478,3708,484,237,132
1400000US48113008703,48113008703,"Census Tract 87.03, Dallas County, Texas",2648,375,1802,287,846,298
1400000US48113008704,48113008704,"Census Tract 87.04, Dallas County, Texas",3187,534,2967,507,220,114
1400000US48113008705,48113008705,"Census Tract 87.05, Dallas County, Texas",1321,158,982,124,339,137
1400000US48113008801,48113008801,"Census Tract 88.01, Dallas County, Texas",2274,242,1854,265,420,219
1400000US48113008802,48113008802,"Census Tract 88.02, Dallas County, Texas",5636,676,4299,555,1337,636
1400000US48113008900,48113008900,"Census Tract 89, Dallas County, Texas",3266,549,2178,373,1088,488
1400000US48113009000,48113009000,"Census Tract 90, Dallas County, Texas",8005,798,3358,716,4647,643
1400000US48113009101,48113009101,"Census Tract 91.01, Dallas County, Texas",5800,658,1798,464,4002,720
1400000US48113009103,48113009103,"Census Tract 91.03, Dallas County, Texas",3960,499,1263,286,2697,535
1400000US48113009104,48113009104,"Census Tract 91.04, Dallas County, Texas",3577,420,819,193,2758,430
1400000US48113009105,48113009105,"Census Tract 91.05, Dallas County, Texas",4134,337,1105,345,3029,420
1400000US48113009201,48113009201,"Census Tract 92.01, Dallas County, Texas",6594,689,2040,347,4554,750
1400000US48113009202,48113009202,"Census Tract 92.02, Dallas County, Texas",5930,536,1454,336,4476,592
1400000US48113009301,48113009301,"Census Tract 93.01, Dallas County, Texas",5266,484,830,174,4436,515
1400000US48113009303,48113009303,"Census Tract 93.03, Dallas County, Texas",4338,438,699,154,3639,437
1400000US48113009304,48113009304,"Census Tract 93.04, Dallas County, Texas",6178,883,4282,635,1896,642
1400000US48113009401,48113009401,"Census Tract 94.01, Dallas County, Texas",3362,244,1393,197,1969,236
1400000US48113009402,48113009402,"Census Tract 94.02, Dallas County, Texas",2498,243,1943,187,555,186
1400000US48113009500,48113009500,"Census Tract 95, Dallas County, Texas",2188,140,1771,261,417,324
1400000US48113009603,48113009603,"Census Tract 96.03, Dallas County, Texas",4536,364,4078,409,458,136
1400000US48113009604,48113009604,"Census Tract 96.04, Dallas County, Texas",3995,543,2811,375,1184,485
1400000US48113009605,48113009605,"Census Tract 96.05, Dallas County, Texas",3535,416,1410,308,2125,486
1400000US48113009607,48113009607,"Census Tract 96.07, Dallas County, Texas",3996,493,2594,327,1402,516
1400000US48113009608,48113009608,"Census Tract 96.08, Dallas County, Texas",4837,566,2766,250,2071,560
1400000US48113009609,48113009609,"Census Tract 96.09, Dallas County, Texas",2966,225,2631,175,335,284
1400000US48113009610,48113009610,"Census Tract 96.10, Dallas County, Texas",5580,512,646,242,4934,578
1400000US48113009611,48113009611,"Census Tract 96.11, Dallas County, Texas",3429,555,1375,344,2054,557
1400000US48113009701,48113009701,"Census Tract 97.01, Dallas County, Texas",4787,426,1738,302,3049,440
1400000US48113009702,48113009702,"Census Tract 97.02, Dallas County, Texas",3024,181,2553,218,471,158
1400000US48113009802,48113009802,"Census Tract 98.02, Dallas County, Texas",6191,583,664,220,5527,594
1400000US48113009803,48113009803,"Census Tract 98.03, Dallas County, Texas",2217,318,851,157,1366,313
1400000US48113009804,48113009804,"Census Tract 98.04, Dallas County, Texas",8116,893,922,362,7194,878
1400000US48113009900,48113009900,"Census Tract 99, Dallas County, Texas",2779,352,1327,228,1452,340
1400000US48113010000,48113010000,"Census Tract 100, Dallas County, Texas",12336,981,10299,832,2037,462
1400000US48113010101,48113010101,"Census Tract 101.01, Dallas County, Texas",4577,612,2245,397,2332,604
1400000US48113010102,48113010102,"Census Tract 101.02, Dallas County, Texas",3089,408,364,202,2725,435
1400000US48113010500,48113010500,"Census Tract 105, Dallas County, Texas",2911,495,1385,332,1526,485
1400000US48113010601,48113010601,"Census Tract 106.01, Dallas County, Texas",6351,568,271,223,6080,633
1400000US48113010602,48113010602,"Census Tract 106.02, Dallas County, Texas",2738,441,686,198,2052,463
1400000US48113010701,48113010701,"Census Tract 107.01, Dallas County, Texas",4608,538,763,272,3845,541
1400000US48113010703,48113010703,"Census Tract 107.03, Dallas County, Texas",3335,327,806,251,2529,293
1400000US48113010704,48113010704,"Census Tract 107.04, Dallas County, Texas",4671,537,1301,366,3370,588
1400000US48113010801,48113010801,"Census Tract 108.01, Dallas County, Texas",9622,640,2224,410,7398,749
1400000US48113010803,48113010803,"Census Tract 108.03, Dallas County, Texas",6830,752,4240,410,2590,788
1400000US48113010804,48113010804,"Census Tract 108.04, Dallas County, Texas",4523,631,1629,428,2894,633
1400000US48113010805,48113010805,"Census Tract 108.05, Dallas County, Texas",5703,527,1778,371,3925,474
1400000US48113010902,48113010902,"Census Tract 109.02, Dallas County, Texas",6034,546,5732,566,302,170
1400000US48113010903,48113010903,"Census Tract 109.03, Dallas County, Texas",3183,441,1967,326,1216,488
1400000US48113010904,48113010904,"Census Tract 109.04, Dallas County, Texas",3717,705,3136,708,581,254
1400000US48113011001,48113011001,"Census Tract 110.01, Dallas County, Texas",6129,530,5875,515,254,189
1400000US48113011002,48113011002,"Census Tract 110.02, Dallas County, Texas",2965,344,2372,259,593,269
1400000US48113011101,48113011101,"Census Tract 111.01, Dallas County, Texas",3984,467,3857,475,127,71
1400000US48113011103,48113011103,"Census Tract 111.03, Dallas County, Texas",3414,525,1802,323,1612,490
1400000US48113011104,48113011104,"Census Tract 111.04, Dallas County, Texas",3526,464,3040,355,486,306
1400000US48113011105,48113011105,"Census Tract 111.05, Dallas County, Texas",3962,517,3197,509,765,305
1400000US48113011200,48113011200,"Census Tract 112, Dallas County, Texas",5806,679,5127,600,679,323
1400000US48113011300,48113011300,"Census Tract 113, Dallas County, Texas",4818,437,4566,450,252,95
1400000US48113011401,48113011401,"Census Tract 114.01, Dallas County, Texas",5360,645,4903,645,457,245
1400000US48113011500,48113011500,"Census Tract 115, Dallas County, Texas",2068,531,887,169,1181,487
1400000US48113011601,48113011601,"Census Tract 116.01, Dallas County, Texas",4987,587,2680,544,2307,718
1400000US48113011602,48113011602,"Census Tract 116.02, Dallas County, Texas",6273,497,1898,311,4375,568
1400000US48113011701,48113011701,"Census Tract 117.01, Dallas County, Texas",7180,659,2376,481,4804,755
1400000US48113011702,48113011702,"Census Tract 117.02, Dallas County, Texas",4912,521,1280,353,3632,595
1400000US48113011800,48113011800,"Census Tract 118, Dallas County, Texas",10113,956,4215,516,5898,841
1400000US48113011900,48113011900,"Census Tract 119, Dallas County, Texas",9097,1181,3915,664,5182,938
1400000US48113012000,48113012000,"Census Tract 120, Dallas County, Texas",6765,670,3586,520,3179,599
1400000US48113012100,48113012100,"Census Tract 121, Dallas County, Texas",6167,570,3307,460,2860,460
1400000US48113012204,48113012204,"Census Tract 122.04, Dallas County, Texas",5909,687,4260,622,1649,525
1400000US48113012206,48113012206,"Census Tract 122.06, Dallas County, Texas",4786,526,3692,507,1094,177
1400000US48113012207,48113012207,"Census Tract 122.07, Dallas County, Texas",7599,755,4061,699,3538,633
1400000US48113012208,48113012208,"Census Tract 122.08, Dallas County, Texas",2488,342,1133,283,1355,329
1400000US48113012209,48113012209,"Census Tract 122.09, Dallas County, Texas",3337,479,1786,288,1551,413
1400000US48113012210,48113012210,"Census Tract 122.10, Dallas County, Texas",4125,633,2652,392,1473,504
1400000US48113012211,48113012211,"Census Tract 122.11, Dallas County, Texas",4484,505,2483,460,2001,394
1400000US48113012301,48113012301,"Census Tract 123.01, Dallas County, Texas",4619,500,1943,382,2676,576
1400000US48113012302,48113012302,"Census Tract 123.02, Dallas County, Texas",7424,642,4695,728,2729,602
1400000US48113012400,48113012400,"Census Tract 124, Dallas County, Texas",4680,403,3051,305,1629,404
1400000US48113012500,48113012500,"Census Tract 125, Dallas County, Texas",7513,723,3286,456,4227,661
1400000US48113012601,48113012601,"Census Tract 126.01, Dallas County, Texas",5766,535,2579,417,3187,602
1400000US48113012603,48113012603,"Census Tract 126.03, Dallas County, Texas",1991,193,913,163,1078,231
1400000US48113012604,48113012604,"Census Tract 126.04, Dallas County, Texas",6607,838,3823,793,2784,757
1400000US48113012701,48113012701,"Census Tract 127.01, Dallas County, Texas",6497,536,2006,372,4491,503
1400000US48113012702,48113012702,"Census Tract 127.02, Dallas County, Texas",3351,486,1029,205,2322,525
1400000US48113012800,48113012800,"Census Tract 128, Dallas County, Texas",7278,615,4709,376,2569,509
1400000US48113012900,48113012900,"Census Tract 129, Dallas County, Texas",4182,327,3717,352,465,186
1400000US48113013004,48113013004,"Census Tract 130.04, Dallas County, Texas",5961,417,5533,429,428,172
1400000US48113013005,48113013005,"Census Tract 130.05, Dallas County, Texas",3420,300,3073,297,347,112
1400000US48113013007,48113013007,"Census Tract 130.07, Dallas County, Texas",3052,453,2122,322,930,389
1400000US48113013008,48113013008,"Census Tract 130.08, Dallas County, Texas",3356,294,2913,369,443,219
1400000US48113013009,48113013009,"Census Tract 130.09, Dallas County, Texas",4471,471,3648,397,823,377
1400000US48113013010,48113013010,"Census Tract 130.10, Dallas County, Texas",4825,538,1912,466,2913,567
1400000US48113013011,48113013011,"Census Tract 130.11, Dallas County, Texas",4768,603,1510,546,3258,559
1400000US48113013101,48113013101,"Census Tract 131.01, Dallas County, Texas",2474,197,2356,187,118,86
1400000US48113013102,48113013102,"Census Tract 131.02, Dallas County, Texas",1554,189,1393,198,161,121
1400000US48113013104,48113013104,"Census Tract 131.04, Dallas County, Texas",1006,173,891,169,115,93
1400000US48113013105,48113013105,"Census Tract 131.05, Dallas County, Texas",6646,796,3755,542,2891,731
1400000US48113013200,48113013200,"Census Tract 132, Dallas County, Texas",6768,621,6111,636,657,314
1400000US48113013300,48113013300,"Census Tract 133, Dallas County, Texas",2231,144,1995,115,236,138
1400000US48113013400,48113013400,"Census Tract 134, Dallas County, Texas",2045,190,1949,199,96,74
1400000US48113013500,48113013500,"Census Tract 135, Dallas County, Texas",2527,210,2463,230,64,67
1400000US48113013605,48113013605,"Census Tract 136.05, Dallas County, Texas",5227,390,4914,300,313,298
1400000US48113013606,48113013606,"Census Tract 136.06, Dallas County, Texas",5831,461,4353,384,1478,539
1400000US48113013607,48113013607,"Census Tract 136.07, Dallas County, Texas",3494,260,3045,259,449,312
1400000US48113013608,48113013608,"Census Tract 136.08, Dallas County, Texas",2567,266,2468,264,99,85
1400000US48113013609,48113013609,"Census Tract 136.09, Dallas County, Texas",3722,391,2625,306,1097,394
1400000US48113013610,48113013610,"Census Tract 136.10, Dallas County, Texas",4703,470,2505,343,2198,540
1400000US48113013611,48113013611,"Census Tract 136.11, Dallas County, Texas",2278,258,2128,253,150,118
1400000US48113013615,48113013615,"Census Tract 136.15, Dallas County, Texas",4532,529,2182,379,2350,549
1400000US48113013616,48113013616,"Census Tract 136.16, Dallas County, Texas",5570,612,4231,528,1339,319
1400000US48113013617,48113013617,"Census Tract 136.17, Dallas County, Texas",2808,206,2346,211,462,216
1400000US48113013618,48113013618,"Census Tract 136.18, Dallas County, Texas",2450,176,2270,150,180,152
1400000US48113013619,48113013619,"Census Tract 136.19, Dallas County, Texas",4996,345,4445,286,551,382
1400000US48113013620,48113013620,"Census Tract 136.20, Dallas County, Texas",4293,431,3897,435,396,219
1400000US48113013621,48113013621,"Census Tract 136.21, Dallas County, Texas",4205,596,3008,448,1197,448
1400000US48113013622,48113013622,"Census Tract 136.22, Dallas County, Texas",3258,431,2225,324,1033,567
1400000US48113013623,48113013623,"Census Tract 136.23, Dallas County, Texas",6411,664,3731,638,2680,649
1400000US48113013624,48113013624,"Census Tract 136.24, Dallas County, Texas",3431,269,2647,253,784,287
1400000US48113013625,48113013625,"Census Tract 136.25, Dallas County, Texas",3004,478,1432,310,1572,513
1400000US48113013626,48113013626,"Census Tract 136.26, Dallas County, Texas",2975,429,1566,328,1409,420
1400000US48113013711,48113013711,"Census Tract 137.11, Dallas County, Texas",2862,385,1042,316,1820,464
1400000US48113013712,48113013712,"Census Tract 137.12, Dallas County, Texas",2258,201,989,131,1269,189
1400000US48113013713,48113013713,"Census Tract 137.13, Dallas County, Texas",1859,281,202,154,1657,325
1400000US48113013714,48113013714,"Census Tract 137.14, Dallas County, Texas",6106,549,1319,263,4787,623
1400000US48113013715,48113013715,"Census Tract 137.15, Dallas County, Texas",2304,202,722,220,1582,297
1400000US48113013716,48113013716,"Census Tract 137.16, Dallas County, Texas",4424,342,2889,270,1535,275
1400000US48113013717,48113013717,"Census Tract 137.17, Dallas County, Texas",2621,291,779,173,1842,298
1400000US48113013718,48113013718,"Census Tract 137.18, Dallas County, Texas",4686,395,1226,255,3460,485
1400000US48113013719,48113013719,"Census Tract 137.19, Dallas County, Texas",3874,330,3111,312,763,254
1400000US48113013720,48113013720,"Census Tract 137.20, Dallas County, Texas",5717,437,3040,296,2677,440
1400000US48113013721,48113013721,"Census Tract 137.21, Dallas County, Texas",5961,402,5134,363,827,272
1400000US48113013722,48113013722,"Census Tract 137.22, Dallas County, Texas",3700,330,3063,297,637,176
1400000US48113013725,48113013725,"Census Tract 137.25, Dallas County, Texas",4059,403,2460,414,1599,362
1400000US48113013726,48113013726,"Census Tract 137.26, Dallas County, Texas",3204,486,1899,354,1305,552
1400000US48113013727,48113013727,"Census Tract 137.27, Dallas County, Texas",3038,277,2600,287,438,251
1400000US48113013803,48113013803,"Census Tract 138.03, Dallas County, Texas",5617,311,4360,351,1257,361
1400000US48113013804,48113013804,"Census Tract 138.04, Dallas County, Texas",3009,255,2043,195,966,291
1400000US48113013805,48113013805,"Census Tract 138.05, Dallas County, Texas",3208,482,1406,362,1802,498
1400000US48113013806,48113013806,"Census Tract 138.06, Dallas County, Texas",2704,272,2280,340,424,180
1400000US48113013901,48113013901,"Census Tract 139.01, Dallas County, Texas",3166,263,1021,209,2145,266
1400000US48113013902,48113013902,"Census Tract 139.02, Dallas County, Texas",3974,290,2355,275,1619,293
1400000US48113014001,48113014001,"Census Tract 140.01, Dallas County, Texas",4256,372,2694,373,1562,470
1400000US48113014002,48113014002,"Census Tract 140.02, Dallas County, Texas",187,75,172,72,15,24
1400000US48113014103,48113014103,"Census Tract 141.03, Dallas County, Texas",3036,355,2011,339,1025,310
1400000US48113014113,48113014113,"Census Tract 141.13, Dallas County, Texas",4444,550,3291,549,1153,367
1400000US48113014114,48113014114,"Census Tract 141.14, Dallas County, Texas",3048,368,1982,261,1066,318
1400000US48113014115,48113014115,"Census Tract 141.15, Dallas County, Texas",7353,661,3847,590,3506,625
1400000US48113014116,48113014116,"Census Tract 141.16, Dallas County, Texas",4089,483,3230,473,859,261
1400000US48113014119,48113014119,"Census Tract 141.19, Dallas County, Texas",4041,200,3789,237,252,148
1400000US48113014120,48113014120,"Census Tract 141.20, Dallas County, Texas",5187,247,4701,250,486,206
1400000US48113014121,48113014121,"Census Tract 141.21, Dallas County, Texas",5372,345,4857,389,515,285
1400000US48113014123,48113014123,"Census Tract 141.23, Dallas County, Texas",5895,214,5326,247,569,183
1400000US48113014124,48113014124,"Census Tract 141.24, Dallas County, Texas",4040,265,3587,306,453,175
1400000US48113014126,48113014126,"Census Tract 141.26, Dallas County, Texas",5683,414,5073,367,610,315
1400000US48113014127,48113014127,"Census Tract 141.27, Dallas County, Texas",8050,611,7555,626,495,238
1400000US48113014128,48113014128,"Census Tract 141.28, Dallas County, Texas",3337,328,3081,355,256,149
1400000US48113014129,48113014129,"Census Tract 141.29, Dallas County, Texas",4760,734,4558,738,202,164
1400000US48113014130,48113014130,"Census Tract 141.30, Dallas County, Texas",3743,693,3176,510,567,560
1400000US48113014131,48113014131,"Census Tract 141.31, Dallas County, Texas",4358,403,3963,433,395,189
1400000US48113014132,48113014132,"Census Tract 141.32, Dallas County, Texas",2358,191,2059,219,299,159
1400000US48113014133,48113014133,"Census Tract 141.33, Dallas County, Texas",4224,397,3466,406,758,327
1400000US48113014134,48113014134,"Census Tract 141.34, Dallas County, Texas",3919,244,3676,253,243,90
1400000US48113014135,48113014135,"Census Tract 141.35, Dallas County, Texas",4466,290,3818,396,648,388
1400000US48113014136,48113014136,"Census Tract 141.36, Dallas County, Texas",5551,481,5034,507,517,247
1400000US48113014137,48113014137,"Census Tract 141.37, Dallas County, Texas",3122,323,2795,314,327,223
1400000US48113014138,48113014138,"Census Tract 141.38, Dallas County, Texas",3422,350,3196,377,226,107
1400000US48113014203,48113014203,"Census Tract 142.03, Dallas County, Texas",3122,358,1760,354,1362,287
1400000US48113014204,48113014204,"Census Tract 142.04, Dallas County, Texas",2183,317,1799,290,384,199
1400000US48113014205,48113014205,"Census Tract 142.05, Dallas County, Texas",1493,163,1403,161,90,77
1400000US48113014206,48113014206,"Census Tract 142.06, Dallas County, Texas",3600,338,2915,319,685,228
1400000US48113014302,48113014302,"Census Tract 143.02, Dallas County, Texas",6928,463,3190,327,3738,459
1400000US48113014306,48113014306,"Census Tract 143.06, Dallas County, Texas",5706,536,2102,319,3604,569
1400000US48113014307,48113014307,"Census Tract 143.07, Dallas County, Texas",4444,328,3444,398,1000,323
1400000US48113014308,48113014308,"Census Tract 143.08, Dallas County, Texas",4399,491,1338,365,3061,533
1400000US48113014309,48113014309,"Census Tract 143.09, Dallas County, Texas",4792,521,2554,401,2238,520
1400000US48113014310,48113014310,"Census Tract 143.10, Dallas County, Texas",4213,425,3062,364,1151,323
1400000US48113014311,48113014311,"Census Tract 143.11, Dallas County, Texas",4891,569,4690,592,201,193
1400000US48113014312,48113014312,"Census Tract 143.12, Dallas County, Texas",5055,449,4337,449,718,355
1400000US48113014403,48113014403,"Census Tract 144.03, Dallas County, Texas",3650,410,1967,360,1683,421
1400000US48113014405,48113014405,"Census Tract 144.05, Dallas County, Texas",3674,517,954,260,2720,507
1400000US48113014406,48113014406,"Census Tract 144.06, Dallas County, Texas",4508,530,1622,202,2886,520
1400000US48113014407,48113014407,"Census Tract 144.07, Dallas County, Texas",4638,460,2011,322,2627,544
1400000US48113014408,48113014408,"Census Tract 144.08, Dallas County, Texas",4514,483,2523,471,1991,421
1400000US48113014501,48113014501,"Census Tract 145.01, Dallas County, Texas",3575,424,1555,235,2020,503
1400000US48113014502,48113014502,"Census Tract 145.02, Dallas County, Texas",4156,566,1812,365,2344,516
1400000US48113014601,48113014601,"Census Tract 146.01, Dallas County, Texas",2104,322,1119,184,985,304
1400000US48113014602,48113014602,"Census Tract 146.02, Dallas County, Texas",5053,577,1440,299,3613,552
1400000US48113014603,48113014603,"Census Tract 146.03, Dallas County, Texas",1813,327,482,137,1331,303
1400000US48113014701,48113014701,"Census Tract 147.01, Dallas County, Texas",4256,519,918,251,3338,522
1400000US48113014702,48113014702,"Census Tract 147.02, Dallas County, Texas",3875,418,909,136,2966,398
1400000US48113014703,48113014703,"Census Tract 147.03, Dallas County, Texas",1648,254,492,140,1156,267
1400000US48113014901,48113014901,"Census Tract 149.01, Dallas County, Texas",1629,292,356,111,1273,301
1400000US48113014902,48113014902,"Census Tract 149.02, Dallas County, Texas",2398,431,908,218,1490,456
1400000US48113015000,48113015000,"Census Tract 150, Dallas County, Texas",8178,670,2622,573,5556,709
1400000US48113015100,48113015100,"Census Tract 151, Dallas County, Texas",6952,653,3006,472,3946,756
1400000US48113015202,48113015202,"Census Tract 152.02, Dallas County, Texas",3649,557,718,157,2931,555
1400000US48113015204,48113015204,"Census Tract 152.04, Dallas County, Texas",7632,612,3668,382,3964,557
1400000US48113015205,48113015205,"Census Tract 152.05, Dallas County, Texas",3557,399,915,258,2642,425
1400000US48113015206,48113015206,"Census Tract 152.06, Dallas County, Texas",3932,380,1752,306,2180,320
1400000US48113015303,48113015303,"Census Tract 153.03, Dallas County, Texas",2033,468,733,211,1300,451
1400000US48113015304,48113015304,"Census Tract 153.04, Dallas County, Texas",3206,405,1484,290,1722,440
1400000US48113015305,48113015305,"Census Tract 153.05, Dallas County, Texas",4337,409,2072,249,2265,368
1400000US48113015306,48113015306,"Census Tract 153.06, Dallas County, Texas",5089,383,3510,356,1579,378
1400000US48113015401,48113015401,"Census Tract 154.01, Dallas County, Texas",5886,603,4636,443,1250,538
1400000US48113015403,48113015403,"Census Tract 154.03, Dallas County, Texas",3105,398,1262,277,1843,390
1400000US48113015404,48113015404,"Census Tract 154.04, Dallas County, Texas",4379,490,1630,279,2749,514
1400000US48113015500,48113015500,"Census Tract 155, Dallas County, Texas",4291,400,1551,329,2740,430
1400000US48113015600,48113015600,"Census Tract 156, Dallas County, Texas",4994,522,974,324,4020,470
1400000US48113015700,48113015700,"Census Tract 157, Dallas County, Texas",2480,400,676,158,1804,430
1400000US48113015800,48113015800,"Census Tract 158, Dallas County, Texas",2345,393,448,169,1897,428
1400000US48113015900,48113015900,"Census Tract 159, Dallas County, Texas",3900,390,1884,265,2016,371
1400000US48113016001,48113016001,"Census Tract 160.01, Dallas County, Texas",4590,573,1347,336,3243,662
1400000US48113016002,48113016002,"Census Tract 160.02, Dallas County, Texas",2717,392,680,242,2037,482
1400000US48113016100,48113016100,"Census Tract 161, Dallas County, Texas",4049,339,2655,441,1394,340
1400000US48113016201,48113016201,"Census Tract 162.01, Dallas County, Texas",4437,532,1586,299,2851,566
1400000US48113016202,48113016202,"Census Tract 162.02, Dallas County, Texas",7217,749,3315,546,3902,752
1400000US48113016301,48113016301,"Census Tract 163.01, Dallas County, Texas",5928,610,2053,371,3875,583
1400000US48113016302,48113016302,"Census Tract 163.02, Dallas County, Texas",2135,298,704,181,1431,354
1400000US48113016401,48113016401,"Census Tract 164.01, Dallas County, Texas",9107,836,4950,784,4157,553
1400000US48113016406,48113016406,"Census Tract 164.06, Dallas County, Texas",4802,483,1819,431,2983,728
1400000US48113016407,48113016407,"Census Tract 164.07, Dallas County, Texas",7529,575,2644,488,4885,609
1400000US48113016408,48113016408,"Census Tract 164.08, Dallas County, Texas",6385,609,3072,387,3313,604
1400000US48113016409,48113016409,"Census Tract 164.09, Dallas County, Texas",3473,266,2520,236,953,208
1400000US48113016410,48113016410,"Census Tract 164.10, Dallas County, Texas",5380,527,3897,492,1483,400
1400000US48113016411,48113016411,"Census Tract 164.11, Dallas County, Texas",9202,647,6139,558,3063,541
1400000US48113016412,48113016412,"Census Tract 164.12, Dallas County, Texas",4104,285,3178,264,926,222
1400000US48113016413,48113016413,"Census Tract 164.13, Dallas County, Texas",7356,538,5336,511,2020,687
1400000US48113016502,48113016502,"Census Tract 165.02, Dallas County, Texas",6969,660,3444,484,3525,758
1400000US48113016509,48113016509,"Census Tract 165.09, Dallas County, Texas",5745,441,4448,508,1297,311
1400000US48113016510,48113016510,"Census Tract 165.10, Dallas County, Texas",11495,1173,7726,984,3769,556
1400000US48113016511,48113016511,"Census Tract 165.11, Dallas County, Texas",3790,362,2503,296,1287,305
1400000US48113016513,48113016513,"Census Tract 165.13, Dallas County, Texas",5101,288,4335,290,766,195
1400000US48113016514,48113016514,"Census Tract 165.14, Dallas County, Texas",7459,758,5766,778,1693,665
1400000US48113016516,48113016516,"Census Tract 165.16, Dallas County, Texas",5497,544,2617,370,2880,641
1400000US48113016517,48113016517,"Census Tract 165.17, Dallas County, Texas",4661,381,2971,344,1690,309
1400000US48113016518,48113016518,"Census Tract 165.18, Dallas County, Texas",4824,507,3006,404,1818,503
1400000US48113016519,48113016519,"Census Tract 165.19, Dallas County, Texas",2257,200,1596,175,661,172
1400000US48113016520,48113016520,"Census Tract 165.20, Dallas County, Texas",6815,765,3276,654,3539,687
1400000US48113016521,48113016521,"Census Tract 165.21, Dallas County, Texas",5259,535,4612,507,647,330
1400000US48113016522,48113016522,"Census Tract 165.22, Dallas County, Texas",3204,343,2629,227,575,343
1400000US48113016523,48113016523,"Census Tract 165.23, Dallas County, Texas",4133,440,3715,394,418,258
1400000US48113016605,48113016605,"Census Tract 166.05, Dallas County, Texas",6602,606,4964,585,1638,385
1400000US48113016606,48113016606,"Census Tract 166.06, Dallas County, Texas",6794,602,5201,541,1593,305
1400000US48113016607,48113016607,"Census Tract 166.07, Dallas County, Texas",3029,339,2664,351,365,200
1400000US48113016610,48113016610,"Census Tract 166.10, Dallas County, Texas",4304,356,4050,356,254,91
1400000US48113016611,48113016611,"Census Tract 166.11, Dallas County, Texas",6143,508,5617,509,526,206
1400000US48113016612,48113016612,"Census Tract 166.12, Dallas County, Texas",13389,772,12159,843,1230,577
1400000US48113016615,48113016615,"Census Tract 166.15, Dallas County, Texas",4018,367,3476,361,542,210
1400000US48113016616,48113016616,"Census Tract 166.16, Dallas County, Texas",5530,446,4504,568,1026,317
1400000US48113016617,48113016617,"Census Tract 166.17, Dallas County, Texas",4500,378,4239,392,261,136
1400000US48113016618,48113016618,"Census Tract 166.18, Dallas County, Texas",4208,406,3817,431,391,138
1400000US48113016619,48113016619,"Census Tract 166.19, Dallas County, Texas",3709,343,3181,364,528,186
1400000US48113016620,48113016620,"Census Tract 166.20, Dallas County, Texas",5383,452,4831,473,552,142
1400000US48113016621,48113016621,"Census Tract 166.21, Dallas County, Texas",4743,482,3907,520,836,403
1400000US48113016622,48113016622,"Census Tract 166.22, Dallas County, Texas",3757,481,2993,579,764,348
1400000US48113016623,48113016623,"Census Tract 166.23, Dallas County, Texas",5880,630,4729,633,1151,374
1400000US48113016624,48113016624,"Census Tract 166.24, Dallas County, Texas",3424,297,2806,344,618,197
1400000US48113016625,48113016625,"Census Tract 166.25, Dallas County, Texas",8819,593,7888,559,931,306
1400000US48113016626,48113016626,"Census Tract 166.26, Dallas County, Texas",4525,463,3516,566,1009,450
1400000US48113016701,48113016701,"Census Tract 167.01, Dallas County, Texas",5829,575,5729,591,100,97
1400000US48113016703,48113016703,"Census Tract 167.03, Dallas County, Texas",10612,678,7913,662,2699,569
1400000US48113016704,48113016704,"Census Tract 167.04, Dallas County, Texas",3760,341,3279,363,481,203
1400000US48113016705,48113016705,"Census Tract 167.05, Dallas County, Texas",6167,681,5192,602,975,436
1400000US48113016802,48113016802,"Census Tract 168.02, Dallas County, Texas",3008,356,2465,335,543,142
1400000US48113016803,48113016803,"Census Tract 168.03, Dallas County, Texas",6125,612,4704,540,1421,557
1400000US48113016804,48113016804,"Census Tract 168.04, Dallas County, Texas",7423,699,6415,676,1008,709
1400000US48113016902,48113016902,"Census Tract 169.02, Dallas County, Texas",6457,188,4433,330,2024,294
1400000US48113016903,48113016903,"Census Tract 169.03, Dallas County, Texas",4666,284,2540,332,2126,393
1400000US48113017001,48113017001,"Census Tract 170.01, Dallas County, Texas",9057,704,7259,755,1798,485
1400000US48113017003,48113017003,"Census Tract 170.03, Dallas County, Texas",8980,648,5787,669,3193,594
1400000US48113017004,48113017004,"Census Tract 170.04, Dallas County, Texas",7883,988,2622,382,5261,938
1400000US48113017101,48113017101,"Census Tract 171.01, Dallas County, Texas",4471,560,1988,380,2483,484
1400000US48113017102,48113017102,"Census Tract 171.02, Dallas County, Texas",4989,690,2235,361,2754,639
1400000US48113017201,48113017201,"Census Tract 172.01, Dallas County, Texas",5660,502,2655,386,3005,548
1400000US48113017202,48113017202,"Census Tract 172.02, Dallas County, Texas",8936,742,5413,647,3523,729
1400000US48113017301,48113017301,"Census Tract 173.01, Dallas County, Texas",5649,466,3294,308,2355,377
1400000US48113017303,48113017303,"Census Tract 173.03, Dallas County, Texas",7635,474,5487,525,2148,349
1400000US48113017304,48113017304,"Census Tract 173.04, Dallas County, Texas",9657,862,6844,623,2813,910
1400000US48113017305,48113017305,"Census Tract 173.05, Dallas County, Texas",9945,692,7867,573,2078,521
1400000US48113017306,48113017306,"Census Tract 173.06, Dallas County, Texas",7710,553,4909,467,2801,566
1400000US48113017400,48113017400,"Census Tract 174, Dallas County, Texas",5549,608,3908,348,1641,542
1400000US48113017500,48113017500,"Census Tract 175, Dallas County, Texas",3926,375,3296,459,630,242
1400000US48113017602,48113017602,"Census Tract 176.02, Dallas County, Texas",4005,388,2221,347,1784,439
1400000US48113017604,48113017604,"Census Tract 176.04, Dallas County, Texas",3280,426,1487,247,1793,516
1400000US48113017605,48113017605,"Census Tract 176.05, Dallas County, Texas",4230,573,1539,310,2691,604
1400000US48113017606,48113017606,"Census Tract 176.06, Dallas County, Texas",4441,447,2530,368,1911,422
1400000US48113017702,48113017702,"Census Tract 177.02, Dallas County, Texas",8581,647,6555,726,2026,544
1400000US48113017703,48113017703,"Census Tract 177.03, Dallas County, Texas",4078,464,1993,373,2085,521
1400000US48113017704,48113017704,"Census Tract 177.04, Dallas County, Texas",5239,495,3288,533,1951,475
1400000US48113017804,48113017804,"Census Tract 178.04, Dallas County, Texas",6258,582,4202,526,2056,623
1400000US48113017805,48113017805,"Census Tract 178.05, Dallas County, Texas",6220,564,3832,543,2388,620
1400000US48113017806,48113017806,"Census Tract 178.06, Dallas County, Texas",4540,410,2681,331,1859,468
1400000US48113017807,48113017807,"Census Tract 178.07, Dallas County, Texas",4947,568,2966,447,1981,596
1400000US48113017808,48113017808,"Census Tract 178.08, Dallas County, Texas",4391,372,3841,457,550,236
1400000US48113017811,48113017811,"Census Tract 178.11, Dallas County, Texas",4394,312,3124,378,1270,303
1400000US48113017812,48113017812,"Census Tract 178.12, Dallas County, Texas",2157,201,1880,243,277,184
1400000US48113017813,48113017813,"Census Tract 178.13, Dallas County, Texas",6088,713,4104,621,1984,638
1400000US48113017814,48113017814,"Census Tract 178.14, Dallas County, Texas",5558,390,4587,369,971,391
1400000US48113017900,48113017900,"Census Tract 179, Dallas County, Texas",5136,512,2164,317,2972,527
1400000US48113018001,48113018001,"Census Tract 180.01, Dallas County, Texas",6169,663,3775,548,2394,482
1400000US48113018002,48113018002,"Census Tract 180.02, Dallas County, Texas",3886,360,1988,254,1898,404
1400000US48113018104,48113018104,"Census Tract 181.04, Dallas County, Texas",6791,421,5937,439,854,187
1400000US48113018105,48113018105,"Census Tract 181.05, Dallas County, Texas",6335,573,2556,432,3779,538
1400000US48113018110,48113018110,"Census Tract 181.10, Dallas County, Texas",4581,360,4259,423,322,299
1400000US48113018111,48113018111,"Census Tract 181.11, Dallas County, Texas",6823,694,4414,646,2409,409
1400000US48113018118,48113018118,"Census Tract 181.18, Dallas County, Texas",7917,619,6110,508,1807,543
1400000US48113018120,48113018120,"Census Tract 181.20, Dallas County, Texas",4574,434,3338,299,1236,376
1400000US48113018121,48113018121,"Census Tract 181.21, Dallas County, Texas",5525,375,2789,461,2736,328
1400000US48113018122,48113018122,"Census Tract 181.22, Dallas County, Texas",12373,545,9740,754,2633,613
1400000US48113018123,48113018123,"Census Tract 181.23, Dallas County, Texas",7844,525,5968,571,1876,421
1400000US48113018124,48113018124,"Census Tract 181.24, Dallas County, Texas",17127,885,14363,780,2764,579
1400000US48113018126,48113018126,"Census Tract 181.26, Dallas County, Texas",5818,486,3926,418,1892,449
1400000US48113018127,48113018127,"Census Tract 181.27, Dallas County, Texas",3206,307,1627,288,1579,230
1400000US48113018128,48113018128,"Census Tract 181.28, Dallas County, Texas",5574,546,3017,378,2557,490
1400000US48113018129,48113018129,"Census Tract 181.29, Dallas County, Texas",4585,426,3773,431,812,212
1400000US48113018130,48113018130,"Census Tract 181.30, Dallas County, Texas",4029,397,3109,355,920,380
1400000US48113018132,48113018132,"Census Tract 181.32, Dallas County, Texas",5722,398,4292,449,1430,226
1400000US48113018133,48113018133,"Census Tract 181.33, Dallas County, Texas",3986,288,2957,336,1029,240
1400000US48113018134,48113018134,"Census Tract 181.34, Dallas County, Texas",5386,538,4585,447,801,375
1400000US48113018135,48113018135,"Census Tract 181.35, Dallas County, Texas",3416,603,2790,526,626,269
1400000US48113018136,48113018136,"Census Tract 181.36, Dallas County, Texas",8168,487,7035,479,1133,407
1400000US48113018137,48113018137,"Census Tract 181.37, Dallas County, Texas",3892,492,2972,478,920,339
1400000US48113018138,48113018138,"Census Tract 181.38, Dallas County, Texas",4279,482,3444,515,835,398
1400000US48113018139,48113018139,"Census Tract 181.39, Dallas County, Texas",6006,551,4781,514,1225,371
1400000US48113018140,48113018140,"Census Tract 181.40, Dallas County, Texas",5356,390,4466,308,890,311
1400000US48113018141,48113018141,"Census Tract 181.41, Dallas County, Texas",3470,578,2340,425,1130,397
1400000US48113018142,48113018142,"Census Tract 181.42, Dallas County, Texas",3146,278,2380,296,766,263
1400000US48113018203,48113018203,"Census Tract 182.03, Dallas County, Texas",6408,543,3273,458,3135,440
1400000US48113018204,48113018204,"Census Tract 182.04, Dallas County, Texas",4476,394,1144,245,3332,460
1400000US48113018205,48113018205,"Census Tract 182.05, Dallas County, Texas",4304,375,1690,335,2614,396
1400000US48113018206,48113018206,"Census Tract 182.06, Dallas County, Texas",4973,456,1564,292,3409,490
1400000US48113018300,48113018300,"Census Tract 183, Dallas County, Texas",6775,571,2770,402,4005,718
1400000US48113018401,48113018401,"Census Tract 184.01, Dallas County, Texas",4937,539,1707,229,3230,521
1400000US48113018402,48113018402,"Census Tract 184.02, Dallas County, Texas",3458,473,2292,220,1166,412
1400000US48113018403,48113018403,"Census Tract 184.03, Dallas County, Texas",856,111,478,78,378,124
1400000US48113018501,48113018501,"Census Tract 185.01, Dallas County, Texas",3575,422,1862,284,1713,400
1400000US48113018503,48113018503,"Census Tract 185.03, Dallas County, Texas",4834,574,3707,457,1127,448
1400000US48113018505,48113018505,"Census Tract 185.05, Dallas County, Texas",3076,494,1978,378,1098,455
1400000US48113018506,48113018506,"Census Tract 185.06, Dallas County, Texas",3134,543,1777,416,1357,458
1400000US48113018600,48113018600,"Census Tract 186, Dallas County, Texas",3317,298,2052,264,1265,234
1400000US48113018700,48113018700,"Census Tract 187, Dallas County, Texas",6157,711,1712,252,4445,766
1400000US48113018801,48113018801,"Census Tract 188.01, Dallas County, Texas",4404,399,2073,304,2331,462
1400000US48113018802,48113018802,"Census Tract 188.02, Dallas County, Texas",937,258,460,182,477,151
1400000US48113018900,48113018900,"Census Tract 189, Dallas County, Texas",6466,630,3673,596,2793,570
1400000US48113019004,48113019004,"Census Tract 190.04, Dallas County, Texas",6759,472,4584,425,2175,413
1400000US48113019013,48113019013,"Census Tract 190.13, Dallas County, Texas",5816,497,1257,268,4559,563
1400000US48113019014,48113019014,"Census Tract 190.14, Dallas County, Texas",7755,833,2866,721,4889,1005
1400000US48113019016,48113019016,"Census Tract 190.16, Dallas County, Texas",2951,380,2300,366,651,339
1400000US48113019018,48113019018,"Census Tract 190.18, Dallas County, Texas",5094,691,4076,737,1018,519
1400000US48113019019,48113019019,"Census Tract 190.19, Dallas County, Texas",6744,739,4791,567,1953,581
1400000US48113019020,48113019020,"Census Tract 190.20, Dallas County, Texas",5475,652,4614,683,861,290
1400000US48113019021,48113019021,"Census Tract 190.21, Dallas County, Texas",7498,628,4232,454,3266,606
1400000US48113019023,48113019023,"Census Tract 190.23, Dallas County, Texas",4933,323,4483,341,450,241
1400000US48113019024,48113019024,"Census Tract 190.24, Dallas County, Texas",4438,540,3685,616,753,187
1400000US48113019025,48113019025,"Census Tract 190.25, Dallas County, Texas",5195,299,4469,344,726,276
1400000US48113019026,48113019026,"Census Tract 190.26, Dallas County, Texas",5616,503,4153,443,1463,450
1400000US48113019027,48113019027,"Census Tract 190.27, Dallas County, Texas",4563,334,4239,368,324,171
1400000US48113019028,48113019028,"Census Tract 190.28, Dallas County, Texas",3695,310,2677,310,1018,365
1400000US48113019029,48113019029,"Census Tract 190.29, Dallas County, Texas",6004,597,4710,552,1294,387
1400000US48113019031,48113019031,"Census Tract 190.31, Dallas County, Texas",6269,303,5218,340,1051,281
1400000US48113019032,48113019032,"Census Tract 190.32, Dallas County, Texas",4382,406,1616,205,2766,428
1400000US48113019033,48113019033,"Census Tract 190.33, Dallas County, Texas",4453,505,1790,309,2663,490
1400000US48113019034,48113019034,"Census Tract 190.34, Dallas County, Texas",4024,403,3353,347,671,295
1400000US48113019035,48113019035,"Census Tract 190.35, Dallas County, Texas",4187,563,2291,379,1896,472
1400000US48113019036,48113019036,"Census Tract 190.36, Dallas County, Texas",2698,174,2509,179,189,128
1400000US48113019037,48113019037,"Census Tract 190.37, Dallas County, Texas",3616,222,3243,244,373,142
1400000US48113019038,48113019038,"Census Tract 190.38, Dallas County, Texas",692,199,672,200,20,24
1400000US48113019039,48113019039,"Census Tract 190.39, Dallas County, Texas",6254,500,4906,519,1348,552
1400000US48113019040,48113019040,"Census Tract 190.40, Dallas County, Texas",5401,502,5026,517,375,166
1400000US48113019041,48113019041,"Census Tract 190.41, Dallas County, Texas",2670,270,2602,272,68,86
1400000US48113019042,48113019042,"Census Tract 190.42, Dallas County, Texas",5237,559,4143,471,1094,536
1400000US48113019043,48113019043,"Census Tract 190.43, Dallas County, Texas",7239,533,6800,427,439,322
1400000US48113019100,48113019100,"Census Tract 191, Dallas County, Texas",5713,645,4677,657,1036,264
1400000US48113019202,48113019202,"Census Tract 192.02, Dallas County, Texas",4632,596,2934,325,1698,630
1400000US48113019203,48113019203,"Census Tract 192.03, Dallas County, Texas",3456,350,2980,258,476,275
1400000US48113019204,48113019204,"Census Tract 192.04, Dallas County, Texas",8901,818,3722,495,5179,1090
1400000US48113019205,48113019205,"Census Tract 192.05, Dallas County, Texas",3455,266,3179,179,276,283
1400000US48113019206,48113019206,"Census Tract 192.06, Dallas County, Texas",5703,437,4829,464,874,343
1400000US48113019208,48113019208,"Census Tract 192.08, Dallas County, Texas",6337,598,1948,343,4389,656
1400000US48113019210,48113019210,"Census Tract 192.10, Dallas County, Texas",3828,219,3681,239,147,102
1400000US48113019211,48113019211,"Census Tract 192.11, Dallas County, Texas",4943,345,4138,349,805,198
1400000US48113019212,48113019212,"Census Tract 192.12, Dallas County, Texas",3575,519,106,85,3469,532
1400000US48113019213,48113019213,"Census Tract 192.13, Dallas County, Texas",3131,470,1325,354,1806,513
1400000US48113019301,48113019301,"Census Tract 193.01, Dallas County, Texas",2779,157,2621,215,158,192
1400000US48113019302,48113019302,"Census Tract 193.02, Dallas County, Texas",5322,350,4815,356,507,191
1400000US48113019400,48113019400,"Census Tract 194, Dallas County, Texas",3960,259,3864,254,96,74
1400000US48113019501,48113019501,"Census Tract 195.01, Dallas County, Texas",6788,310,6697,334,91,118
1400000US48113019502,48113019502,"Census Tract 195.02, Dallas County, Texas",4392,305,4243,327,149,130
1400000US48113019600,48113019600,"Census Tract 196, Dallas County, Texas",2526,277,2310,279,216,128
1400000US48113019700,48113019700,"Census Tract 197, Dallas County, Texas",1967,179,1846,229,121,136
1400000US48113019800,48113019800,"Census Tract 198, Dallas County, Texas",4130,275,3833,287,297,171
1400000US48113019900,48113019900,"Census Tract 199, Dallas County, Texas",4227,27,607,290,3620,290
1400000US48113020000,48113020000,"Census Tract 200, Dallas County, Texas",4211,252,3777,351,434,277
1400000US48113020100,48113020100,"Census Tract 201, Dallas County, Texas",2443,321,865,161,1578,322
1400000US48113020200,48113020200,"Census Tract 202, Dallas County, Texas",3779,542,3704,535,75,114
1400000US48113020300,48113020300,"Census Tract 203, Dallas County, Texas",2417,321,2309,321,108,91
1400000US48113020400,48113020400,"Census Tract 204, Dallas County, Texas",4566,573,3714,536,852,234
1400000US48113020500,48113020500,"Census Tract 205, Dallas County, Texas",4854,579,3179,473,1675,405
1400000US48113020600,48113020600,"Census Tract 206, Dallas County, Texas",2429,264,2289,271,140,71
1400000US48113020700,48113020700,"Census Tract 207, Dallas County, Texas",4797,327,4018,342,779,214
1400000US48113980000,48113980000,"Census Tract 9800, Dallas County, Texas",0,13,0,13,0,13
1400000US48113980100,48113980100,"Census Tract 9801, Dallas County, Texas",0,13,0,13,0,13
1400000US48115950401,48115950401,"Census Tract 9504.01, Dawson County, Texas",4754,409,2171,256,2583,448
1400000US48115950402,48115950402,"Census Tract 9504.02, Dawson County, Texas",3915,332,1692,224,2223,267
1400000US48115950500,48115950500,"Census Tract 9505, Dawson County, Texas",3386,363,1460,211,1926,381
1400000US48115950600,48115950600,"Census Tract 9506, Dawson County, Texas",1706,276,1084,225,622,161
1400000US48117950300,48117950300,"Census Tract 9503, Deaf Smith County, Texas",6008,438,2310,309,3698,364
1400000US48117950400,48117950400,"Census Tract 9504, Deaf Smith County, Texas",5808,468,1667,322,4141,443
1400000US48117950500,48117950500,"Census Tract 9505, Deaf Smith County, Texas",3498,476,455,159,3043,468
1400000US48117950600,48117950600,"Census Tract 9506, Deaf Smith County, Texas",3961,131,1836,279,2125,267
1400000US48119950100,48119950100,"Census Tract 9501, Delta County, Texas",3159,217,3015,201,144,81
1400000US48119950200,48119950200,"Census Tract 9502, Delta County, Texas",2081,217,1923,201,158,81
1400000US48121020103,48121020103,"Census Tract 201.03, Denton County, Texas",10025,465,8238,644,1787,566
1400000US48121020104,48121020104,"Census Tract 201.04, Denton County, Texas",3176,333,2705,305,471,194
1400000US48121020105,48121020105,"Census Tract 201.05, Denton County, Texas",6411,734,5362,726,1049,381
1400000US48121020106,48121020106,"Census Tract 201.06, Denton County, Texas",5989,378,5251,410,738,210
1400000US48121020107,48121020107,"Census Tract 201.07, Denton County, Texas",4652,339,3924,362,728,169
1400000US48121020108,48121020108,"Census Tract 201.08, Denton County, Texas",9093,835,7665,767,1428,406
1400000US48121020109,48121020109,"Census Tract 201.09, Denton County, Texas",2116,253,1960,285,156,144
1400000US48121020110,48121020110,"Census Tract 201.10, Denton County, Texas",5080,371,4529,378,551,187
1400000US48121020111,48121020111,"Census Tract 201.11, Denton County, Texas",3814,296,3419,387,395,266
1400000US48121020112,48121020112,"Census Tract 201.12, Denton County, Texas",2910,330,2604,352,306,130
1400000US48121020113,48121020113,"Census Tract 201.13, Denton County, Texas",9370,746,6992,733,2378,411
1400000US48121020114,48121020114,"Census Tract 201.14, Denton County, Texas",8388,891,5531,1060,2857,559
1400000US48121020115,48121020115,"Census Tract 201.15, Denton County, Texas",4613,595,3262,537,1351,396
1400000US48121020202,48121020202,"Census Tract 202.02, Denton County, Texas",8572,627,7045,599,1527,554
1400000US48121020203,48121020203,"Census Tract 202.03, Denton County, Texas",5027,374,4235,424,792,242
1400000US48121020204,48121020204,"Census Tract 202.04, Denton County, Texas",3778,457,3536,484,242,139
1400000US48121020205,48121020205,"Census Tract 202.05, Denton County, Texas",1602,317,1409,217,193,159
1400000US48121020303,48121020303,"Census Tract 203.03, Denton County, Texas",9934,585,8775,527,1159,365
1400000US48121020305,48121020305,"Census Tract 203.05, Denton County, Texas",6742,432,6482,447,260,144
1400000US48121020306,48121020306,"Census Tract 203.06, Denton County, Texas",6491,474,5729,488,762,267
1400000US48121020307,48121020307,"Census Tract 203.07, Denton County, Texas",7683,472,6792,526,891,261
1400000US48121020308,48121020308,"Census Tract 203.08, Denton County, Texas",9790,755,7637,681,2153,550
1400000US48121020309,48121020309,"Census Tract 203.09, Denton County, Texas",8989,673,8270,729,719,216
1400000US48121020310,48121020310,"Census Tract 203.10, Denton County, Texas",2587,235,2235,187,352,149
1400000US48121020401,48121020401,"Census Tract 204.01, Denton County, Texas",6260,624,4688,580,1572,504
1400000US48121020402,48121020402,"Census Tract 204.02, Denton County, Texas",4673,334,3933,316,740,181
1400000US48121020403,48121020403,"Census Tract 204.03, Denton County, Texas",3719,286,3155,337,564,264
1400000US48121020503,48121020503,"Census Tract 205.03, Denton County, Texas",5977,518,4969,548,1008,343
1400000US48121020504,48121020504,"Census Tract 205.04, Denton County, Texas",2785,433,1845,328,940,221
1400000US48121020505,48121020505,"Census Tract 205.05, Denton County, Texas",6766,427,6061,452,705,482
1400000US48121020506,48121020506,"Census Tract 205.06, Denton County, Texas",1745,232,1430,206,315,238
1400000US48121020601,48121020601,"Census Tract 206.01, Denton County, Texas",5265,476,3738,447,1527,469
1400000US48121020602,48121020602,"Census Tract 206.02, Denton County, Texas",8426,696,5689,727,2737,594
1400000US48121020700,48121020700,"Census Tract 207, Denton County, Texas",3613,458,3131,404,482,148
1400000US48121020800,48121020800,"Census Tract 208, Denton County, Texas",4713,594,4002,530,711,279
1400000US48121020900,48121020900,"Census Tract 209, Denton County, Texas",4493,512,3183,424,1310,331
1400000US48121021000,48121021000,"Census Tract 210, Denton County, Texas",6825,557,5495,491,1330,396
1400000US48121021100,48121021100,"Census Tract 211, Denton County, Texas",2424,229,2192,217,232,86
1400000US48121021201,48121021201,"Census Tract 212.01, Denton County, Texas",5565,525,4241,479,1324,322
1400000US48121021202,48121021202,"Census Tract 212.02, Denton County, Texas",4996,469,3228,371,1768,301
1400000US48121021301,48121021301,"Census Tract 213.01, Denton County, Texas",2586,253,2240,233,346,126
1400000US48121021303,48121021303,"Census Tract 213.03, Denton County, Texas",6635,608,5819,672,816,383
1400000US48121021304,48121021304,"Census Tract 213.04, Denton County, Texas",5745,650,4121,639,1624,677
1400000US48121021305,48121021305,"Census Tract 213.05, Denton County, Texas",3795,304,3436,359,359,236
1400000US48121021403,48121021403,"Census Tract 214.03, Denton County, Texas",9661,438,8152,459,1509,298
1400000US48121021404,48121021404,"Census Tract 214.04, Denton County, Texas",8303,385,7638,442,665,206
1400000US48121021405,48121021405,"Census Tract 214.05, Denton County, Texas",9609,959,6144,662,3465,774
1400000US48121021406,48121021406,"Census Tract 214.06, Denton County, Texas",6859,413,5543,432,1316,381
1400000US48121021407,48121021407,"Census Tract 214.07, Denton County, Texas",6776,513,5162,522,1614,514
1400000US48121021408,48121021408,"Census Tract 214.08, Denton County, Texas",5976,412,5145,431,831,356
1400000US48121021409,48121021409,"Census Tract 214.09, Denton County, Texas",7875,488,7119,474,756,220
1400000US48121021502,48121021502,"Census Tract 215.02, Denton County, Texas",4621,357,2632,282,1989,386
1400000US48121021505,48121021505,"Census Tract 215.05, Denton County, Texas",5919,440,5024,455,895,356
1400000US48121021512,48121021512,"Census Tract 215.12, Denton County, Texas",4645,305,4498,335,147,92
1400000US48121021513,48121021513,"Census Tract 215.13, Denton County, Texas",3556,219,3297,240,259,176
1400000US48121021514,48121021514,"Census Tract 215.14, Denton County, Texas",4111,235,3855,282,256,120
1400000US48121021515,48121021515,"Census Tract 215.15, Denton County, Texas",5801,539,4464,534,1337,443
1400000US48121021516,48121021516,"Census Tract 215.16, Denton County, Texas",6633,523,5031,460,1602,372
1400000US48121021517,48121021517,"Census Tract 215.17, Denton County, Texas",2188,211,1948,287,240,216
1400000US48121021518,48121021518,"Census Tract 215.18, Denton County, Texas",3316,242,3177,260,139,136
1400000US48121021519,48121021519,"Census Tract 215.19, Denton County, Texas",11692,600,9960,580,1732,302
1400000US48121021520,48121021520,"Census Tract 215.20, Denton County, Texas",3726,394,3030,542,696,441
1400000US48121021521,48121021521,"Census Tract 215.21, Denton County, Texas",4423,380,3432,356,991,363
1400000US48121021522,48121021522,"Census Tract 215.22, Denton County, Texas",869,172,784,181,85,51
1400000US48121021523,48121021523,"Census Tract 215.23, Denton County, Texas",3710,482,2337,382,1373,438
1400000US48121021524,48121021524,"Census Tract 215.24, Denton County, Texas",1618,146,1478,175,140,108
1400000US48121021525,48121021525,"Census Tract 215.25, Denton County, Texas",7774,419,6886,401,888,376
1400000US48121021526,48121021526,"Census Tract 215.26, Denton County, Texas",5997,316,5570,354,427,193
1400000US48121021527,48121021527,"Census Tract 215.27, Denton County, Texas",5949,547,5635,559,314,166
1400000US48121021611,48121021611,"Census Tract 216.11, Denton County, Texas",3951,268,3194,285,757,172
1400000US48121021612,48121021612,"Census Tract 216.12, Denton County, Texas",3354,352,2621,256,733,310
1400000US48121021613,48121021613,"Census Tract 216.13, Denton County, Texas",5808,401,3662,368,2146,343
1400000US48121021614,48121021614,"Census Tract 216.14, Denton County, Texas",3447,362,1771,207,1676,368
1400000US48121021615,48121021615,"Census Tract 216.15, Denton County, Texas",4665,336,2491,291,2174,376
1400000US48121021616,48121021616,"Census Tract 216.16, Denton County, Texas",4147,404,3147,320,1000,329
1400000US48121021618,48121021618,"Census Tract 216.18, Denton County, Texas",4145,550,2232,504,1913,704
1400000US48121021619,48121021619,"Census Tract 216.19, Denton County, Texas",3000,602,1094,213,1906,554
1400000US48121021620,48121021620,"Census Tract 216.20, Denton County, Texas",1547,264,1381,257,166,103
1400000US48121021621,48121021621,"Census Tract 216.21, Denton County, Texas",3902,222,3482,212,420,140
1400000US48121021622,48121021622,"Census Tract 216.22, Denton County, Texas",5593,254,5147,262,446,117
1400000US48121021623,48121021623,"Census Tract 216.23, Denton County, Texas",5733,485,5224,458,509,137
1400000US48121021624,48121021624,"Census Tract 216.24, Denton County, Texas",8012,1110,6026,753,1986,1226
1400000US48121021625,48121021625,"Census Tract 216.25, Denton County, Texas",3542,309,3405,291,137,90
1400000US48121021626,48121021626,"Census Tract 216.26, Denton County, Texas",2037,348,1991,360,46,46
1400000US48121021627,48121021627,"Census Tract 216.27, Denton County, Texas",6219,465,5816,517,403,229
1400000US48121021628,48121021628,"Census Tract 216.28, Denton County, Texas",6775,534,5126,425,1649,453
1400000US48121021629,48121021629,"Census Tract 216.29, Denton County, Texas",6037,532,5506,545,531,230
1400000US48121021630,48121021630,"Census Tract 216.30, Denton County, Texas",4976,481,4302,440,674,247
1400000US48121021631,48121021631,"Census Tract 216.31, Denton County, Texas",5206,262,4538,334,668,217
1400000US48121021632,48121021632,"Census Tract 216.32, Denton County, Texas",3453,240,3143,218,310,122
1400000US48121021633,48121021633,"Census Tract 216.33, Denton County, Texas",4489,265,4043,300,446,136
1400000US48121021634,48121021634,"Census Tract 216.34, Denton County, Texas",4817,472,3630,588,1187,505
1400000US48121021635,48121021635,"Census Tract 216.35, Denton County, Texas",4157,500,3330,507,827,270
1400000US48121021636,48121021636,"Census Tract 216.36, Denton County, Texas",6937,555,5433,565,1504,505
1400000US48121021637,48121021637,"Census Tract 216.37, Denton County, Texas",3867,467,2396,380,1471,558
1400000US48121021638,48121021638,"Census Tract 216.38, Denton County, Texas",3996,541,2723,467,1273,465
1400000US48121021715,48121021715,"Census Tract 217.15, Denton County, Texas",4734,495,3935,356,799,353
1400000US48121021716,48121021716,"Census Tract 217.16, Denton County, Texas",5447,697,4450,608,997,382
1400000US48121021717,48121021717,"Census Tract 217.17, Denton County, Texas",5836,491,5025,484,811,199
1400000US48121021718,48121021718,"Census Tract 217.18, Denton County, Texas",7676,437,6930,461,746,257
1400000US48121021719,48121021719,"Census Tract 217.19, Denton County, Texas",4376,186,4235,208,141,78
1400000US48121021720,48121021720,"Census Tract 217.20, Denton County, Texas",3251,217,2866,257,385,196
1400000US48121021721,48121021721,"Census Tract 217.21, Denton County, Texas",3628,214,3390,268,238,138
1400000US48121021722,48121021722,"Census Tract 217.22, Denton County, Texas",3824,349,3580,335,244,118
1400000US48121021723,48121021723,"Census Tract 217.23, Denton County, Texas",1501,203,1191,275,310,282
1400000US48121021724,48121021724,"Census Tract 217.24, Denton County, Texas",4417,313,4183,386,234,176
1400000US48121021725,48121021725,"Census Tract 217.25, Denton County, Texas",3778,264,3376,232,402,181
1400000US48121021726,48121021726,"Census Tract 217.26, Denton County, Texas",3110,244,2893,279,217,155
1400000US48121021727,48121021727,"Census Tract 217.27, Denton County, Texas",4627,359,4342,380,285,173
1400000US48121021728,48121021728,"Census Tract 217.28, Denton County, Texas",1584,265,667,135,917,290
1400000US48121021729,48121021729,"Census Tract 217.29, Denton County, Texas",3013,256,2793,255,220,122
1400000US48121021730,48121021730,"Census Tract 217.30, Denton County, Texas",3461,177,3176,208,285,186
1400000US48121021731,48121021731,"Census Tract 217.31, Denton County, Texas",3782,389,2952,256,830,511
1400000US48121021732,48121021732,"Census Tract 217.32, Denton County, Texas",2320,238,1828,328,492,239
1400000US48121021733,48121021733,"Census Tract 217.33, Denton County, Texas",3029,648,1935,407,1094,664
1400000US48121021734,48121021734,"Census Tract 217.34, Denton County, Texas",2764,533,1929,336,835,493
1400000US48121021735,48121021735,"Census Tract 217.35, Denton County, Texas",3028,393,2272,314,756,382
1400000US48121021736,48121021736,"Census Tract 217.36, Denton County, Texas",2461,413,2167,409,294,203
1400000US48121021737,48121021737,"Census Tract 217.37, Denton County, Texas",4236,357,3771,310,465,184
1400000US48121021738,48121021738,"Census Tract 217.38, Denton County, Texas",2343,306,1657,456,686,527
1400000US48121021739,48121021739,"Census Tract 217.39, Denton County, Texas",3828,461,1852,452,1976,589
1400000US48121021740,48121021740,"Census Tract 217.40, Denton County, Texas",4978,465,3787,474,1191,299
1400000US48121021741,48121021741,"Census Tract 217.41, Denton County, Texas",1656,218,1451,230,205,148
1400000US48121021742,48121021742,"Census Tract 217.42, Denton County, Texas",5968,546,4243,617,1725,494
1400000US48121021743,48121021743,"Census Tract 217.43, Denton County, Texas",3113,344,1709,243,1404,358
1400000US48121021744,48121021744,"Census Tract 217.44, Denton County, Texas",2849,432,1326,421,1523,301
1400000US48121021745,48121021745,"Census Tract 217.45, Denton County, Texas",6085,644,2486,457,3599,731
1400000US48121021746,48121021746,"Census Tract 217.46, Denton County, Texas",3353,219,3156,230,197,82
1400000US48121021747,48121021747,"Census Tract 217.47, Denton County, Texas",4193,363,3831,466,362,303
1400000US48121021748,48121021748,"Census Tract 217.48, Denton County, Texas",3848,248,3531,252,317,105
1400000US48121021749,48121021749,"Census Tract 217.49, Denton County, Texas",3142,319,2704,369,438,287
1400000US48121021750,48121021750,"Census Tract 217.50, Denton County, Texas",3837,247,3669,300,168,117
1400000US48121021751,48121021751,"Census Tract 217.51, Denton County, Texas",4904,254,4461,308,443,192
1400000US48121021752,48121021752,"Census Tract 217.52, Denton County, Texas",4936,271,4393,329,543,329
1400000US48121021753,48121021753,"Census Tract 217.53, Denton County, Texas",5298,390,5078,396,220,122
1400000US48121021800,48121021800,"Census Tract 218, Denton County, Texas",3782,276,3670,292,112,89
1400000US48121021900,48121021900,"Census Tract 219, Denton County, Texas",4681,341,4506,357,175,104
1400000US48123970100,48123970100,"Census Tract 9701, DeWitt County, Texas",3799,426,2602,370,1197,319
1400000US48123970200,48123970200,"Census Tract 9702, DeWitt County, Texas",5052,346,2898,289,2154,294
1400000US48123970300,48123970300,"Census Tract 9703, DeWitt County, Texas",4427,509,3113,393,1314,417
1400000US48123970400,48123970400,"Census Tract 9704, DeWitt County, Texas",3808,418,2750,338,1058,288
1400000US48123970500,48123970500,"Census Tract 9705, DeWitt County, Texas",3070,398,2280,315,790,258
1400000US48125950300,48125950300,"Census Tract 9503, Dickens County, Texas",2399,,1740,98,659,98
1400000US48127950200,48127950200,"Census Tract 9502, Dimmit County, Texas",7426,489,1062,262,6364,397
1400000US48127950400,48127950400,"Census Tract 9504, Dimmit County, Texas",2628,489,368,262,2260,398
1400000US48129950200,48129950200,"Census Tract 9502, Donley County, Texas",1885,155,1733,132,152,78
1400000US48129950300,48129950300,"Census Tract 9503, Donley County, Texas",1767,155,1602,132,165,78
1400000US48131950100,48131950100,"Census Tract 9501, Duval County, Texas",4876,280,658,170,4218,299
1400000US48131950200,48131950200,"Census Tract 9502, Duval County, Texas",3054,170,542,155,2512,232
1400000US48131950500,48131950500,"Census Tract 9505, Duval County, Texas",3891,318,210,122,3681,337
1400000US48133950100,48133950100,"Census Tract 9501, Eastland County, Texas",3360,332,2679,305,681,187
1400000US48133950200,48133950200,"Census Tract 9502, Eastland County, Texas",6222,544,5202,489,1020,235
1400000US48133950300,48133950300,"Census Tract 9503, Eastland County, Texas",4990,364,4414,436,576,253
1400000US48133950400,48133950400,"Census Tract 9504, Eastland County, Texas",1738,268,1618,245,120,91
1400000US48133950500,48133950500,"Census Tract 9505, Eastland County, Texas",2209,306,1894,284,315,164
1400000US48135000100,48135000100,"Census Tract 1, Ector County, Texas",2740,403,1405,245,1335,439
1400000US48135000300,48135000300,"Census Tract 3, Ector County, Texas",1914,224,1287,213,627,183
1400000US48135000400,48135000400,"Census Tract 4, Ector County, Texas",4240,344,2689,312,1551,299
1400000US48135000500,48135000500,"Census Tract 5, Ector County, Texas",4164,415,2246,306,1918,377
1400000US48135000600,48135000600,"Census Tract 6, Ector County, Texas",5869,532,2442,348,3427,485
1400000US48135000700,48135000700,"Census Tract 7, Ector County, Texas",4387,542,1510,351,2877,537
1400000US48135000800,48135000800,"Census Tract 8, Ector County, Texas",3635,359,1736,333,1899,349
1400000US48135001000,48135001000,"Census Tract 10, Ector County, Texas",4630,340,2007,279,2623,285
1400000US48135001100,48135001100,"Census Tract 11, Ector County, Texas",7386,616,1568,456,5818,764
1400000US48135001300,48135001300,"Census Tract 13, Ector County, Texas",4958,391,2042,302,2916,368
1400000US48135001500,48135001500,"Census Tract 15, Ector County, Texas",4543,514,1078,232,3465,539
1400000US48135001600,48135001600,"Census Tract 16, Ector County, Texas",5871,482,3390,362,2481,521
1400000US48135001700,48135001700,"Census Tract 17, Ector County, Texas",5791,421,3701,460,2090,454
1400000US48135001800,48135001800,"Census Tract 18, Ector County, Texas",3267,373,1287,286,1980,303
1400000US48135001900,48135001900,"Census Tract 19, Ector County, Texas",5269,647,225,102,5044,653
1400000US48135002000,48135002000,"Census Tract 20, Ector County, Texas",3785,399,718,203,3067,393
1400000US48135002200,48135002200,"Census Tract 22, Ector County, Texas",3125,354,756,194,2369,374
1400000US48135002300,48135002300,"Census Tract 23, Ector County, Texas",3424,314,2564,382,860,184
1400000US48135002400,48135002400,"Census Tract 24, Ector County, Texas",4829,350,3686,335,1143,349
1400000US48135002501,48135002501,"Census Tract 25.01, Ector County, Texas",3581,373,1901,349,1680,323
1400000US48135002502,48135002502,"Census Tract 25.02, Ector County, Texas",6313,512,5255,597,1058,379
1400000US48135002503,48135002503,"Census Tract 25.03, Ector County, Texas",5526,559,3468,525,2058,497
1400000US48135002700,48135002700,"Census Tract 27, Ector County, Texas",9708,671,5000,574,4708,532
1400000US48135002801,48135002801,"Census Tract 28.01, Ector County, Texas",3805,418,1284,343,2521,335
1400000US48135002802,48135002802,"Census Tract 28.02, Ector County, Texas",9072,706,3159,415,5913,708
1400000US48135002900,48135002900,"Census Tract 29, Ector County, Texas",3719,271,2739,277,980,222
1400000US48135003000,48135003000,"Census Tract 30, Ector County, Texas",8871,777,4841,680,4030,772
1400000US48135003100,48135003100,"Census Tract 31, Ector County, Texas",3771,443,925,264,2846,424
1400000US48137950300,48137950300,"Census Tract 9503, Edwards County, Texas",2023,133,897,143,1126,172
1400000US48139060101,48139060101,"Census Tract 601.01, Ellis County, Texas",7609,626,5108,642,2501,469
1400000US48139060102,48139060102,"Census Tract 601.02, Ellis County, Texas",7669,702,4350,523,3319,688
1400000US48139060204,48139060204,"Census Tract 602.04, Ellis County, Texas",9131,577,6980,459,2151,595
1400000US48139060206,48139060206,"Census Tract 602.06, Ellis County, Texas",5709,571,4048,420,1661,575
1400000US48139060207,48139060207,"Census Tract 602.07, Ellis County, Texas",5734,477,4565,442,1169,231
1400000US48139060208,48139060208,"Census Tract 602.08, Ellis County, Texas",3855,273,3177,286,678,216
1400000US48139060209,48139060209,"Census Tract 602.09, Ellis County, Texas",3507,281,3229,267,278,112
1400000US48139060210,48139060210,"Census Tract 602.10, Ellis County, Texas",1590,185,1296,182,294,238
1400000US48139060211,48139060211,"Census Tract 602.11, Ellis County, Texas",3056,350,2645,335,411,236
1400000US48139060212,48139060212,"Census Tract 602.12, Ellis County, Texas",4372,353,3428,272,944,267
1400000US48139060213,48139060213,"Census Tract 602.13, Ellis County, Texas",6523,378,5209,376,1314,350
1400000US48139060214,48139060214,"Census Tract 602.14, Ellis County, Texas",7183,582,6515,696,668,304
1400000US48139060300,48139060300,"Census Tract 603, Ellis County, Texas",4353,381,3153,355,1200,310
1400000US48139060400,48139060400,"Census Tract 604, Ellis County, Texas",4433,405,3608,401,825,200
1400000US48139060500,48139060500,"Census Tract 605, Ellis County, Texas",3652,393,2033,362,1619,390
1400000US48139060600,48139060600,"Census Tract 606, Ellis County, Texas",7882,630,6386,646,1496,474
1400000US48139060701,48139060701,"Census Tract 607.01, Ellis County, Texas",2117,380,1385,319,732,356
1400000US48139060702,48139060702,"Census Tract 607.02, Ellis County, Texas",3535,377,2768,507,767,471
1400000US48139060703,48139060703,"Census Tract 607.03, Ellis County, Texas",2143,304,1876,285,267,140
1400000US48139060801,48139060801,"Census Tract 608.01, Ellis County, Texas",6079,337,5643,376,436,182
1400000US48139060802,48139060802,"Census Tract 608.02, Ellis County, Texas",6275,579,5843,575,432,266
1400000US48139060803,48139060803,"Census Tract 608.03, Ellis County, Texas",1302,202,941,208,361,208
1400000US48139060900,48139060900,"Census Tract 609, Ellis County, Texas",5822,596,5141,547,681,313
1400000US48139061000,48139061000,"Census Tract 610, Ellis County, Texas",3934,347,3419,350,515,159
1400000US48139061100,48139061100,"Census Tract 611, Ellis County, Texas",4622,470,3463,417,1159,275
1400000US48139061200,48139061200,"Census Tract 612, Ellis County, Texas",1828,280,1037,160,791,227
1400000US48139061300,48139061300,"Census Tract 613, Ellis County, Texas",2171,367,1381,242,790,339
1400000US48139061400,48139061400,"Census Tract 614, Ellis County, Texas",7876,473,5759,450,2117,390
1400000US48139061500,48139061500,"Census Tract 615, Ellis County, Texas",4681,504,2641,427,2040,387
1400000US48139061600,48139061600,"Census Tract 616, Ellis County, Texas",6050,454,3649,560,2401,497
1400000US48139061700,48139061700,"Census Tract 617, Ellis County, Texas",5019,482,3792,422,1227,450
1400000US48141000101,48141000101,"Census Tract 1.01, El Paso County, Texas",6653,538,2693,388,3960,514
1400000US48141000106,48141000106,"Census Tract 1.06, El Paso County, Texas",6318,437,3497,554,2821,719
1400000US48141000107,48141000107,"Census Tract 1.07, El Paso County, Texas",5528,370,1519,220,4009,368
1400000US48141000108,48141000108,"Census Tract 1.08, El Paso County, Texas",2702,339,1001,250,1701,403
1400000US48141000109,48141000109,"Census Tract 1.09, El Paso County, Texas",3864,467,762,265,3102,487
1400000US48141000110,48141000110,"Census Tract 1.10, El Paso County, Texas",3800,299,1175,229,2625,346
1400000US48141000111,48141000111,"Census Tract 1.11, El Paso County, Texas",2793,235,1449,280,1344,244
1400000US48141000112,48141000112,"Census Tract 1.12, El Paso County, Texas",4605,326,1341,265,3264,337
1400000US48141000204,48141000204,"Census Tract 2.04, El Paso County, Texas",5466,417,2035,323,3431,434
1400000US48141000205,48141000205,"Census Tract 2.05, El Paso County, Texas",4094,531,922,173,3172,519
1400000US48141000206,48141000206,"Census Tract 2.06, El Paso County, Texas",4802,418,969,215,3833,462
1400000US48141000207,48141000207,"Census Tract 2.07, El Paso County, Texas",4664,781,1043,351,3621,659
1400000US48141000208,48141000208,"Census Tract 2.08, El Paso County, Texas",3031,333,652,211,2379,360
1400000US48141000301,48141000301,"Census Tract 3.01, El Paso County, Texas",6305,533,1197,295,5108,476
1400000US48141000302,48141000302,"Census Tract 3.02, El Paso County, Texas",5313,596,761,243,4552,553
1400000US48141000401,48141000401,"Census Tract 4.01, El Paso County, Texas",5921,710,2372,436,3549,659
1400000US48141000403,48141000403,"Census Tract 4.03, El Paso County, Texas",3333,309,791,150,2542,305
1400000US48141000404,48141000404,"Census Tract 4.04, El Paso County, Texas",4180,458,487,172,3693,469
1400000US48141000600,48141000600,"Census Tract 6, El Paso County, Texas",4528,437,763,291,3765,434
1400000US48141000800,48141000800,"Census Tract 8, El Paso County, Texas",6119,755,538,178,5581,775
1400000US48141000900,48141000900,"Census Tract 9, El Paso County, Texas",8961,1111,1249,336,7712,1116
1400000US48141001001,48141001001,"Census Tract 10.01, El Paso County, Texas",3272,402,255,122,3017,442
1400000US48141001002,48141001002,"Census Tract 10.02, El Paso County, Texas",4383,434,132,79,4251,443
1400000US48141001104,48141001104,"Census Tract 11.04, El Paso County, Texas",7630,781,2863,486,4767,872
1400000US48141001107,48141001107,"Census Tract 11.07, El Paso County, Texas",6760,407,2450,364,4310,392
1400000US48141001109,48141001109,"Census Tract 11.09, El Paso County, Texas",4772,326,2439,317,2333,255
1400000US48141001110,48141001110,"Census Tract 11.10, El Paso County, Texas",4812,359,2170,238,2642,299
1400000US48141001111,48141001111,"Census Tract 11.11, El Paso County, Texas",4424,423,1752,321,2672,485
1400000US48141001112,48141001112,"Census Tract 11.12, El Paso County, Texas",4703,495,1606,317,3097,460
1400000US48141001113,48141001113,"Census Tract 11.13, El Paso County, Texas",7182,611,1774,318,5408,647
1400000US48141001114,48141001114,"Census Tract 11.14, El Paso County, Texas",5090,516,1253,343,3837,534
1400000US48141001115,48141001115,"Census Tract 11.15, El Paso County, Texas",3502,684,148,97,3354,709
1400000US48141001201,48141001201,"Census Tract 12.01, El Paso County, Texas",6019,660,426,178,5593,588
1400000US48141001202,48141001202,"Census Tract 12.02, El Paso County, Texas",4959,396,929,197,4030,430
1400000US48141001203,48141001203,"Census Tract 12.03, El Paso County, Texas",770,87,27,27,743,86
1400000US48141001301,48141001301,"Census Tract 13.01, El Paso County, Texas",3781,279,1576,191,2205,295
1400000US48141001302,48141001302,"Census Tract 13.02, El Paso County, Texas",7109,538,2954,516,4155,575
1400000US48141001400,48141001400,"Census Tract 14, El Paso County, Texas",2192,282,475,210,1717,331
1400000US48141001501,48141001501,"Census Tract 15.01, El Paso County, Texas",5546,612,1735,307,3811,652
1400000US48141001502,48141001502,"Census Tract 15.02, El Paso County, Texas",3103,449,1672,417,1431,262
1400000US48141001600,48141001600,"Census Tract 16, El Paso County, Texas",3798,596,826,251,2972,549
1400000US48141001700,48141001700,"Census Tract 17, El Paso County, Texas",1352,235,118,58,1234,230
1400000US48141001800,48141001800,"Census Tract 18, El Paso County, Texas",1168,256,57,48,1111,263
1400000US48141001900,48141001900,"Census Tract 19, El Paso County, Texas",2629,374,7,11,2622,375
1400000US48141002000,48141002000,"Census Tract 20, El Paso County, Texas",1869,314,26,31,1843,319
1400000US48141002100,48141002100,"Census Tract 21, El Paso County, Texas",2747,415,122,99,2625,402
1400000US48141002201,48141002201,"Census Tract 22.01, El Paso County, Texas",3364,375,621,154,2743,394
1400000US48141002202,48141002202,"Census Tract 22.02, El Paso County, Texas",4479,547,286,119,4193,551
1400000US48141002300,48141002300,"Census Tract 23, El Paso County, Texas",4808,504,540,259,4268,443
1400000US48141002400,48141002400,"Census Tract 24, El Paso County, Texas",3718,428,641,308,3077,488
1400000US48141002500,48141002500,"Census Tract 25, El Paso County, Texas",6149,557,789,374,5360,499
1400000US48141002600,48141002600,"Census Tract 26, El Paso County, Texas",3541,570,32,30,3509,571
1400000US48141002800,48141002800,"Census Tract 28, El Paso County, Texas",5069,495,119,66,4950,503
1400000US48141002900,48141002900,"Census Tract 29, El Paso County, Texas",1266,211,35,39,1231,200
1400000US48141003000,48141003000,"Census Tract 30, El Paso County, Texas",4009,430,287,229,3722,449
1400000US48141003100,48141003100,"Census Tract 31, El Paso County, Texas",3867,368,108,114,3759,391
1400000US48141003200,48141003200,"Census Tract 32, El Paso County, Texas",2391,361,73,60,2318,347
1400000US48141003300,48141003300,"Census Tract 33, El Paso County, Texas",5051,487,551,156,4500,489
1400000US48141003402,48141003402,"Census Tract 34.02, El Paso County, Texas",6831,777,965,217,5866,777
1400000US48141003403,48141003403,"Census Tract 34.03, El Paso County, Texas",5376,437,1334,349,4042,485
1400000US48141003404,48141003404,"Census Tract 34.04, El Paso County, Texas",6179,545,2113,525,4066,606
1400000US48141003501,48141003501,"Census Tract 35.01, El Paso County, Texas",2532,360,177,102,2355,353
1400000US48141003502,48141003502,"Census Tract 35.02, El Paso County, Texas",5126,596,311,141,4815,570
1400000US48141003601,48141003601,"Census Tract 36.01, El Paso County, Texas",3808,403,309,205,3499,385
1400000US48141003602,48141003602,"Census Tract 36.02, El Paso County, Texas",2683,450,156,110,2527,400
1400000US48141003701,48141003701,"Census Tract 37.01, El Paso County, Texas",4812,458,62,51,4750,457
1400000US48141003702,48141003702,"Census Tract 37.02, El Paso County, Texas",4562,461,158,132,4404,430
1400000US48141003801,48141003801,"Census Tract 38.01, El Paso County, Texas",5534,519,182,108,5352,522
1400000US48141003803,48141003803,"Census Tract 38.03, El Paso County, Texas",3038,300,109,67,2929,307
1400000US48141003804,48141003804,"Census Tract 38.04, El Paso County, Texas",4369,517,255,180,4114,528
1400000US48141003901,48141003901,"Census Tract 39.01, El Paso County, Texas",3751,408,74,50,3677,406
1400000US48141003902,48141003902,"Census Tract 39.02, El Paso County, Texas",2576,346,192,69,2384,327
1400000US48141003903,48141003903,"Census Tract 39.03, El Paso County, Texas",6932,564,75,89,6857,571
1400000US48141004002,48141004002,"Census Tract 40.02, El Paso County, Texas",8355,623,161,134,8194,614
1400000US48141004003,48141004003,"Census Tract 40.03, El Paso County, Texas",8497,768,127,109,8370,790
1400000US48141004004,48141004004,"Census Tract 40.04, El Paso County, Texas",5551,383,202,138,5349,361
1400000US48141004103,48141004103,"Census Tract 41.03, El Paso County, Texas",6991,611,424,158,6567,603
1400000US48141004104,48141004104,"Census Tract 41.04, El Paso County, Texas",6370,515,230,135,6140,489
1400000US48141004105,48141004105,"Census Tract 41.05, El Paso County, Texas",3608,388,186,70,3422,406
1400000US48141004106,48141004106,"Census Tract 41.06, El Paso County, Texas",5910,591,461,191,5449,625
1400000US48141004107,48141004107,"Census Tract 41.07, El Paso County, Texas",1483,110,146,122,1337,143
1400000US48141004201,48141004201,"Census Tract 42.01, El Paso County, Texas",6351,649,249,129,6102,653
1400000US48141004202,48141004202,"Census Tract 42.02, El Paso County, Texas",5854,478,642,239,5212,502
1400000US48141004303,48141004303,"Census Tract 43.03, El Paso County, Texas",6143,447,1448,296,4695,444
1400000US48141004307,48141004307,"Census Tract 43.07, El Paso County, Texas",5710,535,1420,308,4290,542
1400000US48141004309,48141004309,"Census Tract 43.09, El Paso County, Texas",5610,519,702,185,4908,565
1400000US48141004310,48141004310,"Census Tract 43.10, El Paso County, Texas",4983,290,906,201,4077,353
1400000US48141004311,48141004311,"Census Tract 43.11, El Paso County, Texas",4557,386,896,248,3661,355
1400000US48141004312,48141004312,"Census Tract 43.12, El Paso County, Texas",5245,571,1415,274,3830,641
1400000US48141004313,48141004313,"Census Tract 43.13, El Paso County, Texas",3491,331,861,237,2630,290
1400000US48141004314,48141004314,"Census Tract 43.14, El Paso County, Texas",5965,416,649,274,5316,408
1400000US48141004316,48141004316,"Census Tract 43.16, El Paso County, Texas",6336,467,699,241,5637,524
1400000US48141004317,48141004317,"Census Tract 43.17, El Paso County, Texas",4631,507,1786,378,2845,558
1400000US48141004318,48141004318,"Census Tract 43.18, El Paso County, Texas",4433,494,837,267,3596,494
1400000US48141004319,48141004319,"Census Tract 43.19, El Paso County, Texas",5778,371,752,269,5026,431
1400000US48141004320,48141004320,"Census Tract 43.20, El Paso County, Texas",3228,360,323,182,2905,413
1400000US48141010101,48141010101,"Census Tract 101.01, El Paso County, Texas",2326,334,2029,304,297,129
1400000US48141010102,48141010102,"Census Tract 101.02, El Paso County, Texas",4309,534,3381,494,928,361
1400000US48141010103,48141010103,"Census Tract 101.03, El Paso County, Texas",2939,327,2268,331,671,208
1400000US48141010203,48141010203,"Census Tract 102.03, El Paso County, Texas",4702,211,1184,191,3518,251
1400000US48141010207,48141010207,"Census Tract 102.07, El Paso County, Texas",4862,382,1900,317,2962,413
1400000US48141010210,48141010210,"Census Tract 102.10, El Paso County, Texas",6193,521,3771,688,2422,531
1400000US48141010211,48141010211,"Census Tract 102.11, El Paso County, Texas",3181,245,1614,245,1567,244
1400000US48141010212,48141010212,"Census Tract 102.12, El Paso County, Texas",5438,480,2506,347,2932,456
1400000US48141010213,48141010213,"Census Tract 102.13, El Paso County, Texas",5891,491,2522,502,3369,377
1400000US48141010214,48141010214,"Census Tract 102.14, El Paso County, Texas",6930,1084,3522,689,3408,1145
1400000US48141010215,48141010215,"Census Tract 102.15, El Paso County, Texas",6589,638,1627,423,4962,576
1400000US48141010216,48141010216,"Census Tract 102.16, El Paso County, Texas",7646,930,833,285,6813,959
1400000US48141010217,48141010217,"Census Tract 102.17, El Paso County, Texas",5470,387,1558,253,3912,452
1400000US48141010218,48141010218,"Census Tract 102.18, El Paso County, Texas",2777,366,819,175,1958,373
1400000US48141010219,48141010219,"Census Tract 102.19, El Paso County, Texas",7881,439,2303,311,5578,445
1400000US48141010220,48141010220,"Census Tract 102.20, El Paso County, Texas",4009,443,131,89,3878,460
1400000US48141010221,48141010221,"Census Tract 102.21, El Paso County, Texas",7382,786,654,515,6728,872
1400000US48141010222,48141010222,"Census Tract 102.22, El Paso County, Texas",2102,522,454,96,1648,510
1400000US48141010303,48141010303,"Census Tract 103.03, El Paso County, Texas",3622,231,1045,280,2577,265
1400000US48141010307,48141010307,"Census Tract 103.07, El Paso County, Texas",6473,468,1079,296,5394,498
1400000US48141010311,48141010311,"Census Tract 103.11, El Paso County, Texas",7667,523,1462,404,6205,559
1400000US48141010312,48141010312,"Census Tract 103.12, El Paso County, Texas",4151,345,892,221,3259,326
1400000US48141010316,48141010316,"Census Tract 103.16, El Paso County, Texas",4471,397,632,187,3839,467
1400000US48141010317,48141010317,"Census Tract 103.17, El Paso County, Texas",4593,457,774,203,3819,510
1400000US48141010319,48141010319,"Census Tract 103.19, El Paso County, Texas",863,210,98,58,765,211
1400000US48141010322,48141010322,"Census Tract 103.22, El Paso County, Texas",5505,709,472,215,5033,741
1400000US48141010323,48141010323,"Census Tract 103.23, El Paso County, Texas",4308,395,544,310,3764,355
1400000US48141010324,48141010324,"Census Tract 103.24, El Paso County, Texas",9340,878,708,280,8632,850
1400000US48141010325,48141010325,"Census Tract 103.25, El Paso County, Texas",8319,651,933,342,7386,693
1400000US48141010326,48141010326,"Census Tract 103.26, El Paso County, Texas",5153,400,1118,311,4035,541
1400000US48141010327,48141010327,"Census Tract 103.27, El Paso County, Texas",3959,378,530,175,3429,446
1400000US48141010328,48141010328,"Census Tract 103.28, El Paso County, Texas",3992,543,1152,458,2840,588
1400000US48141010329,48141010329,"Census Tract 103.29, El Paso County, Texas",4961,645,527,294,4434,649
1400000US48141010330,48141010330,"Census Tract 103.30, El Paso County, Texas",11514,774,1746,307,9768,765
1400000US48141010331,48141010331,"Census Tract 103.31, El Paso County, Texas",10433,724,1690,683,8743,830
1400000US48141010332,48141010332,"Census Tract 103.32, El Paso County, Texas",7974,683,1350,675,6624,784
1400000US48141010333,48141010333,"Census Tract 103.33, El Paso County, Texas",4724,629,17,29,4707,628
1400000US48141010334,48141010334,"Census Tract 103.34, El Paso County, Texas",4101,460,86,102,4015,461
1400000US48141010335,48141010335,"Census Tract 103.35, El Paso County, Texas",3517,596,92,75,3425,589
1400000US48141010336,48141010336,"Census Tract 103.36, El Paso County, Texas",7120,582,474,286,6646,667
1400000US48141010337,48141010337,"Census Tract 103.37, El Paso County, Texas",6660,478,616,305,6044,447
1400000US48141010338,48141010338,"Census Tract 103.38, El Paso County, Texas",7493,545,1228,385,6265,509
1400000US48141010339,48141010339,"Census Tract 103.39, El Paso County, Texas",7197,797,1120,262,6077,742
1400000US48141010340,48141010340,"Census Tract 103.40, El Paso County, Texas",1823,436,94,127,1729,407
1400000US48141010341,48141010341,"Census Tract 103.41, El Paso County, Texas",18297,1351,1723,511,16574,1293
1400000US48141010342,48141010342,"Census Tract 103.42, El Paso County, Texas",10647,925,1137,304,9510,952
1400000US48141010343,48141010343,"Census Tract 103.43, El Paso County, Texas",6643,555,1560,336,5083,493
1400000US48141010344,48141010344,"Census Tract 103.44, El Paso County, Texas",3660,733,10,17,3650,732
1400000US48141010345,48141010345,"Census Tract 103.45, El Paso County, Texas",6429,680,265,197,6164,690
1400000US48141010346,48141010346,"Census Tract 103.46, El Paso County, Texas",4500,524,327,210,4173,632
1400000US48141010347,48141010347,"Census Tract 103.47, El Paso County, Texas",3828,625,127,115,3701,628
1400000US48141010401,48141010401,"Census Tract 104.01, El Paso County, Texas",6230,563,158,95,6072,551
1400000US48141010404,48141010404,"Census Tract 104.04, El Paso County, Texas",4409,400,225,89,4184,407
1400000US48141010405,48141010405,"Census Tract 104.05, El Paso County, Texas",6523,541,91,64,6432,529
1400000US48141010406,48141010406,"Census Tract 104.06, El Paso County, Texas",4440,718,20,30,4420,721
1400000US48141010407,48141010407,"Census Tract 104.07, El Paso County, Texas",7016,783,14,25,7002,784
1400000US48141010408,48141010408,"Census Tract 104.08, El Paso County, Texas",3794,446,49,45,3745,438
1400000US48141010409,48141010409,"Census Tract 104.09, El Paso County, Texas",5770,628,67,53,5703,636
1400000US48141010501,48141010501,"Census Tract 105.01, El Paso County, Texas",3779,547,257,210,3522,529
1400000US48141010502,48141010502,"Census Tract 105.02, El Paso County, Texas",2260,456,355,248,1905,479
1400000US48141010504,48141010504,"Census Tract 105.04, El Paso County, Texas",1732,241,15,18,1717,246
1400000US48141010505,48141010505,"Census Tract 105.05, El Paso County, Texas",4035,435,12,14,4023,435
1400000US48141010506,48141010506,"Census Tract 105.06, El Paso County, Texas",3459,370,0,13,3459,370
1400000US48141010600,48141010600,"Census Tract 106, El Paso County, Texas",5651,410,4441,481,1210,349
1400000US48141980000,48141980000,"Census Tract 9800, El Paso County, Texas",0,13,0,13,0,13
1400000US48143950100,48143950100,"Census Tract 9501, Erath County, Texas",3301,321,3083,326,218,163
1400000US48143950201,48143950201,"Census Tract 9502.01, Erath County, Texas",3464,470,2159,467,1305,479
1400000US48143950202,48143950202,"Census Tract 9502.02, Erath County, Texas",6611,470,5704,428,907,297
1400000US48143950300,48143950300,"Census Tract 9503, Erath County, Texas",5674,440,4075,440,1599,362
1400000US48143950400,48143950400,"Census Tract 9504, Erath County, Texas",5177,437,4486,384,691,319
1400000US48143950500,48143950500,"Census Tract 9505, Erath County, Texas",7916,422,6802,449,1114,362
1400000US48143950600,48143950600,"Census Tract 9506, Erath County, Texas",3384,345,2633,315,751,282
1400000US48143950700,48143950700,"Census Tract 9507, Erath County, Texas",2665,384,1950,302,715,261
1400000US48145000200,48145000200,"Census Tract 2, Falls County, Texas",2576,266,1874,232,702,181
1400000US48145000300,48145000300,"Census Tract 3, Falls County, Texas",3627,294,2606,277,1021,226
1400000US48145000400,48145000400,"Census Tract 4, Falls County, Texas",2227,295,1880,276,347,164
1400000US48145000500,48145000500,"Census Tract 5, Falls County, Texas",2842,303,2397,252,445,188
1400000US48145000700,48145000700,"Census Tract 7, Falls County, Texas",2747,305,2275,293,472,171
1400000US48145000800,48145000800,"Census Tract 8, Falls County, Texas",3737,412,3026,359,711,184
1400000US48147950100,48147950100,"Census Tract 9501, Fannin County, Texas",2897,274,2636,260,261,117
1400000US48147950300,48147950300,"Census Tract 9503, Fannin County, Texas",3132,285,2953,300,179,108
1400000US48147950401,48147950401,"Census Tract 9504.01, Fannin County, Texas",4091,443,3270,416,821,235
1400000US48147950402,48147950402,"Census Tract 9504.02, Fannin County, Texas",6919,525,5935,600,984,367
1400000US48147950500,48147950500,"Census Tract 9505, Fannin County, Texas",2485,241,2365,237,120,125
1400000US48147950600,48147950600,"Census Tract 9506, Fannin County, Texas",2355,355,2306,357,49,42
1400000US48147950701,48147950701,"Census Tract 9507.01, Fannin County, Texas",4535,490,4147,510,388,206
1400000US48147950702,48147950702,"Census Tract 9507.02, Fannin County, Texas",3219,290,2861,310,358,157
1400000US48147950800,48147950800,"Census Tract 9508, Fannin County, Texas",4234,360,4124,370,110,79
1400000US48149970100,48149970100,"Census Tract 9701, Fayette County, Texas",1996,219,1735,188,261,160
1400000US48149970200,48149970200,"Census Tract 9702, Fayette County, Texas",2682,372,2491,382,191,143
1400000US48149970300,48149970300,"Census Tract 9703, Fayette County, Texas",5939,296,4498,507,1441,376
1400000US48149970400,48149970400,"Census Tract 9704, Fayette County, Texas",3003,340,2619,339,384,195
1400000US48149970500,48149970500,"Census Tract 9705, Fayette County, Texas",3938,442,2685,356,1253,295
1400000US48149970600,48149970600,"Census Tract 9706, Fayette County, Texas",4865,350,4015,347,850,240
1400000US48149970700,48149970700,"Census Tract 9707, Fayette County, Texas",2134,290,1941,264,193,138
1400000US48151950300,48151950300,"Census Tract 9503, Fisher County, Texas",1742,144,1369,155,373,120
1400000US48151950400,48151950400,"Census Tract 9504, Fisher County, Texas",2221,144,1494,135,727,110
1400000US48153950500,48153950500,"Census Tract 9505, Floyd County, Texas",2603,222,1235,186,1368,190
1400000US48153950600,48153950600,"Census Tract 9506, Floyd County, Texas",3836,222,1762,186,2074,190
1400000US48155950100,48155950100,"Census Tract 9501, Foard County, Texas",1273,152,1039,131,234,90
1400000US48157670101,48157670101,"Census Tract 6701.01, Fort Bend County, Texas",7438,779,2695,530,4743,706
1400000US48157670102,48157670102,"Census Tract 6701.02, Fort Bend County, Texas",3451,409,2440,380,1011,396
1400000US48157670200,48157670200,"Census Tract 6702, Fort Bend County, Texas",8572,799,5513,789,3059,598
1400000US48157670300,48157670300,"Census Tract 6703, Fort Bend County, Texas",3240,527,2778,422,462,334
1400000US48157670400,48157670400,"Census Tract 6704, Fort Bend County, Texas",5397,525,4891,537,506,224
1400000US48157670500,48157670500,"Census Tract 6705, Fort Bend County, Texas",4386,456,3227,356,1159,545
1400000US48157670601,48157670601,"Census Tract 6706.01, Fort Bend County, Texas",8888,679,7522,670,1366,418
1400000US48157670602,48157670602,"Census Tract 6706.02, Fort Bend County, Texas",2063,357,1449,256,614,369
1400000US48157670700,48157670700,"Census Tract 6707, Fort Bend County, Texas",3193,418,2370,425,823,238
1400000US48157670800,48157670800,"Census Tract 6708, Fort Bend County, Texas",14281,898,10519,875,3762,594
1400000US48157670901,48157670901,"Census Tract 6709.01, Fort Bend County, Texas",9761,602,8757,634,1004,538
1400000US48157670902,48157670902,"Census Tract 6709.02, Fort Bend County, Texas",4871,686,3347,547,1524,395
1400000US48157671001,48157671001,"Census Tract 6710.01, Fort Bend County, Texas",5180,495,4538,505,642,320
1400000US48157671002,48157671002,"Census Tract 6710.02, Fort Bend County, Texas",6716,492,5552,483,1164,267
1400000US48157671100,48157671100,"Census Tract 6711, Fort Bend County, Texas",7629,743,4500,560,3129,614
1400000US48157671200,48157671200,"Census Tract 6712, Fort Bend County, Texas",6329,562,4308,423,2021,544
1400000US48157671300,48157671300,"Census Tract 6713, Fort Bend County, Texas",3668,454,2500,386,1168,326
1400000US48157671400,48157671400,"Census Tract 6714, Fort Bend County, Texas",8450,700,6629,537,1821,548
1400000US48157671501,48157671501,"Census Tract 6715.01, Fort Bend County, Texas",7904,530,7336,620,568,238
1400000US48157671502,48157671502,"Census Tract 6715.02, Fort Bend County, Texas",1770,192,1499,226,271,148
1400000US48157671601,48157671601,"Census Tract 6716.01, Fort Bend County, Texas",5988,424,5361,479,627,374
1400000US48157671602,48157671602,"Census Tract 6716.02, Fort Bend County, Texas",3459,361,3257,374,202,69
1400000US48157671700,48157671700,"Census Tract 6717, Fort Bend County, Texas",5165,555,4834,557,331,147
1400000US48157671800,48157671800,"Census Tract 6718, Fort Bend County, Texas",2824,331,2177,283,647,156
1400000US48157671900,48157671900,"Census Tract 6719, Fort Bend County, Texas",4038,232,3137,297,901,244
1400000US48157672001,48157672001,"Census Tract 6720.01, Fort Bend County, Texas",8521,745,6828,502,1693,806
1400000US48157672002,48157672002,"Census Tract 6720.02, Fort Bend County, Texas",6143,525,5109,485,1034,390
1400000US48157672100,48157672100,"Census Tract 6721, Fort Bend County, Texas",4120,351,3891,378,229,135
1400000US48157672200,48157672200,"Census Tract 6722, Fort Bend County, Texas",3399,327,2596,303,803,295
1400000US48157672301,48157672301,"Census Tract 6723.01, Fort Bend County, Texas",8089,928,6128,915,1961,1044
1400000US48157672302,48157672302,"Census Tract 6723.02, Fort Bend County, Texas",9505,561,8247,515,1258,403
1400000US48157672400,48157672400,"Census Tract 6724, Fort Bend County, Texas",9314,604,5330,539,3984,733
1400000US48157672500,48157672500,"Census Tract 6725, Fort Bend County, Texas",7811,544,5210,403,2601,559
1400000US48157672601,48157672601,"Census Tract 6726.01, Fort Bend County, Texas",10228,784,5167,838,5061,525
1400000US48157672602,48157672602,"Census Tract 6726.02, Fort Bend County, Texas",6794,740,4462,746,2332,491
1400000US48157672701,48157672701,"Census Tract 6727.01, Fort Bend County, Texas",14003,849,9482,815,4521,828
1400000US48157672702,48157672702,"Census Tract 6727.02, Fort Bend County, Texas",6860,472,5749,536,1111,355
1400000US48157672800,48157672800,"Census Tract 6728, Fort Bend County, Texas",8023,521,6797,505,1226,419
1400000US48157672900,48157672900,"Census Tract 6729, Fort Bend County, Texas",29144,1284,22076,1303,7068,752
1400000US48157673001,48157673001,"Census Tract 6730.01, Fort Bend County, Texas",8522,684,7721,651,801,349
1400000US48157673002,48157673002,"Census Tract 6730.02, Fort Bend County, Texas",7906,455,6485,495,1421,383
1400000US48157673003,48157673003,"Census Tract 6730.03, Fort Bend County, Texas",12104,660,10072,707,2032,404
1400000US48157673101,48157673101,"Census Tract 6731.01, Fort Bend County, Texas",34354,1231,29225,1521,5129,918
1400000US48157673102,48157673102,"Census Tract 6731.02, Fort Bend County, Texas",16929,889,14100,926,2829,467
1400000US48157673200,48157673200,"Census Tract 6732, Fort Bend County, Texas",6032,495,4996,442,1036,315
1400000US48157673300,48157673300,"Census Tract 6733, Fort Bend County, Texas",4489,309,4139,325,350,141
1400000US48157673400,48157673400,"Census Tract 6734, Fort Bend County, Texas",14832,1226,12111,1335,2721,467
1400000US48157673500,48157673500,"Census Tract 6735, Fort Bend County, Texas",8817,591,7668,585,1149,327
1400000US48157673600,48157673600,"Census Tract 6736, Fort Bend County, Texas",7039,647,5630,720,1409,630
1400000US48157673700,48157673700,"Census Tract 6737, Fort Bend County, Texas",2606,447,1946,309,660,244
1400000US48157673800,48157673800,"Census Tract 6738, Fort Bend County, Texas",9023,645,7310,669,1713,356
1400000US48157673901,48157673901,"Census Tract 6739.01, Fort Bend County, Texas",9291,506,8520,539,771,318
1400000US48157673902,48157673902,"Census Tract 6739.02, Fort Bend County, Texas",6734,558,6380,559,354,180
1400000US48157674000,48157674000,"Census Tract 6740, Fort Bend County, Texas",7593,426,6517,462,1076,352
1400000US48157674100,48157674100,"Census Tract 6741, Fort Bend County, Texas",6765,446,6007,392,758,282
1400000US48157674200,48157674200,"Census Tract 6742, Fort Bend County, Texas",5522,313,5405,332,117,94
1400000US48157674300,48157674300,"Census Tract 6743, Fort Bend County, Texas",8492,574,7803,581,689,308
1400000US48157674400,48157674400,"Census Tract 6744, Fort Bend County, Texas",9430,729,8533,602,897,448
1400000US48157674501,48157674501,"Census Tract 6745.01, Fort Bend County, Texas",6536,585,5812,655,724,339
1400000US48157674502,48157674502,"Census Tract 6745.02, Fort Bend County, Texas",16668,956,13919,1021,2749,600
1400000US48157674601,48157674601,"Census Tract 6746.01, Fort Bend County, Texas",3696,346,3497,358,199,140
1400000US48157674602,48157674602,"Census Tract 6746.02, Fort Bend County, Texas",7513,587,6316,465,1197,459
1400000US48157674603,48157674603,"Census Tract 6746.03, Fort Bend County, Texas",5887,443,3589,586,2298,696
1400000US48157674604,48157674604,"Census Tract 6746.04, Fort Bend County, Texas",4956,448,3722,605,1234,477
1400000US48157674700,48157674700,"Census Tract 6747, Fort Bend County, Texas",10891,749,8714,697,2177,422
1400000US48157674800,48157674800,"Census Tract 6748, Fort Bend County, Texas",5994,547,2445,530,3549,687
1400000US48157674900,48157674900,"Census Tract 6749, Fort Bend County, Texas",5155,540,1201,294,3954,463
1400000US48157675000,48157675000,"Census Tract 6750, Fort Bend County, Texas",3056,367,663,154,2393,423
1400000US48157675100,48157675100,"Census Tract 6751, Fort Bend County, Texas",9716,832,5149,851,4567,929
1400000US48157675200,48157675200,"Census Tract 6752, Fort Bend County, Texas",5984,580,1684,291,4300,579
1400000US48157675300,48157675300,"Census Tract 6753, Fort Bend County, Texas",6773,713,2089,412,4684,862
1400000US48157675400,48157675400,"Census Tract 6754, Fort Bend County, Texas",5831,606,3183,603,2648,354
1400000US48157675500,48157675500,"Census Tract 6755, Fort Bend County, Texas",11019,983,6796,754,4223,686
1400000US48157675600,48157675600,"Census Tract 6756, Fort Bend County, Texas",5163,559,3710,452,1453,560
1400000US48157675700,48157675700,"Census Tract 6757, Fort Bend County, Texas",6423,643,4625,479,1798,578
1400000US48157675800,48157675800,"Census Tract 6758, Fort Bend County, Texas",3310,759,1953,282,1357,772
1400000US48159950100,48159950100,"Census Tract 9501, Franklin County, Texas",5149,425,4628,395,521,250
1400000US48159950200,48159950200,"Census Tract 9502, Franklin County, Texas",2656,196,2026,268,630,195
1400000US48159950300,48159950300,"Census Tract 9503, Franklin County, Texas",2788,423,2591,394,197,186
1400000US48161000100,48161000100,"Census Tract 1, Freestone County, Texas",5291,429,4326,436,965,421
1400000US48161000200,48161000200,"Census Tract 2, Freestone County, Texas",1382,183,1282,191,100,80
1400000US48161000300,48161000300,"Census Tract 3, Freestone County, Texas",1154,178,1088,209,66,96
1400000US48161000400,48161000400,"Census Tract 4, Freestone County, Texas",2639,262,2510,250,129,95
1400000US48161000600,48161000600,"Census Tract 6, Freestone County, Texas",4509,443,3776,373,733,217
1400000US48161000700,48161000700,"Census Tract 7, Freestone County, Texas",3073,201,2393,315,680,251
1400000US48161000900,48161000900,"Census Tract 9, Freestone County, Texas",1583,324,1551,318,32,41
1400000US48163950100,48163950100,"Census Tract 9501, Frio County, Texas",6310,547,1668,310,4642,538
1400000US48163950200,48163950200,"Census Tract 9502, Frio County, Texas",6637,518,581,259,6056,544
1400000US48163950300,48163950300,"Census Tract 9503, Frio County, Texas",4318,172,1598,284,2720,304
1400000US48165950100,48165950100,"Census Tract 9501, Gaines County, Texas",3666,319,1535,332,2131,276
1400000US48165950200,48165950200,"Census Tract 9502, Gaines County, Texas",8237,396,6812,468,1425,426
1400000US48165950300,48165950300,"Census Tract 9503, Gaines County, Texas",5669,254,2697,344,2972,380
1400000US48167720100,48167720100,"Census Tract 7201, Galveston County, Texas",5998,302,5269,307,729,178
1400000US48167720200,48167720200,"Census Tract 7202, Galveston County, Texas",4198,294,3773,293,425,226
1400000US48167720301,48167720301,"Census Tract 7203.01, Galveston County, Texas",2193,226,2060,247,133,98
1400000US48167720302,48167720302,"Census Tract 7203.02, Galveston County, Texas",7304,364,6259,352,1045,373
1400000US48167720400,48167720400,"Census Tract 7204, Galveston County, Texas",5900,274,5225,309,675,238
1400000US48167720501,48167720501,"Census Tract 7205.01, Galveston County, Texas",4242,314,3756,368,486,186
1400000US48167720502,48167720502,"Census Tract 7205.02, Galveston County, Texas",10594,638,8755,587,1839,514
1400000US48167720503,48167720503,"Census Tract 7205.03, Galveston County, Texas",13664,750,11493,960,2171,592
1400000US48167720600,48167720600,"Census Tract 7206, Galveston County, Texas",12117,779,9452,941,2665,642
1400000US48167720700,48167720700,"Census Tract 7207, Galveston County, Texas",8865,732,6987,663,1878,437
1400000US48167720800,48167720800,"Census Tract 7208, Galveston County, Texas",3693,432,2931,417,762,336
1400000US48167720900,48167720900,"Census Tract 7209, Galveston County, Texas",5224,595,3379,645,1845,655
1400000US48167721000,48167721000,"Census Tract 7210, Galveston County, Texas",1828,277,1601,250,227,101
1400000US48167721100,48167721100,"Census Tract 7211, Galveston County, Texas",10470,715,5789,501,4681,743
1400000US48167721201,48167721201,"Census Tract 7212.01, Galveston County, Texas",16914,740,13606,795,3308,680
1400000US48167721202,48167721202,"Census Tract 7212.02, Galveston County, Texas",3103,325,2751,283,352,159
1400000US48167721300,48167721300,"Census Tract 7213, Galveston County, Texas",4627,385,3302,325,1325,354
1400000US48167721400,48167721400,"Census Tract 7214, Galveston County, Texas",7403,435,6845,441,558,180
1400000US48167721500,48167721500,"Census Tract 7215, Galveston County, Texas",6861,510,6192,553,669,253
1400000US48167721600,48167721600,"Census Tract 7216, Galveston County, Texas",1618,280,1105,255,513,177
1400000US48167721700,48167721700,"Census Tract 7217, Galveston County, Texas",6908,678,4681,744,2227,601
1400000US48167721800,48167721800,"Census Tract 7218, Galveston County, Texas",4301,587,3549,512,752,334
1400000US48167721900,48167721900,"Census Tract 7219, Galveston County, Texas",9027,716,6800,742,2227,476
1400000US48167722001,48167722001,"Census Tract 7220.01, Galveston County, Texas",5586,540,3482,656,2104,655
1400000US48167722002,48167722002,"Census Tract 7220.02, Galveston County, Texas",3483,549,1986,327,1497,589
1400000US48167722100,48167722100,"Census Tract 7221, Galveston County, Texas",6554,559,4872,476,1682,503
1400000US48167722200,48167722200,"Census Tract 7222, Galveston County, Texas",2955,351,1850,386,1105,368
1400000US48167722300,48167722300,"Census Tract 7223, Galveston County, Texas",7735,637,4543,600,3192,620
1400000US48167722600,48167722600,"Census Tract 7226, Galveston County, Texas",1718,255,1404,235,314,203
1400000US48167722700,48167722700,"Census Tract 7227, Galveston County, Texas",3843,480,3668,453,175,132
1400000US48167722800,48167722800,"Census Tract 7228, Galveston County, Texas",2789,356,1815,336,974,316
1400000US48167722900,48167722900,"Census Tract 7229, Galveston County, Texas",2514,374,1811,230,703,336
1400000US48167723000,48167723000,"Census Tract 7230, Galveston County, Texas",3085,399,2676,361,409,165
1400000US48167723100,48167723100,"Census Tract 7231, Galveston County, Texas",3326,315,2712,312,614,196
1400000US48167723200,48167723200,"Census Tract 7232, Galveston County, Texas",3939,377,3267,357,672,346
1400000US48167723300,48167723300,"Census Tract 7233, Galveston County, Texas",5502,428,4842,434,660,209
1400000US48167723400,48167723400,"Census Tract 7234, Galveston County, Texas",6479,494,5470,559,1009,525
1400000US48167723501,48167723501,"Census Tract 7235.01, Galveston County, Texas",1034,147,754,268,280,219
1400000US48167723502,48167723502,"Census Tract 7235.02, Galveston County, Texas",9584,652,8437,682,1147,391
1400000US48167723600,48167723600,"Census Tract 7236, Galveston County, Texas",4220,355,3421,394,799,252
1400000US48167723700,48167723700,"Census Tract 7237, Galveston County, Texas",2309,293,1883,276,426,238
1400000US48167723800,48167723800,"Census Tract 7238, Galveston County, Texas",3955,317,3708,299,247,129
1400000US48167723900,48167723900,"Census Tract 7239, Galveston County, Texas",2441,555,2118,482,323,217
1400000US48167724000,48167724000,"Census Tract 7240, Galveston County, Texas",2803,382,2250,369,553,136
1400000US48167724101,48167724101,"Census Tract 7241.01, Galveston County, Texas",1515,291,1232,282,283,242
1400000US48167724200,48167724200,"Census Tract 7242, Galveston County, Texas",2672,363,2404,327,268,146
1400000US48167724300,48167724300,"Census Tract 7243, Galveston County, Texas",2971,311,2318,303,653,205
1400000US48167724400,48167724400,"Census Tract 7244, Galveston County, Texas",2723,453,1773,342,950,397
1400000US48167724500,48167724500,"Census Tract 7245, Galveston County, Texas",802,158,672,142,130,109
1400000US48167724600,48167724600,"Census Tract 7246, Galveston County, Texas",1696,309,1572,314,124,105
1400000US48167724700,48167724700,"Census Tract 7247, Galveston County, Texas",2090,391,1210,233,880,390
1400000US48167724800,48167724800,"Census Tract 7248, Galveston County, Texas",1508,279,1006,205,502,217
1400000US48167724900,48167724900,"Census Tract 7249, Galveston County, Texas",1990,271,1445,195,545,237
1400000US48167725000,48167725000,"Census Tract 7250, Galveston County, Texas",2457,329,1399,287,1058,347
1400000US48167725100,48167725100,"Census Tract 7251, Galveston County, Texas",1533,313,984,274,549,276
1400000US48167725200,48167725200,"Census Tract 7252, Galveston County, Texas",1602,367,518,173,1084,371
1400000US48167725300,48167725300,"Census Tract 7253, Galveston County, Texas",2268,336,1207,282,1061,291
1400000US48167725400,48167725400,"Census Tract 7254, Galveston County, Texas",3434,507,1248,325,2186,426
1400000US48167725500,48167725500,"Census Tract 7255, Galveston County, Texas",1118,170,1012,164,106,74
1400000US48167725600,48167725600,"Census Tract 7256, Galveston County, Texas",3568,467,3063,451,505,258
1400000US48167725700,48167725700,"Census Tract 7257, Galveston County, Texas",2068,320,1617,267,451,208
1400000US48167725800,48167725800,"Census Tract 7258, Galveston County, Texas",3517,585,1612,369,1905,536
1400000US48167725900,48167725900,"Census Tract 7259, Galveston County, Texas",2263,350,1797,329,466,197
1400000US48167726000,48167726000,"Census Tract 7260, Galveston County, Texas",1875,340,1631,346,244,133
1400000US48167726100,48167726100,"Census Tract 7261, Galveston County, Texas",2886,382,2742,371,144,103
1400000US48167726200,48167726200,"Census Tract 7262, Galveston County, Texas",3412,496,2116,367,1296,490
1400000US48167990000,48167990000,"Census Tract 9900, Galveston County, Texas",0,13,0,13,0,13
1400000US48169950100,48169950100,"Census Tract 9501, Garza County, Texas",6295,361,2793,354,3502,593
1400000US48171950100,48171950100,"Census Tract 9501, Gillespie County, Texas",3568,428,2964,386,604,244
1400000US48171950200,48171950200,"Census Tract 9502, Gillespie County, Texas",3651,287,3549,282,102,73
1400000US48171950300,48171950300,"Census Tract 9503, Gillespie County, Texas",7297,611,5693,497,1604,435
1400000US48171950400,48171950400,"Census Tract 9504, Gillespie County, Texas",6470,493,4863,458,1607,362
1400000US48171950500,48171950500,"Census Tract 9505, Gillespie County, Texas",3791,376,2725,297,1066,332
1400000US48173950100,48173950100,"Census Tract 9501, Glasscock County, Texas",1255,118,905,123,350,135
1400000US48175960100,48175960100,"Census Tract 9601, Goliad County, Texas",4053,232,2703,208,1350,201
1400000US48175960200,48175960200,"Census Tract 9602, Goliad County, Texas",3170,232,2005,208,1165,201
1400000US48177000100,48177000100,"Census Tract 1, Gonzales County, Texas",2875,392,1688,303,1187,273
1400000US48177000200,48177000200,"Census Tract 2, Gonzales County, Texas",4802,569,3238,402,1564,424
1400000US48177000300,48177000300,"Census Tract 3, Gonzales County, Texas",3658,343,1457,287,2201,453
1400000US48177000400,48177000400,"Census Tract 4, Gonzales County, Texas",2071,285,1045,226,1026,243
1400000US48177000500,48177000500,"Census Tract 5, Gonzales County, Texas",3765,442,1304,243,2461,425
1400000US48177000600,48177000600,"Census Tract 6, Gonzales County, Texas",2602,327,1689,279,913,301
1400000US48179950100,48179950100,"Census Tract 9501, Gray County, Texas",4397,166,3728,188,669,140
1400000US48179950300,48179950300,"Census Tract 9503, Gray County, Texas",4577,328,4131,343,446,172
1400000US48179950400,48179950400,"Census Tract 9504, Gray County, Texas",5290,484,4376,415,914,294
1400000US48179950500,48179950500,"Census Tract 9505, Gray County, Texas",2570,340,1712,304,858,257
1400000US48179950600,48179950600,"Census Tract 9506, Gray County, Texas",2164,280,1081,275,1083,266
1400000US48179950700,48179950700,"Census Tract 9507, Gray County, Texas",2109,341,1310,307,799,216
1400000US48179950800,48179950800,"Census Tract 9508, Gray County, Texas",1624,253,969,248,655,206
1400000US48181000101,48181000101,"Census Tract 1.01, Grayson County, Texas",4491,297,4408,312,83,79
1400000US48181000102,48181000102,"Census Tract 1.02, Grayson County, Texas",3159,303,2908,300,251,230
1400000US48181000200,48181000200,"Census Tract 2, Grayson County, Texas",2391,219,2258,225,133,83
1400000US48181000302,48181000302,"Census Tract 3.02, Grayson County, Texas",4510,340,4402,343,108,57
1400000US48181000303,48181000303,"Census Tract 3.03, Grayson County, Texas",4540,484,4315,523,225,203
1400000US48181000304,48181000304,"Census Tract 3.04, Grayson County, Texas",3165,322,2986,308,179,144
1400000US48181000400,48181000400,"Census Tract 4, Grayson County, Texas",3170,328,2877,366,293,227
1400000US48181000501,48181000501,"Census Tract 5.01, Grayson County, Texas",3785,483,3573,508,212,129
1400000US48181000502,48181000502,"Census Tract 5.02, Grayson County, Texas",1509,268,1109,188,400,238
1400000US48181000600,48181000600,"Census Tract 6, Grayson County, Texas",3559,288,3444,300,115,85
1400000US48181000700,48181000700,"Census Tract 7, Grayson County, Texas",4417,449,3981,431,436,242
1400000US48181000800,48181000800,"Census Tract 8, Grayson County, Texas",5536,418,4891,541,645,318
1400000US48181000901,48181000901,"Census Tract 9.01, Grayson County, Texas",3366,259,3226,264,140,107
1400000US48181000902,48181000902,"Census Tract 9.02, Grayson County, Texas",6974,544,6559,574,415,274
1400000US48181001101,48181001101,"Census Tract 11.01, Grayson County, Texas",3842,447,3292,396,550,268
1400000US48181001102,48181001102,"Census Tract 11.02, Grayson County, Texas",6740,541,6234,517,506,243
1400000US48181001200,48181001200,"Census Tract 12, Grayson County, Texas",6116,424,5067,486,1049,458
1400000US48181001300,48181001300,"Census Tract 13, Grayson County, Texas",3857,457,3470,437,387,261
1400000US48181001400,48181001400,"Census Tract 14, Grayson County, Texas",4627,401,3457,338,1170,312
1400000US48181001500,48181001500,"Census Tract 15, Grayson County, Texas",6563,577,4719,571,1844,425
1400000US48181001700,48181001700,"Census Tract 17, Grayson County, Texas",4543,490,3739,391,804,355
1400000US48181001801,48181001801,"Census Tract 18.01, Grayson County, Texas",5972,505,5664,520,308,244
1400000US48181001802,48181001802,"Census Tract 18.02, Grayson County, Texas",4773,336,4567,365,206,124
1400000US48181001803,48181001803,"Census Tract 18.03, Grayson County, Texas",5294,321,4630,483,664,356
1400000US48181001900,48181001900,"Census Tract 19, Grayson County, Texas",10410,611,9204,618,1206,263
1400000US48181002000,48181002000,"Census Tract 20, Grayson County, Texas",3332,434,2097,352,1235,372
1400000US48183000200,48183000200,"Census Tract 2, Gregg County, Texas",5619,439,4462,398,1157,374
1400000US48183000300,48183000300,"Census Tract 3, Gregg County, Texas",4592,469,4287,454,305,181
1400000US48183000401,48183000401,"Census Tract 4.01, Gregg County, Texas",3036,374,2759,341,277,180
1400000US48183000402,48183000402,"Census Tract 4.02, Gregg County, Texas",3287,302,3178,282,109,103
1400000US48183000501,48183000501,"Census Tract 5.01, Gregg County, Texas",5278,375,5108,358,170,119
1400000US48183000502,48183000502,"Census Tract 5.02, Gregg County, Texas",4304,420,3871,374,433,235
1400000US48183000600,48183000600,"Census Tract 6, Gregg County, Texas",7308,560,7140,578,168,120
1400000US48183000700,48183000700,"Census Tract 7, Gregg County, Texas",5608,398,5074,433,534,162
1400000US48183000800,48183000800,"Census Tract 8, Gregg County, Texas",7511,811,5312,564,2199,642
1400000US48183000900,48183000900,"Census Tract 9, Gregg County, Texas",2911,391,2175,491,736,346
1400000US48183001000,48183001000,"Census Tract 10, Gregg County, Texas",2794,420,1803,408,991,375
1400000US48183001100,48183001100,"Census Tract 11, Gregg County, Texas",4120,412,3189,328,931,387
1400000US48183001200,48183001200,"Census Tract 12, Gregg County, Texas",2687,394,1705,265,982,318
1400000US48183001300,48183001300,"Census Tract 13, Gregg County, Texas",4708,483,2670,432,2038,367
1400000US48183001400,48183001400,"Census Tract 14, Gregg County, Texas",4031,520,2899,473,1132,295
1400000US48183001500,48183001500,"Census Tract 15, Gregg County, Texas",5380,498,4096,452,1284,378
1400000US48183010100,48183010100,"Census Tract 101, Gregg County, Texas",6545,558,6057,574,488,264
1400000US48183010200,48183010200,"Census Tract 102, Gregg County, Texas",7242,401,6973,406,269,118
1400000US48183010301,48183010301,"Census Tract 103.01, Gregg County, Texas",5268,411,4801,452,467,205
1400000US48183010302,48183010302,"Census Tract 103.02, Gregg County, Texas",5954,547,4741,407,1213,517
1400000US48183010400,48183010400,"Census Tract 104, Gregg County, Texas",7353,548,6366,532,987,283
1400000US48183010500,48183010500,"Census Tract 105, Gregg County, Texas",5282,495,4579,462,703,282
1400000US48183010600,48183010600,"Census Tract 106, Gregg County, Texas",5702,410,5282,438,420,209
1400000US48183010700,48183010700,"Census Tract 107, Gregg County, Texas",4931,461,3085,484,1846,415
1400000US48183980000,48183980000,"Census Tract 9800, Gregg County, Texas",0,13,0,13,0,13
1400000US48185180101,48185180101,"Census Tract 1801.01, Grimes County, Texas",4589,469,2725,392,1864,310
1400000US48185180102,48185180102,"Census Tract 1801.02, Grimes County, Texas",4192,462,3298,384,894,319
1400000US48185180200,48185180200,"Census Tract 1802, Grimes County, Texas",6007,481,4361,394,1646,314
1400000US48185180301,48185180301,"Census Tract 1803.01, Grimes County, Texas",5162,483,4746,464,416,186
1400000US48185180302,48185180302,"Census Tract 1803.02, Grimes County, Texas",4217,496,3823,471,394,331
1400000US48185180400,48185180400,"Census Tract 1804, Grimes County, Texas",2397,339,1931,282,466,111
1400000US48187210100,48187210100,"Census Tract 2101, Guadalupe County, Texas",4555,485,1766,282,2789,524
1400000US48187210200,48187210200,"Census Tract 2102, Guadalupe County, Texas",4504,475,1075,249,3429,446
1400000US48187210300,48187210300,"Census Tract 2103, Guadalupe County, Texas",6722,756,3358,595,3364,652
1400000US48187210400,48187210400,"Census Tract 2104, Guadalupe County, Texas",4221,469,2796,415,1425,330
1400000US48187210504,48187210504,"Census Tract 2105.04, Guadalupe County, Texas",5599,440,3329,373,2270,387
1400000US48187210505,48187210505,"Census Tract 2105.05, Guadalupe County, Texas",4173,617,918,255,3255,652
1400000US48187210506,48187210506,"Census Tract 2105.06, Guadalupe County, Texas",3332,395,2158,306,1174,394
1400000US48187210507,48187210507,"Census Tract 2105.07, Guadalupe County, Texas",4685,353,3158,390,1527,319
1400000US48187210508,48187210508,"Census Tract 2105.08, Guadalupe County, Texas",2366,307,1305,188,1061,312
1400000US48187210603,48187210603,"Census Tract 2106.03, Guadalupe County, Texas",1973,204,1275,140,698,167
1400000US48187210604,48187210604,"Census Tract 2106.04, Guadalupe County, Texas",8488,624,6045,558,2443,502
1400000US48187210606,48187210606,"Census Tract 2106.06, Guadalupe County, Texas",3192,496,2266,280,926,465
1400000US48187210607,48187210607,"Census Tract 2106.07, Guadalupe County, Texas",8151,355,5378,529,2773,564
1400000US48187210608,48187210608,"Census Tract 2106.08, Guadalupe County, Texas",3535,503,1823,332,1712,286
1400000US48187210705,48187210705,"Census Tract 2107.05, Guadalupe County, Texas",2680,246,2050,224,630,231
1400000US48187210706,48187210706,"Census Tract 2107.06, Guadalupe County, Texas",5210,433,3337,385,1873,445
1400000US48187210707,48187210707,"Census Tract 2107.07, Guadalupe County, Texas",3973,301,2754,252,1219,268
1400000US48187210708,48187210708,"Census Tract 2107.08, Guadalupe County, Texas",5782,430,4252,361,1530,333
1400000US48187210709,48187210709,"Census Tract 2107.09, Guadalupe County, Texas",5081,392,3985,400,1096,266
1400000US48187210710,48187210710,"Census Tract 2107.10, Guadalupe County, Texas",3461,308,3005,389,456,240
1400000US48187210711,48187210711,"Census Tract 2107.11, Guadalupe County, Texas",3070,304,2276,315,794,219
1400000US48187210712,48187210712,"Census Tract 2107.12, Guadalupe County, Texas",4640,351,3545,339,1095,350
1400000US48187210713,48187210713,"Census Tract 2107.13, Guadalupe County, Texas",4380,407,3035,325,1345,364
1400000US48187210714,48187210714,"Census Tract 2107.14, Guadalupe County, Texas",6291,450,3750,552,2541,561
1400000US48187210801,48187210801,"Census Tract 2108.01, Guadalupe County, Texas",5595,458,3936,511,1659,532
1400000US48187210803,48187210803,"Census Tract 2108.03, Guadalupe County, Texas",3476,419,2721,327,755,314
1400000US48187210804,48187210804,"Census Tract 2108.04, Guadalupe County, Texas",4002,361,2975,335,1027,252
1400000US48187210901,48187210901,"Census Tract 2109.01, Guadalupe County, Texas",5377,574,3937,547,1440,381
1400000US48187210902,48187210902,"Census Tract 2109.02, Guadalupe County, Texas",3431,266,2457,256,974,187
1400000US48189950100,48189950100,"Census Tract 9501, Hale County, Texas",5000,638,864,232,4136,590
1400000US48189950200,48189950200,"Census Tract 9502, Hale County, Texas",4178,397,642,199,3536,392
1400000US48189950300,48189950300,"Census Tract 9503, Hale County, Texas",6459,479,4246,371,2213,389
1400000US48189950400,48189950400,"Census Tract 9504, Hale County, Texas",4600,422,2350,264,2250,378
1400000US48189950500,48189950500,"Census Tract 9505, Hale County, Texas",3518,303,1098,201,2420,318
1400000US48189950600,48189950600,"Census Tract 9506, Hale County, Texas",5005,753,3148,496,1857,482
1400000US48189950700,48189950700,"Census Tract 9507, Hale County, Texas",3185,399,1335,199,1850,353
1400000US48189950800,48189950800,"Census Tract 9508, Hale County, Texas",1353,188,564,134,789,185
1400000US48189950900,48189950900,"Census Tract 9509, Hale County, Texas",2855,374,1644,249,1211,311
1400000US48191950500,48191950500,"Census Tract 9505, Hall County, Texas",3337,,2240,,1097,
1400000US48193950100,48193950100,"Census Tract 9501, Hamilton County, Texas",2582,243,2292,247,290,129
1400000US48193950200,48193950200,"Census Tract 9502, Hamilton County, Texas",2255,217,2155,242,100,93
1400000US48193950300,48193950300,"Census Tract 9503, Hamilton County, Texas",3611,262,3110,264,501,148
1400000US48195950100,48195950100,"Census Tract 9501, Hansford County, Texas",1756,205,1173,153,583,149
1400000US48195950300,48195950300,"Census Tract 9503, Hansford County, Texas",3800,205,1975,153,1825,149
1400000US48197950100,48197950100,"Census Tract 9501, Hardeman County, Texas",4124,,3293,110,831,110
1400000US48199030100,48199030100,"Census Tract 301, Hardin County, Texas",3745,465,3613,447,132,160
1400000US48199030200,48199030200,"Census Tract 302, Hardin County, Texas",5094,393,4891,391,203,104
1400000US48199030300,48199030300,"Census Tract 303, Hardin County, Texas",9115,673,8831,673,284,188
1400000US48199030400,48199030400,"Census Tract 304, Hardin County, Texas",2418,265,2127,242,291,157
1400000US48199030501,48199030501,"Census Tract 305.01, Hardin County, Texas",4470,393,4349,409,121,91
1400000US48199030502,48199030502,"Census Tract 305.02, Hardin County, Texas",8922,542,8472,552,450,303
1400000US48199030600,48199030600,"Census Tract 306, Hardin County, Texas",3528,359,3292,350,236,138
1400000US48199030700,48199030700,"Census Tract 307, Hardin County, Texas",3734,422,3586,393,148,107
1400000US48199030800,48199030800,"Census Tract 308, Hardin County, Texas",4818,455,4553,475,265,181
1400000US48199030900,48199030900,"Census Tract 309, Hardin County, Texas",4387,435,4206,433,181,111
1400000US48199031000,48199031000,"Census Tract 310, Hardin County, Texas",4266,473,4118,466,148,107
1400000US48201100000,48201100000,"Census Tract 1000, Harris County, Texas",3717,450,2842,369,875,195
1400000US48201210100,48201210100,"Census Tract 2101, Harris County, Texas",5897,449,3911,376,1986,225
1400000US48201210400,48201210400,"Census Tract 2104, Harris County, Texas",5503,490,1033,395,4470,530
1400000US48201210500,48201210500,"Census Tract 2105, Harris County, Texas",5144,596,1363,467,3781,556
1400000US48201210600,48201210600,"Census Tract 2106, Harris County, Texas",5784,619,989,273,4795,681
1400000US48201210700,48201210700,"Census Tract 2107, Harris County, Texas",2240,277,842,239,1398,211
1400000US48201210800,48201210800,"Census Tract 2108, Harris County, Texas",2215,378,665,165,1550,342
1400000US48201210900,48201210900,"Census Tract 2109, Harris County, Texas",1619,215,1148,265,471,197
1400000US48201211000,48201211000,"Census Tract 2110, Harris County, Texas",1653,358,1274,278,379,261
1400000US48201211100,48201211100,"Census Tract 2111, Harris County, Texas",6332,723,3393,666,2939,449
1400000US48201211200,48201211200,"Census Tract 2112, Harris County, Texas",2829,394,2212,454,617,208
1400000US48201211300,48201211300,"Census Tract 2113, Harris County, Texas",4412,670,3494,569,918,328
1400000US48201211400,48201211400,"Census Tract 2114, Harris County, Texas",3761,608,2764,608,997,215
1400000US48201211500,48201211500,"Census Tract 2115, Harris County, Texas",6938,928,711,525,6227,773
1400000US48201211600,48201211600,"Census Tract 2116, Harris County, Texas",3437,549,922,263,2515,487
1400000US48201211700,48201211700,"Census Tract 2117, Harris County, Texas",3670,554,2762,507,908,331
1400000US48201211900,48201211900,"Census Tract 2119, Harris County, Texas",5412,571,390,208,5022,538
1400000US48201212300,48201212300,"Census Tract 2123, Harris County, Texas",5938,813,397,137,5541,811
1400000US48201212400,48201212400,"Census Tract 2124, Harris County, Texas",3501,444,568,222,2933,489
1400000US48201212500,48201212500,"Census Tract 2125, Harris County, Texas",4165,438,2820,435,1345,412
1400000US48201220100,48201220100,"Census Tract 2201, Harris County, Texas",2719,362,1037,262,1682,325
1400000US48201220200,48201220200,"Census Tract 2202, Harris County, Texas",2893,334,126,54,2767,339
1400000US48201220300,48201220300,"Census Tract 2203, Harris County, Texas",4700,548,424,116,4276,551
1400000US48201220400,48201220400,"Census Tract 2204, Harris County, Texas",4781,575,209,126,4572,582
1400000US48201220500,48201220500,"Census Tract 2205, Harris County, Texas",4696,532,1048,210,3648,589
1400000US48201220600,48201220600,"Census Tract 2206, Harris County, Texas",3859,625,860,239,2999,623
1400000US48201220700,48201220700,"Census Tract 2207, Harris County, Texas",5881,886,1668,373,4213,711
1400000US48201220800,48201220800,"Census Tract 2208, Harris County, Texas",2879,491,1293,312,1586,553
1400000US48201220900,48201220900,"Census Tract 2209, Harris County, Texas",1692,231,204,106,1488,210
1400000US48201221000,48201221000,"Census Tract 2210, Harris County, Texas",3352,617,1010,382,2342,625
1400000US48201221100,48201221100,"Census Tract 2211, Harris County, Texas",3916,526,387,141,3529,550
1400000US48201221200,48201221200,"Census Tract 2212, Harris County, Texas",6446,626,825,289,5621,592
1400000US48201221300,48201221300,"Census Tract 2213, Harris County, Texas",8293,947,842,424,7451,914
1400000US48201221400,48201221400,"Census Tract 2214, Harris County, Texas",6498,680,666,201,5832,690
1400000US48201221500,48201221500,"Census Tract 2215, Harris County, Texas",8109,810,1636,590,6473,785
1400000US48201221600,48201221600,"Census Tract 2216, Harris County, Texas",9830,825,1705,509,8125,899
1400000US48201221700,48201221700,"Census Tract 2217, Harris County, Texas",8098,867,970,219,7128,899
1400000US48201221800,48201221800,"Census Tract 2218, Harris County, Texas",3301,540,247,138,3054,533
1400000US48201221900,48201221900,"Census Tract 2219, Harris County, Texas",3976,835,223,100,3753,851
1400000US48201222000,48201222000,"Census Tract 2220, Harris County, Texas",2285,288,424,217,1861,337
1400000US48201222100,48201222100,"Census Tract 2221, Harris County, Texas",5069,513,1001,360,4068,617
1400000US48201222200,48201222200,"Census Tract 2222, Harris County, Texas",3792,481,698,286,3094,636
1400000US48201222300,48201222300,"Census Tract 2223, Harris County, Texas",4403,359,739,220,3664,288
1400000US48201222401,48201222401,"Census Tract 2224.01, Harris County, Texas",2997,635,367,208,2630,578
1400000US48201222402,48201222402,"Census Tract 2224.02, Harris County, Texas",6150,742,1120,388,5030,718
1400000US48201222501,48201222501,"Census Tract 2225.01, Harris County, Texas",3521,647,332,116,3189,664
1400000US48201222502,48201222502,"Census Tract 2225.02, Harris County, Texas",4021,549,800,238,3221,538
1400000US48201222503,48201222503,"Census Tract 2225.03, Harris County, Texas",7621,821,890,654,6731,926
1400000US48201222600,48201222600,"Census Tract 2226, Harris County, Texas",5147,555,761,248,4386,630
1400000US48201222700,48201222700,"Census Tract 2227, Harris County, Texas",5439,507,4082,463,1357,277
1400000US48201222800,48201222800,"Census Tract 2228, Harris County, Texas",3519,500,607,168,2912,520
1400000US48201222900,48201222900,"Census Tract 2229, Harris County, Texas",8300,674,1609,325,6691,688
1400000US48201223001,48201223001,"Census Tract 2230.01, Harris County, Texas",3326,473,553,165,2773,513
1400000US48201223002,48201223002,"Census Tract 2230.02, Harris County, Texas",3814,572,660,151,3154,609
1400000US48201223100,48201223100,"Census Tract 2231, Harris County, Texas",2126,293,550,260,1576,304
1400000US48201230100,48201230100,"Census Tract 2301, Harris County, Texas",1749,340,1686,335,63,74
1400000US48201230200,48201230200,"Census Tract 2302, Harris County, Texas",5453,571,4739,568,714,141
1400000US48201230300,48201230300,"Census Tract 2303, Harris County, Texas",2324,688,1748,575,576,263
1400000US48201230400,48201230400,"Census Tract 2304, Harris County, Texas",3744,502,2241,363,1503,346
1400000US48201230500,48201230500,"Census Tract 2305, Harris County, Texas",4020,556,971,233,3049,526
1400000US48201230600,48201230600,"Census Tract 2306, Harris County, Texas",2475,291,1715,390,760,264
1400000US48201230700,48201230700,"Census Tract 2307, Harris County, Texas",2257,417,1854,394,403,252
1400000US48201230800,48201230800,"Census Tract 2308, Harris County, Texas",2865,333,1842,299,1023,269
1400000US48201230900,48201230900,"Census Tract 2309, Harris County, Texas",3996,552,3127,439,869,347
1400000US48201231000,48201231000,"Census Tract 2310, Harris County, Texas",4200,517,2698,422,1502,358
1400000US48201231100,48201231100,"Census Tract 2311, Harris County, Texas",4727,708,1899,477,2828,733
1400000US48201231200,48201231200,"Census Tract 2312, Harris County, Texas",7198,1077,4830,858,2368,784
1400000US48201231300,48201231300,"Census Tract 2313, Harris County, Texas",4761,467,3944,484,817,327
1400000US48201231400,48201231400,"Census Tract 2314, Harris County, Texas",2678,374,2596,368,82,62
1400000US48201231500,48201231500,"Census Tract 2315, Harris County, Texas",2903,584,2612,583,291,258
1400000US48201231600,48201231600,"Census Tract 2316, Harris County, Texas",2811,413,2424,350,387,246
1400000US48201231700,48201231700,"Census Tract 2317, Harris County, Texas",3757,622,371,118,3386,632
1400000US48201231800,48201231800,"Census Tract 2318, Harris County, Texas",2616,433,1475,464,1141,203
1400000US48201231900,48201231900,"Census Tract 2319, Harris County, Texas",6447,862,4663,641,1784,611
1400000US48201232000,48201232000,"Census Tract 2320, Harris County, Texas",3659,382,1553,221,2106,372
1400000US48201232100,48201232100,"Census Tract 2321, Harris County, Texas",2899,535,899,297,2000,453
1400000US48201232200,48201232200,"Census Tract 2322, Harris County, Texas",11621,1075,6559,731,5062,1085
1400000US48201232301,48201232301,"Census Tract 2323.01, Harris County, Texas",9189,781,3644,640,5545,795
1400000US48201232302,48201232302,"Census Tract 2323.02, Harris County, Texas",8640,853,4153,815,4487,844
1400000US48201232401,48201232401,"Census Tract 2324.01, Harris County, Texas",8307,696,3700,502,4607,629
1400000US48201232402,48201232402,"Census Tract 2324.02, Harris County, Texas",3669,406,1940,369,1729,298
1400000US48201232403,48201232403,"Census Tract 2324.03, Harris County, Texas",4363,657,1497,552,2866,562
1400000US48201232500,48201232500,"Census Tract 2325, Harris County, Texas",3598,841,1018,377,2580,715
1400000US48201232600,48201232600,"Census Tract 2326, Harris County, Texas",3296,400,733,147,2563,417
1400000US48201232701,48201232701,"Census Tract 2327.01, Harris County, Texas",7389,687,2099,429,5290,708
1400000US48201232702,48201232702,"Census Tract 2327.02, Harris County, Texas",5766,883,1653,515,4113,901
1400000US48201232800,48201232800,"Census Tract 2328, Harris County, Texas",5008,559,2622,421,2386,555
1400000US48201232900,48201232900,"Census Tract 2329, Harris County, Texas",7738,933,5656,844,2082,492
1400000US48201233001,48201233001,"Census Tract 2330.01, Harris County, Texas",2597,538,1647,404,950,387
1400000US48201233002,48201233002,"Census Tract 2330.02, Harris County, Texas",4094,369,2120,299,1974,297
1400000US48201233003,48201233003,"Census Tract 2330.03, Harris County, Texas",2513,291,1529,304,984,187
1400000US48201233101,48201233101,"Census Tract 2331.01, Harris County, Texas",3991,576,793,152,3198,570
1400000US48201233102,48201233102,"Census Tract 2331.02, Harris County, Texas",7112,684,707,215,6405,657
1400000US48201233103,48201233103,"Census Tract 2331.03, Harris County, Texas",4965,596,465,198,4500,628
1400000US48201233200,48201233200,"Census Tract 2332, Harris County, Texas",6078,475,1717,246,4361,510
1400000US48201233300,48201233300,"Census Tract 2333, Harris County, Texas",5372,494,743,221,4629,518
1400000US48201233400,48201233400,"Census Tract 2334, Harris County, Texas",2668,291,597,181,2071,342
1400000US48201233500,48201233500,"Census Tract 2335, Harris County, Texas",7904,295,811,266,7093,403
1400000US48201233600,48201233600,"Census Tract 2336, Harris County, Texas",1666,271,1471,237,195,161
1400000US48201233701,48201233701,"Census Tract 2337.01, Harris County, Texas",5208,459,2025,406,3183,516
1400000US48201233702,48201233702,"Census Tract 2337.02, Harris County, Texas",3344,503,296,159,3048,533
1400000US48201233703,48201233703,"Census Tract 2337.03, Harris County, Texas",2355,313,457,139,1898,299
1400000US48201240100,48201240100,"Census Tract 2401, Harris County, Texas",4048,506,1565,491,2483,420
1400000US48201240400,48201240400,"Census Tract 2404, Harris County, Texas",6848,551,3514,443,3334,608
1400000US48201240501,48201240501,"Census Tract 2405.01, Harris County, Texas",6320,728,3060,685,3260,618
1400000US48201240502,48201240502,"Census Tract 2405.02, Harris County, Texas",5987,947,3258,700,2729,759
1400000US48201240600,48201240600,"Census Tract 2406, Harris County, Texas",2367,409,1180,319,1187,365
1400000US48201240701,48201240701,"Census Tract 2407.01, Harris County, Texas",14062,1146,7693,909,6369,1199
1400000US48201240702,48201240702,"Census Tract 2407.02, Harris County, Texas",10635,1149,5164,733,5471,945
1400000US48201240801,48201240801,"Census Tract 2408.01, Harris County, Texas",6696,666,3010,428,3686,681
1400000US48201240802,48201240802,"Census Tract 2408.02, Harris County, Texas",3435,462,2088,366,1347,381
1400000US48201240901,48201240901,"Census Tract 2409.01, Harris County, Texas",8309,821,5368,676,2941,655
1400000US48201240902,48201240902,"Census Tract 2409.02, Harris County, Texas",11582,887,7058,700,4524,709
1400000US48201241000,48201241000,"Census Tract 2410, Harris County, Texas",8608,770,5234,521,3374,606
1400000US48201241101,48201241101,"Census Tract 2411.01, Harris County, Texas",4643,406,2747,356,1896,328
1400000US48201241102,48201241102,"Census Tract 2411.02, Harris County, Texas",11461,810,7578,670,3883,618
1400000US48201241103,48201241103,"Census Tract 2411.03, Harris County, Texas",4212,345,3192,426,1020,266
1400000US48201241200,48201241200,"Census Tract 2412, Harris County, Texas",6750,599,4828,596,1922,448
1400000US48201241300,48201241300,"Census Tract 2413, Harris County, Texas",11311,683,9087,598,2224,492
1400000US48201241400,48201241400,"Census Tract 2414, Harris County, Texas",8366,799,6174,547,2192,653
1400000US48201241500,48201241500,"Census Tract 2415, Harris County, Texas",9136,823,5530,754,3606,639
1400000US48201250100,48201250100,"Census Tract 2501, Harris County, Texas",8013,836,4342,577,3671,659
1400000US48201250200,48201250200,"Census Tract 2502, Harris County, Texas",8162,728,4316,709,3846,592
1400000US48201250301,48201250301,"Census Tract 2503.01, Harris County, Texas",7806,696,5151,628,2655,331
1400000US48201250302,48201250302,"Census Tract 2503.02, Harris County, Texas",9772,826,5967,612,3805,850
1400000US48201250401,48201250401,"Census Tract 2504.01, Harris County, Texas",11708,789,8131,728,3577,619
1400000US48201250402,48201250402,"Census Tract 2504.02, Harris County, Texas",13230,993,11629,1059,1601,454
1400000US48201250500,48201250500,"Census Tract 2505, Harris County, Texas",5374,515,4222,500,1152,452
1400000US48201250600,48201250600,"Census Tract 2506, Harris County, Texas",8028,832,5056,791,2972,812
1400000US48201250701,48201250701,"Census Tract 2507.01, Harris County, Texas",5674,464,4578,393,1096,390
1400000US48201250702,48201250702,"Census Tract 2507.02, Harris County, Texas",4477,377,3664,469,813,226
1400000US48201250800,48201250800,"Census Tract 2508, Harris County, Texas",7962,457,7001,462,961,222
1400000US48201250900,48201250900,"Census Tract 2509, Harris County, Texas",9511,524,9036,548,475,225
1400000US48201251000,48201251000,"Census Tract 2510, Harris County, Texas",2871,305,2690,277,181,160
1400000US48201251100,48201251100,"Census Tract 2511, Harris County, Texas",7637,565,6060,518,1577,458
1400000US48201251200,48201251200,"Census Tract 2512, Harris County, Texas",6002,512,5090,469,912,291
1400000US48201251300,48201251300,"Census Tract 2513, Harris County, Texas",7301,361,6707,397,594,179
1400000US48201251401,48201251401,"Census Tract 2514.01, Harris County, Texas",2620,210,2186,189,434,183
1400000US48201251402,48201251402,"Census Tract 2514.02, Harris County, Texas",6288,393,5443,442,845,378
1400000US48201251501,48201251501,"Census Tract 2515.01, Harris County, Texas",5334,422,4641,460,693,210
1400000US48201251502,48201251502,"Census Tract 2515.02, Harris County, Texas",9905,724,8912,714,993,585
1400000US48201251503,48201251503,"Census Tract 2515.03, Harris County, Texas",2201,172,1976,210,225,200
1400000US48201251600,48201251600,"Census Tract 2516, Harris County, Texas",5574,416,4925,431,649,264
1400000US48201251700,48201251700,"Census Tract 2517, Harris County, Texas",7917,731,7056,732,861,473
1400000US48201251800,48201251800,"Census Tract 2518, Harris County, Texas",1723,296,1439,286,284,166
1400000US48201251901,48201251901,"Census Tract 2519.01, Harris County, Texas",9455,802,8040,799,1415,536
1400000US48201251902,48201251902,"Census Tract 2519.02, Harris County, Texas",4847,467,3919,698,928,599
1400000US48201252000,48201252000,"Census Tract 2520, Harris County, Texas",11421,848,8602,734,2819,695
1400000US48201252100,48201252100,"Census Tract 2521, Harris County, Texas",1817,191,1139,202,678,250
1400000US48201252200,48201252200,"Census Tract 2522, Harris County, Texas",7048,559,3143,422,3905,490
1400000US48201252301,48201252301,"Census Tract 2523.01, Harris County, Texas",8548,747,3607,691,4941,805
1400000US48201252302,48201252302,"Census Tract 2523.02, Harris County, Texas",12342,767,5397,759,6945,798
1400000US48201252400,48201252400,"Census Tract 2524, Harris County, Texas",7204,1022,3443,860,3761,696
1400000US48201252500,48201252500,"Census Tract 2525, Harris County, Texas",4632,830,1597,473,3035,827
1400000US48201252600,48201252600,"Census Tract 2526, Harris County, Texas",7249,845,2641,440,4608,853
1400000US48201252700,48201252700,"Census Tract 2527, Harris County, Texas",4143,460,2812,357,1331,355
1400000US48201252800,48201252800,"Census Tract 2528, Harris County, Texas",5799,719,4906,679,893,336
1400000US48201252900,48201252900,"Census Tract 2529, Harris County, Texas",8370,764,6166,795,2204,551
1400000US48201253000,48201253000,"Census Tract 2530, Harris County, Texas",3339,484,2496,396,843,278
1400000US48201253100,48201253100,"Census Tract 2531, Harris County, Texas",8680,486,5293,466,3387,489
1400000US48201253200,48201253200,"Census Tract 2532, Harris County, Texas",9372,1037,6382,536,2990,1023
1400000US48201253300,48201253300,"Census Tract 2533, Harris County, Texas",3569,340,2586,304,983,261
1400000US48201253400,48201253400,"Census Tract 2534, Harris County, Texas",542,203,410,201,132,97
1400000US48201253500,48201253500,"Census Tract 2535, Harris County, Texas",8709,705,5732,701,2977,490
1400000US48201253600,48201253600,"Census Tract 2536, Harris County, Texas",5183,589,3868,639,1315,344
1400000US48201253700,48201253700,"Census Tract 2537, Harris County, Texas",5428,484,3011,427,2417,629
1400000US48201253800,48201253800,"Census Tract 2538, Harris County, Texas",7609,543,4380,555,3229,618
1400000US48201253900,48201253900,"Census Tract 2539, Harris County, Texas",4010,336,2623,341,1387,312
1400000US48201254000,48201254000,"Census Tract 2540, Harris County, Texas",3757,594,2326,426,1431,485
1400000US48201254100,48201254100,"Census Tract 2541, Harris County, Texas",4918,497,2731,424,2187,480
1400000US48201254200,48201254200,"Census Tract 2542, Harris County, Texas",3217,416,667,239,2550,443
1400000US48201254300,48201254300,"Census Tract 2543, Harris County, Texas",4904,548,2032,360,2872,492
1400000US48201254400,48201254400,"Census Tract 2544, Harris County, Texas",3081,423,686,179,2395,385
1400000US48201254500,48201254500,"Census Tract 2545, Harris County, Texas",2505,377,665,299,1840,373
1400000US48201254600,48201254600,"Census Tract 2546, Harris County, Texas",4063,540,1250,336,2813,413
1400000US48201254700,48201254700,"Census Tract 2547, Harris County, Texas",2537,337,1731,280,806,314
1400000US48201310100,48201310100,"Census Tract 3101, Harris County, Texas",5484,613,3140,627,2344,504
1400000US48201310200,48201310200,"Census Tract 3102, Harris County, Texas",1582,231,1138,158,444,176
1400000US48201310300,48201310300,"Census Tract 3103, Harris County, Texas",5367,571,1634,477,3733,590
1400000US48201310400,48201310400,"Census Tract 3104, Harris County, Texas",3698,441,261,139,3437,450
1400000US48201310500,48201310500,"Census Tract 3105, Harris County, Texas",4397,703,549,289,3848,660
1400000US48201310600,48201310600,"Census Tract 3106, Harris County, Texas",6177,864,795,272,5382,887
1400000US48201310700,48201310700,"Census Tract 3107, Harris County, Texas",4537,575,723,275,3814,556
1400000US48201310800,48201310800,"Census Tract 3108, Harris County, Texas",2432,346,293,182,2139,327
1400000US48201310900,48201310900,"Census Tract 3109, Harris County, Texas",5671,640,296,136,5375,655
1400000US48201311000,48201311000,"Census Tract 3110, Harris County, Texas",7826,1003,349,216,7477,1067
1400000US48201311100,48201311100,"Census Tract 3111, Harris County, Texas",6039,624,170,113,5869,648
1400000US48201311200,48201311200,"Census Tract 3112, Harris County, Texas",5531,706,497,214,5034,680
1400000US48201311300,48201311300,"Census Tract 3113, Harris County, Texas",5391,412,376,182,5015,411
1400000US48201311400,48201311400,"Census Tract 3114, Harris County, Texas",2283,440,391,383,1892,463
1400000US48201311500,48201311500,"Census Tract 3115, Harris County, Texas",7556,592,853,229,6703,583
1400000US48201311600,48201311600,"Census Tract 3116, Harris County, Texas",4027,555,309,188,3718,557
1400000US48201311700,48201311700,"Census Tract 3117, Harris County, Texas",5902,437,1297,300,4605,438
1400000US48201311800,48201311800,"Census Tract 3118, Harris County, Texas",4810,519,371,132,4439,508
1400000US48201311900,48201311900,"Census Tract 3119, Harris County, Texas",2422,302,171,64,2251,309
1400000US48201312000,48201312000,"Census Tract 3120, Harris County, Texas",3572,838,3327,797,245,115
1400000US48201312100,48201312100,"Census Tract 3121, Harris County, Texas",2170,628,1969,636,201,99
1400000US48201312200,48201312200,"Census Tract 3122, Harris County, Texas",2078,262,1770,250,308,165
1400000US48201312300,48201312300,"Census Tract 3123, Harris County, Texas",1892,421,1429,293,463,295
1400000US48201312400,48201312400,"Census Tract 3124, Harris County, Texas",2165,563,1483,330,682,528
1400000US48201312500,48201312500,"Census Tract 3125, Harris County, Texas",3744,481,3134,477,610,197
1400000US48201312600,48201312600,"Census Tract 3126, Harris County, Texas",4941,576,4263,574,678,208
1400000US48201312700,48201312700,"Census Tract 3127, Harris County, Texas",1774,343,1747,347,27,24
1400000US48201312800,48201312800,"Census Tract 3128, Harris County, Texas",2275,385,2124,394,151,100
1400000US48201312900,48201312900,"Census Tract 3129, Harris County, Texas",3651,481,3634,482,17,24
1400000US48201313000,48201313000,"Census Tract 3130, Harris County, Texas",2086,346,2031,348,55,39
1400000US48201313100,48201313100,"Census Tract 3131, Harris County, Texas",3205,325,2829,379,376,177
1400000US48201313200,48201313200,"Census Tract 3132, Harris County, Texas",3472,471,3169,437,303,214
1400000US48201313300,48201313300,"Census Tract 3133, Harris County, Texas",2442,376,2271,341,171,122
1400000US48201313400,48201313400,"Census Tract 3134, Harris County, Texas",2909,382,2244,395,665,210
1400000US48201313500,48201313500,"Census Tract 3135, Harris County, Texas",2443,348,1903,321,540,244
1400000US48201313600,48201313600,"Census Tract 3136, Harris County, Texas",4597,558,3005,378,1592,522
1400000US48201313700,48201313700,"Census Tract 3137, Harris County, Texas",2753,314,2650,323,103,92
1400000US48201313800,48201313800,"Census Tract 3138, Harris County, Texas",4758,564,4061,564,697,245
1400000US48201313900,48201313900,"Census Tract 3139, Harris County, Texas",4390,662,3908,558,482,346
1400000US48201314001,48201314001,"Census Tract 3140.01, Harris County, Texas",2900,446,2174,425,726,272
1400000US48201314002,48201314002,"Census Tract 3140.02, Harris County, Texas",7054,700,6647,683,407,205
1400000US48201314300,48201314300,"Census Tract 3143, Harris County, Texas",4331,490,4024,511,307,182
1400000US48201314400,48201314400,"Census Tract 3144, Harris County, Texas",3156,305,2779,327,377,121
1400000US48201320100,48201320100,"Census Tract 3201, Harris County, Texas",2615,376,165,87,2450,386
1400000US48201320200,48201320200,"Census Tract 3202, Harris County, Texas",7310,790,2217,514,5093,792
1400000US48201320500,48201320500,"Census Tract 3205, Harris County, Texas",4991,398,553,151,4438,350
1400000US48201320601,48201320601,"Census Tract 3206.01, Harris County, Texas",2433,403,294,103,2139,404
1400000US48201320602,48201320602,"Census Tract 3206.02, Harris County, Texas",4318,537,442,186,3876,553
1400000US48201320700,48201320700,"Census Tract 3207, Harris County, Texas",4209,505,1201,223,3008,518
1400000US48201320800,48201320800,"Census Tract 3208, Harris County, Texas",5888,501,407,178,5481,541
1400000US48201320900,48201320900,"Census Tract 3209, Harris County, Texas",6862,682,1955,495,4907,609
1400000US48201321000,48201321000,"Census Tract 3210, Harris County, Texas",8333,692,2216,557,6117,693
1400000US48201321100,48201321100,"Census Tract 3211, Harris County, Texas",8182,541,2710,325,5472,601
1400000US48201321200,48201321200,"Census Tract 3212, Harris County, Texas",4048,541,793,369,3255,606
1400000US48201321300,48201321300,"Census Tract 3213, Harris County, Texas",5409,701,1488,544,3921,610
1400000US48201321401,48201321401,"Census Tract 3214.01, Harris County, Texas",4450,425,765,339,3685,466
1400000US48201321402,48201321402,"Census Tract 3214.02, Harris County, Texas",3928,487,561,212,3367,504
1400000US48201321500,48201321500,"Census Tract 3215, Harris County, Texas",2731,264,374,134,2357,286
1400000US48201321600,48201321600,"Census Tract 3216, Harris County, Texas",6915,485,1731,327,5184,485
1400000US48201321700,48201321700,"Census Tract 3217, Harris County, Texas",3277,324,899,183,2378,332
1400000US48201321800,48201321800,"Census Tract 3218, Harris County, Texas",4233,362,532,199,3701,420
1400000US48201321900,48201321900,"Census Tract 3219, Harris County, Texas",5633,572,710,217,4923,567
1400000US48201322000,48201322000,"Census Tract 3220, Harris County, Texas",4946,678,678,229,4268,680
1400000US48201322100,48201322100,"Census Tract 3221, Harris County, Texas",4256,528,1332,403,2924,488
1400000US48201322200,48201322200,"Census Tract 3222, Harris County, Texas",1431,202,285,80,1146,213
1400000US48201322600,48201322600,"Census Tract 3226, Harris County, Texas",5440,433,1824,334,3616,524
1400000US48201322700,48201322700,"Census Tract 3227, Harris County, Texas",7230,715,1737,396,5493,738
1400000US48201322800,48201322800,"Census Tract 3228, Harris County, Texas",6268,527,1360,351,4908,606
1400000US48201322900,48201322900,"Census Tract 3229, Harris County, Texas",4230,432,615,129,3615,432
1400000US48201323000,48201323000,"Census Tract 3230, Harris County, Texas",6035,581,921,255,5114,609
1400000US48201323100,48201323100,"Census Tract 3231, Harris County, Texas",3448,400,729,276,2719,449
1400000US48201323200,48201323200,"Census Tract 3232, Harris County, Texas",4899,609,1465,332,3434,599
1400000US48201323300,48201323300,"Census Tract 3233, Harris County, Texas",3298,464,784,219,2514,430
1400000US48201323400,48201323400,"Census Tract 3234, Harris County, Texas",7812,728,1866,416,5946,816
1400000US48201323500,48201323500,"Census Tract 3235, Harris County, Texas",5361,674,1531,366,3830,637
1400000US48201323600,48201323600,"Census Tract 3236, Harris County, Texas",8063,786,4010,460,4053,656
1400000US48201323701,48201323701,"Census Tract 3237.01, Harris County, Texas",4258,519,2557,335,1701,492
1400000US48201323702,48201323702,"Census Tract 3237.02, Harris County, Texas",3224,365,2066,308,1158,398
1400000US48201323801,48201323801,"Census Tract 3238.01, Harris County, Texas",3495,315,1389,313,2106,327
1400000US48201323802,48201323802,"Census Tract 3238.02, Harris County, Texas",4902,570,1610,178,3292,605
1400000US48201323900,48201323900,"Census Tract 3239, Harris County, Texas",3750,435,1991,300,1759,382
1400000US48201324000,48201324000,"Census Tract 3240, Harris County, Texas",5600,305,3151,267,2449,258
1400000US48201324100,48201324100,"Census Tract 3241, Harris County, Texas",5721,514,650,218,5071,516
1400000US48201324200,48201324200,"Census Tract 3242, Harris County, Texas",1734,283,57,50,1677,288
1400000US48201330100,48201330100,"Census Tract 3301, Harris County, Texas",8499,1265,3819,730,4680,1314
1400000US48201330200,48201330200,"Census Tract 3302, Harris County, Texas",4425,431,2185,384,2240,348
1400000US48201330301,48201330301,"Census Tract 3303.01, Harris County, Texas",7337,585,2106,288,5231,581
1400000US48201330302,48201330302,"Census Tract 3303.02, Harris County, Texas",5668,607,2532,417,3136,488
1400000US48201330303,48201330303,"Census Tract 3303.03, Harris County, Texas",4380,524,2097,334,2283,502
1400000US48201330400,48201330400,"Census Tract 3304, Harris County, Texas",4852,431,2042,330,2810,437
1400000US48201330500,48201330500,"Census Tract 3305, Harris County, Texas",4230,733,1412,490,2818,699
1400000US48201330600,48201330600,"Census Tract 3306, Harris County, Texas",7019,758,4553,722,2466,382
1400000US48201330700,48201330700,"Census Tract 3307, Harris County, Texas",8188,795,2911,468,5277,790
1400000US48201330800,48201330800,"Census Tract 3308, Harris County, Texas",9038,891,6128,537,2910,713
1400000US48201330900,48201330900,"Census Tract 3309, Harris County, Texas",8020,859,4493,584,3527,744
1400000US48201331100,48201331100,"Census Tract 3311, Harris County, Texas",3043,340,2647,338,396,161
1400000US48201331200,48201331200,"Census Tract 3312, Harris County, Texas",3023,502,2804,562,219,208
1400000US48201331300,48201331300,"Census Tract 3313, Harris County, Texas",4980,588,4797,582,183,168
1400000US48201331400,48201331400,"Census Tract 3314, Harris County, Texas",2427,444,2309,468,118,118
1400000US48201331500,48201331500,"Census Tract 3315, Harris County, Texas",7257,768,6605,760,652,435
1400000US48201331601,48201331601,"Census Tract 3316.01, Harris County, Texas",6067,659,5797,667,270,99
1400000US48201331602,48201331602,"Census Tract 3316.02, Harris County, Texas",2070,491,1720,523,350,259
1400000US48201331700,48201331700,"Census Tract 3317, Harris County, Texas",4261,560,3583,507,678,359
1400000US48201331800,48201331800,"Census Tract 3318, Harris County, Texas",3937,702,3492,603,445,332
1400000US48201331900,48201331900,"Census Tract 3319, Harris County, Texas",2820,381,2773,436,47,130
1400000US48201332000,48201332000,"Census Tract 3320, Harris County, Texas",5398,588,4406,501,992,381
1400000US48201332100,48201332100,"Census Tract 3321, Harris County, Texas",3016,552,1833,517,1183,303
1400000US48201332200,48201332200,"Census Tract 3322, Harris County, Texas",5493,505,3197,398,2296,441
1400000US48201332300,48201332300,"Census Tract 3323, Harris County, Texas",3294,391,2408,357,886,388
1400000US48201332400,48201332400,"Census Tract 3324, Harris County, Texas",4046,504,3638,493,408,229
1400000US48201332500,48201332500,"Census Tract 3325, Harris County, Texas",3164,441,2072,376,1092,223
1400000US48201332600,48201332600,"Census Tract 3326, Harris County, Texas",6761,823,2862,505,3899,939
1400000US48201332700,48201332700,"Census Tract 3327, Harris County, Texas",3410,390,261,101,3149,387
1400000US48201332800,48201332800,"Census Tract 3328, Harris County, Texas",5226,613,970,331,4256,625
1400000US48201332900,48201332900,"Census Tract 3329, Harris County, Texas",5208,575,730,238,4478,558
1400000US48201333000,48201333000,"Census Tract 3330, Harris County, Texas",3665,489,428,160,3237,473
1400000US48201333100,48201333100,"Census Tract 3331, Harris County, Texas",3603,399,1876,402,1727,341
1400000US48201333201,48201333201,"Census Tract 3332.01, Harris County, Texas",4578,545,1177,177,3401,574
1400000US48201333202,48201333202,"Census Tract 3332.02, Harris County, Texas",4964,596,2276,505,2688,597
1400000US48201333300,48201333300,"Census Tract 3333, Harris County, Texas",9959,887,2828,535,7131,850
1400000US48201333500,48201333500,"Census Tract 3335, Harris County, Texas",7129,746,1749,355,5380,725
1400000US48201333600,48201333600,"Census Tract 3336, Harris County, Texas",2998,516,1145,388,1853,649
1400000US48201333700,48201333700,"Census Tract 3337, Harris County, Texas",3800,366,933,399,2867,360
1400000US48201333800,48201333800,"Census Tract 3338, Harris County, Texas",9612,965,2366,596,7246,1005
1400000US48201333901,48201333901,"Census Tract 3339.01, Harris County, Texas",7908,688,3241,551,4667,546
1400000US48201333902,48201333902,"Census Tract 3339.02, Harris County, Texas",7819,625,3553,562,4266,492
1400000US48201334001,48201334001,"Census Tract 3340.01, Harris County, Texas",3486,694,1487,538,1999,517
1400000US48201334002,48201334002,"Census Tract 3340.02, Harris County, Texas",2759,499,1528,454,1231,374
1400000US48201334003,48201334003,"Census Tract 3340.03, Harris County, Texas",6775,717,4157,665,2618,717
1400000US48201334100,48201334100,"Census Tract 3341, Harris County, Texas",9625,1005,7723,976,1902,680
1400000US48201340100,48201340100,"Census Tract 3401, Harris County, Texas",4991,463,2868,418,2123,445
1400000US48201340201,48201340201,"Census Tract 3402.01, Harris County, Texas",1825,184,1604,265,221,167
1400000US48201340202,48201340202,"Census Tract 3402.02, Harris County, Texas",5258,376,4628,315,630,342
1400000US48201340203,48201340203,"Census Tract 3402.03, Harris County, Texas",4519,382,4174,405,345,206
1400000US48201340301,48201340301,"Census Tract 3403.01, Harris County, Texas",4189,277,3996,288,193,130
1400000US48201340302,48201340302,"Census Tract 3403.02, Harris County, Texas",7247,438,6441,391,806,379
1400000US48201340400,48201340400,"Census Tract 3404, Harris County, Texas",1566,111,1429,134,137,90
1400000US48201340500,48201340500,"Census Tract 3405, Harris County, Texas",6053,769,4864,655,1189,485
1400000US48201340600,48201340600,"Census Tract 3406, Harris County, Texas",2502,119,2172,165,330,199
1400000US48201340700,48201340700,"Census Tract 3407, Harris County, Texas",7375,588,5496,569,1879,580
1400000US48201340800,48201340800,"Census Tract 3408, Harris County, Texas",5858,291,5211,351,647,164
1400000US48201340900,48201340900,"Census Tract 3409, Harris County, Texas",4949,509,3083,510,1866,514
1400000US48201341000,48201341000,"Census Tract 3410, Harris County, Texas",7258,783,5496,887,1762,545
1400000US48201341100,48201341100,"Census Tract 3411, Harris County, Texas",3805,410,2119,325,1686,426
1400000US48201341201,48201341201,"Census Tract 3412.01, Harris County, Texas",4173,419,3187,539,986,449
1400000US48201341202,48201341202,"Census Tract 3412.02, Harris County, Texas",4667,219,4090,297,577,218
1400000US48201341301,48201341301,"Census Tract 3413.01, Harris County, Texas",5466,508,4418,401,1048,528
1400000US48201341302,48201341302,"Census Tract 3413.02, Harris County, Texas",2966,313,2044,305,922,269
1400000US48201341400,48201341400,"Census Tract 3414, Harris County, Texas",5310,422,4641,503,669,261
1400000US48201341501,48201341501,"Census Tract 3415.01, Harris County, Texas",6567,475,5690,627,877,474
1400000US48201341502,48201341502,"Census Tract 3415.02, Harris County, Texas",4375,445,3740,474,635,279
1400000US48201341600,48201341600,"Census Tract 3416, Harris County, Texas",5311,555,4710,551,601,287
1400000US48201341700,48201341700,"Census Tract 3417, Harris County, Texas",2207,251,1884,181,323,157
1400000US48201341800,48201341800,"Census Tract 3418, Harris County, Texas",1674,283,1439,278,235,96
1400000US48201342001,48201342001,"Census Tract 3420.01, Harris County, Texas",6750,360,5515,431,1235,365
1400000US48201342002,48201342002,"Census Tract 3420.02, Harris County, Texas",3247,214,2301,222,946,206
1400000US48201342100,48201342100,"Census Tract 3421, Harris County, Texas",4328,476,2280,220,2048,455
1400000US48201342200,48201342200,"Census Tract 3422, Harris County, Texas",3810,527,1596,314,2214,522
1400000US48201342300,48201342300,"Census Tract 3423, Harris County, Texas",6876,636,3450,612,3426,585
1400000US48201342400,48201342400,"Census Tract 3424, Harris County, Texas",3497,448,1604,279,1893,464
1400000US48201342500,48201342500,"Census Tract 3425, Harris County, Texas",5793,344,4639,412,1154,360
1400000US48201342700,48201342700,"Census Tract 3427, Harris County, Texas",5124,361,3956,325,1168,299
1400000US48201342800,48201342800,"Census Tract 3428, Harris County, Texas",8903,485,6864,445,2039,414
1400000US48201342900,48201342900,"Census Tract 3429, Harris County, Texas",5479,315,4732,342,747,289
1400000US48201343000,48201343000,"Census Tract 3430, Harris County, Texas",7706,487,5106,533,2600,482
1400000US48201343100,48201343100,"Census Tract 3431, Harris County, Texas",4485,343,3549,338,936,245
1400000US48201343200,48201343200,"Census Tract 3432, Harris County, Texas",4787,446,4006,479,781,325
1400000US48201343301,48201343301,"Census Tract 3433.01, Harris County, Texas",4405,385,3067,402,1338,369
1400000US48201343302,48201343302,"Census Tract 3433.02, Harris County, Texas",4936,321,3353,398,1583,373
1400000US48201343600,48201343600,"Census Tract 3436, Harris County, Texas",3416,323,2318,263,1098,297
1400000US48201343700,48201343700,"Census Tract 3437, Harris County, Texas",3299,421,2146,341,1153,386
1400000US48201350100,48201350100,"Census Tract 3501, Harris County, Texas",15630,1020,11341,882,4289,917
1400000US48201350200,48201350200,"Census Tract 3502, Harris County, Texas",9053,806,4368,506,4685,906
1400000US48201350300,48201350300,"Census Tract 3503, Harris County, Texas",5461,524,3979,461,1482,357
1400000US48201350400,48201350400,"Census Tract 3504, Harris County, Texas",6267,429,2826,360,3441,374
1400000US48201350500,48201350500,"Census Tract 3505, Harris County, Texas",7074,560,3053,393,4021,523
1400000US48201350601,48201350601,"Census Tract 3506.01, Harris County, Texas",4458,510,3667,494,791,282
1400000US48201350602,48201350602,"Census Tract 3506.02, Harris County, Texas",8077,530,6502,615,1575,438
1400000US48201350700,48201350700,"Census Tract 3507, Harris County, Texas",2216,228,1794,275,422,212
1400000US48201350801,48201350801,"Census Tract 3508.01, Harris County, Texas",4871,394,3506,477,1365,359
1400000US48201350802,48201350802,"Census Tract 3508.02, Harris County, Texas",6996,573,5183,608,1813,450
1400000US48201410100,48201410100,"Census Tract 4101, Harris County, Texas",3634,316,3035,304,599,202
1400000US48201410200,48201410200,"Census Tract 4102, Harris County, Texas",4524,445,3726,509,798,263
1400000US48201410300,48201410300,"Census Tract 4103, Harris County, Texas",2125,291,1839,271,286,127
1400000US48201410401,48201410401,"Census Tract 4104.01, Harris County, Texas",3998,270,3192,359,806,302
1400000US48201410402,48201410402,"Census Tract 4104.02, Harris County, Texas",3048,537,1839,246,1209,469
1400000US48201410500,48201410500,"Census Tract 4105, Harris County, Texas",4158,414,3412,410,746,220
1400000US48201410600,48201410600,"Census Tract 4106, Harris County, Texas",3448,270,3032,254,416,161
1400000US48201410701,48201410701,"Census Tract 4107.01, Harris County, Texas",3671,488,2966,419,705,298
1400000US48201410702,48201410702,"Census Tract 4107.02, Harris County, Texas",2457,220,2168,222,289,112
1400000US48201410800,48201410800,"Census Tract 4108, Harris County, Texas",3442,515,2547,323,895,487
1400000US48201410900,48201410900,"Census Tract 4109, Harris County, Texas",2508,315,1854,221,654,260
1400000US48201411000,48201411000,"Census Tract 4110, Harris County, Texas",4223,337,4057,328,166,106
1400000US48201411100,48201411100,"Census Tract 4111, Harris County, Texas",3617,402,3210,337,407,256
1400000US48201411200,48201411200,"Census Tract 4112, Harris County, Texas",1924,159,1833,163,91,65
1400000US48201411300,48201411300,"Census Tract 4113, Harris County, Texas",3748,372,3086,344,662,281
1400000US48201411400,48201411400,"Census Tract 4114, Harris County, Texas",2728,343,2652,340,76,86
1400000US48201411501,48201411501,"Census Tract 4115.01, Harris County, Texas",4827,483,3710,508,1117,322
1400000US48201411502,48201411502,"Census Tract 4115.02, Harris County, Texas",4171,580,3425,442,746,449
1400000US48201411600,48201411600,"Census Tract 4116, Harris County, Texas",2445,236,2270,246,175,99
1400000US48201411700,48201411700,"Census Tract 4117, Harris County, Texas",2751,240,2397,273,354,183
1400000US48201411800,48201411800,"Census Tract 4118, Harris County, Texas",4749,413,4196,459,553,220
1400000US48201411900,48201411900,"Census Tract 4119, Harris County, Texas",3899,342,3388,347,511,220
1400000US48201412000,48201412000,"Census Tract 4120, Harris County, Texas",2802,294,2725,302,77,45
1400000US48201412100,48201412100,"Census Tract 4121, Harris County, Texas",2264,321,1898,301,366,125
1400000US48201412200,48201412200,"Census Tract 4122, Harris County, Texas",6097,652,5529,584,568,371
1400000US48201412300,48201412300,"Census Tract 4123, Harris County, Texas",6833,289,6404,366,429,208
1400000US48201412400,48201412400,"Census Tract 4124, Harris County, Texas",4251,267,3976,295,275,131
1400000US48201412500,48201412500,"Census Tract 4125, Harris County, Texas",1715,96,1593,100,122,60
1400000US48201412600,48201412600,"Census Tract 4126, Harris County, Texas",3891,201,3546,244,345,144
1400000US48201412700,48201412700,"Census Tract 4127, Harris County, Texas",3180,268,2731,282,449,174
1400000US48201412800,48201412800,"Census Tract 4128, Harris County, Texas",5412,313,4816,344,596,261
1400000US48201412900,48201412900,"Census Tract 4129, Harris County, Texas",4200,369,3920,378,280,136
1400000US48201413000,48201413000,"Census Tract 4130, Harris County, Texas",3341,315,2899,348,442,262
1400000US48201413100,48201413100,"Census Tract 4131, Harris County, Texas",3222,222,2811,241,411,176
1400000US48201413201,48201413201,"Census Tract 4132.01, Harris County, Texas",2312,381,1995,358,317,248
1400000US48201413202,48201413202,"Census Tract 4132.02, Harris County, Texas",3123,295,2785,320,338,178
1400000US48201413300,48201413300,"Census Tract 4133, Harris County, Texas",6907,570,6311,541,596,242
1400000US48201420100,48201420100,"Census Tract 4201, Harris County, Texas",3356,372,1731,288,1625,350
1400000US48201420200,48201420200,"Census Tract 4202, Harris County, Texas",2525,262,1585,321,940,235
1400000US48201420300,48201420300,"Census Tract 4203, Harris County, Texas",3359,325,2920,328,439,154
1400000US48201420400,48201420400,"Census Tract 4204, Harris County, Texas",3390,229,2716,214,674,231
1400000US48201420500,48201420500,"Census Tract 4205, Harris County, Texas",3102,628,960,227,2142,596
1400000US48201420600,48201420600,"Census Tract 4206, Harris County, Texas",2058,236,1483,155,575,211
1400000US48201420700,48201420700,"Census Tract 4207, Harris County, Texas",3323,242,3029,286,294,138
1400000US48201420800,48201420800,"Census Tract 4208, Harris County, Texas",2814,259,2614,282,200,136
1400000US48201420900,48201420900,"Census Tract 4209, Harris County, Texas",5864,318,5612,338,252,171
1400000US48201421000,48201421000,"Census Tract 4210, Harris County, Texas",2536,244,2174,226,362,181
1400000US48201421101,48201421101,"Census Tract 4211.01, Harris County, Texas",3387,519,1339,312,2048,543
1400000US48201421102,48201421102,"Census Tract 4211.02, Harris County, Texas",4412,637,1033,310,3379,648
1400000US48201421201,48201421201,"Census Tract 4212.01, Harris County, Texas",3453,436,851,217,2602,459
1400000US48201421202,48201421202,"Census Tract 4212.02, Harris County, Texas",3239,765,374,189,2865,740
1400000US48201421300,48201421300,"Census Tract 4213, Harris County, Texas",5803,772,2749,665,3054,679
1400000US48201421401,48201421401,"Census Tract 4214.01, Harris County, Texas",3177,559,414,233,2763,587
1400000US48201421402,48201421402,"Census Tract 4214.02, Harris County, Texas",4289,653,236,304,4053,710
1400000US48201421403,48201421403,"Census Tract 4214.03, Harris County, Texas",4512,631,580,229,3932,620
1400000US48201421500,48201421500,"Census Tract 4215, Harris County, Texas",5705,649,3027,554,2678,564
1400000US48201421600,48201421600,"Census Tract 4216, Harris County, Texas",6015,854,1660,366,4355,845
1400000US48201421700,48201421700,"Census Tract 4217, Harris County, Texas",4631,397,3005,423,1626,531
1400000US48201421800,48201421800,"Census Tract 4218, Harris County, Texas",5114,588,3937,586,1177,424
1400000US48201421900,48201421900,"Census Tract 4219, Harris County, Texas",2498,236,2304,220,194,165
1400000US48201422000,48201422000,"Census Tract 4220, Harris County, Texas",2719,237,2181,249,538,216
1400000US48201422100,48201422100,"Census Tract 4221, Harris County, Texas",5285,551,3316,548,1969,242
1400000US48201422200,48201422200,"Census Tract 4222, Harris County, Texas",5486,721,4202,685,1284,521
1400000US48201422301,48201422301,"Census Tract 4223.01, Harris County, Texas",7543,768,5216,782,2327,550
1400000US48201422302,48201422302,"Census Tract 4223.02, Harris County, Texas",2460,466,1855,448,605,243
1400000US48201422401,48201422401,"Census Tract 4224.01, Harris County, Texas",3912,575,2911,487,1001,478
1400000US48201422402,48201422402,"Census Tract 4224.02, Harris County, Texas",5205,643,1984,366,3221,591
1400000US48201422500,48201422500,"Census Tract 4225, Harris County, Texas",6019,733,3330,442,2689,659
1400000US48201422600,48201422600,"Census Tract 4226, Harris County, Texas",5699,675,3952,570,1747,460
1400000US48201422701,48201422701,"Census Tract 4227.01, Harris County, Texas",4896,733,1078,363,3818,734
1400000US48201422702,48201422702,"Census Tract 4227.02, Harris County, Texas",3381,464,1415,277,1966,521
1400000US48201422800,48201422800,"Census Tract 4228, Harris County, Texas",4702,588,2116,329,2586,580
1400000US48201422900,48201422900,"Census Tract 4229, Harris County, Texas",4695,538,1914,331,2781,567
1400000US48201423000,48201423000,"Census Tract 4230, Harris County, Texas",5432,855,2602,652,2830,635
1400000US48201423100,48201423100,"Census Tract 4231, Harris County, Texas",2777,368,921,270,1856,399
1400000US48201423201,48201423201,"Census Tract 4232.01, Harris County, Texas",3738,419,2066,396,1672,497
1400000US48201423202,48201423202,"Census Tract 4232.02, Harris County, Texas",7660,1006,3918,749,3742,927
1400000US48201423301,48201423301,"Census Tract 4233.01, Harris County, Texas",4101,403,3035,357,1066,238
1400000US48201423302,48201423302,"Census Tract 4233.02, Harris County, Texas",4812,540,4335,482,477,246
1400000US48201423401,48201423401,"Census Tract 4234.01, Harris County, Texas",5044,402,4155,489,889,316
1400000US48201423402,48201423402,"Census Tract 4234.02, Harris County, Texas",4014,450,3016,489,998,377
1400000US48201423500,48201423500,"Census Tract 4235, Harris County, Texas",2194,311,1757,258,437,231
1400000US48201423600,48201423600,"Census Tract 4236, Harris County, Texas",7166,799,4591,819,2575,686
1400000US48201430100,48201430100,"Census Tract 4301, Harris County, Texas",5589,516,4716,515,873,302
1400000US48201430200,48201430200,"Census Tract 4302, Harris County, Texas",1382,170,1101,169,281,98
1400000US48201430300,48201430300,"Census Tract 4303, Harris County, Texas",4413,18,4228,132,185,134
1400000US48201430400,48201430400,"Census Tract 4304, Harris County, Texas",3158,31,2948,140,210,138
1400000US48201430500,48201430500,"Census Tract 4305, Harris County, Texas",2567,21,2177,175,390,175
1400000US48201430600,48201430600,"Census Tract 4306, Harris County, Texas",3680,22,3387,156,293,158
1400000US48201430700,48201430700,"Census Tract 4307, Harris County, Texas",3218,256,2858,267,360,155
1400000US48201430800,48201430800,"Census Tract 4308, Harris County, Texas",4057,349,3888,343,169,98
1400000US48201430900,48201430900,"Census Tract 4309, Harris County, Texas",6009,549,5435,505,574,292
1400000US48201431000,48201431000,"Census Tract 4310, Harris County, Texas",5406,385,4533,529,873,358
1400000US48201431101,48201431101,"Census Tract 4311.01, Harris County, Texas",3140,454,2776,440,364,362
1400000US48201431102,48201431102,"Census Tract 4311.02, Harris County, Texas",3393,728,2696,694,697,393
1400000US48201431201,48201431201,"Census Tract 4312.01, Harris County, Texas",4520,571,3249,518,1271,427
1400000US48201431202,48201431202,"Census Tract 4312.02, Harris County, Texas",4853,424,4014,392,839,269
1400000US48201431301,48201431301,"Census Tract 4313.01, Harris County, Texas",5319,750,3288,449,2031,688
1400000US48201431302,48201431302,"Census Tract 4313.02, Harris County, Texas",3747,303,3391,301,356,170
1400000US48201431401,48201431401,"Census Tract 4314.01, Harris County, Texas",2647,345,1984,279,663,216
1400000US48201431402,48201431402,"Census Tract 4314.02, Harris County, Texas",3372,362,2858,381,514,202
1400000US48201431501,48201431501,"Census Tract 4315.01, Harris County, Texas",3508,415,3194,390,314,95
1400000US48201431502,48201431502,"Census Tract 4315.02, Harris County, Texas",3421,358,2887,375,534,274
1400000US48201431600,48201431600,"Census Tract 4316, Harris County, Texas",3231,270,2887,301,344,237
1400000US48201431700,48201431700,"Census Tract 4317, Harris County, Texas",4063,333,3836,327,227,136
1400000US48201431801,48201431801,"Census Tract 4318.01, Harris County, Texas",2950,301,2520,310,430,209
1400000US48201431802,48201431802,"Census Tract 4318.02, Harris County, Texas",3172,606,2042,349,1130,590
1400000US48201431900,48201431900,"Census Tract 4319, Harris County, Texas",3078,302,2576,309,502,204
1400000US48201432001,48201432001,"Census Tract 4320.01, Harris County, Texas",3085,400,2251,318,834,306
1400000US48201432002,48201432002,"Census Tract 4320.02, Harris County, Texas",4561,788,2158,305,2403,777
1400000US48201432100,48201432100,"Census Tract 4321, Harris County, Texas",4618,519,3158,488,1460,347
1400000US48201432200,48201432200,"Census Tract 4322, Harris County, Texas",4285,539,2920,414,1365,501
1400000US48201432300,48201432300,"Census Tract 4323, Harris County, Texas",6394,728,3792,408,2602,679
1400000US48201432400,48201432400,"Census Tract 4324, Harris County, Texas",5075,568,3655,682,1420,527
1400000US48201432500,48201432500,"Census Tract 4325, Harris County, Texas",6341,822,2876,482,3465,802
1400000US48201432600,48201432600,"Census Tract 4326, Harris County, Texas",2263,377,1586,266,677,375
1400000US48201432701,48201432701,"Census Tract 4327.01, Harris County, Texas",6671,801,580,220,6091,828
1400000US48201432702,48201432702,"Census Tract 4327.02, Harris County, Texas",2953,470,1538,265,1415,444
1400000US48201432801,48201432801,"Census Tract 4328.01, Harris County, Texas",4811,564,2263,455,2548,523
1400000US48201432802,48201432802,"Census Tract 4328.02, Harris County, Texas",6284,677,2270,508,4014,684
1400000US48201432901,48201432901,"Census Tract 4329.01, Harris County, Texas",3462,467,787,375,2675,504
1400000US48201432902,48201432902,"Census Tract 4329.02, Harris County, Texas",4350,708,1962,370,2388,684
1400000US48201433001,48201433001,"Census Tract 4330.01, Harris County, Texas",5579,690,2381,599,3198,488
1400000US48201433002,48201433002,"Census Tract 4330.02, Harris County, Texas",3822,783,1180,321,2642,754
1400000US48201433003,48201433003,"Census Tract 4330.03, Harris County, Texas",5080,642,3112,720,1968,568
1400000US48201433100,48201433100,"Census Tract 4331, Harris County, Texas",2520,541,1009,396,1511,457
1400000US48201433201,48201433201,"Census Tract 4332.01, Harris County, Texas",4907,523,3258,444,1649,462
1400000US48201433202,48201433202,"Census Tract 4332.02, Harris County, Texas",3482,413,1763,268,1719,405
1400000US48201433300,48201433300,"Census Tract 4333, Harris County, Texas",4792,449,3220,396,1572,334
1400000US48201433400,48201433400,"Census Tract 4334, Harris County, Texas",4396,516,2040,369,2356,427
1400000US48201433501,48201433501,"Census Tract 4335.01, Harris County, Texas",6214,686,1141,456,5073,709
1400000US48201433502,48201433502,"Census Tract 4335.02, Harris County, Texas",5961,811,1843,530,4118,767
1400000US48201433600,48201433600,"Census Tract 4336, Harris County, Texas",4580,687,2493,395,2087,660
1400000US48201440100,48201440100,"Census Tract 4401, Harris County, Texas",6986,968,3725,597,3261,917
1400000US48201450100,48201450100,"Census Tract 4501, Harris County, Texas",1612,157,1431,202,181,203
1400000US48201450200,48201450200,"Census Tract 4502, Harris County, Texas",4793,241,4350,290,443,175
1400000US48201450300,48201450300,"Census Tract 4503, Harris County, Texas",6919,657,4882,526,2037,593
1400000US48201450400,48201450400,"Census Tract 4504, Harris County, Texas",4798,615,3464,547,1334,356
1400000US48201450500,48201450500,"Census Tract 4505, Harris County, Texas",2556,292,2350,314,206,116
1400000US48201450600,48201450600,"Census Tract 4506, Harris County, Texas",3985,399,3059,267,926,411
1400000US48201450700,48201450700,"Census Tract 4507, Harris County, Texas",6684,484,6483,483,201,127
1400000US48201450801,48201450801,"Census Tract 4508.01, Harris County, Texas",2049,226,1478,272,571,230
1400000US48201450802,48201450802,"Census Tract 4508.02, Harris County, Texas",6356,1242,3390,621,2966,1136
1400000US48201450900,48201450900,"Census Tract 4509, Harris County, Texas",2466,222,2116,233,350,101
1400000US48201451001,48201451001,"Census Tract 4510.01, Harris County, Texas",5234,784,3820,653,1414,702
1400000US48201451002,48201451002,"Census Tract 4510.02, Harris County, Texas",4927,692,3829,641,1098,450
1400000US48201451100,48201451100,"Census Tract 4511, Harris County, Texas",4154,460,3330,373,824,440
1400000US48201451200,48201451200,"Census Tract 4512, Harris County, Texas",2589,193,2435,202,154,97
1400000US48201451300,48201451300,"Census Tract 4513, Harris County, Texas",6686,496,5648,530,1038,244
1400000US48201451401,48201451401,"Census Tract 4514.01, Harris County, Texas",3201,374,2789,398,412,235
1400000US48201451402,48201451402,"Census Tract 4514.02, Harris County, Texas",4898,960,3828,1113,1070,530
1400000US48201451403,48201451403,"Census Tract 4514.03, Harris County, Texas",4186,487,3508,477,678,348
1400000US48201451500,48201451500,"Census Tract 4515, Harris County, Texas",4933,574,4304,645,629,302
1400000US48201451601,48201451601,"Census Tract 4516.01, Harris County, Texas",6112,445,5611,477,501,212
1400000US48201451602,48201451602,"Census Tract 4516.02, Harris County, Texas",6783,858,5441,802,1342,391
1400000US48201451700,48201451700,"Census Tract 4517, Harris County, Texas",3121,315,1948,282,1173,322
1400000US48201451800,48201451800,"Census Tract 4518, Harris County, Texas",5384,541,3337,488,2047,445
1400000US48201451901,48201451901,"Census Tract 4519.01, Harris County, Texas",7296,848,4770,821,2526,827
1400000US48201451902,48201451902,"Census Tract 4519.02, Harris County, Texas",2885,354,2746,366,139,73
1400000US48201452000,48201452000,"Census Tract 4520, Harris County, Texas",7229,864,5465,672,1764,570
1400000US48201452100,48201452100,"Census Tract 4521, Harris County, Texas",7757,799,5901,818,1856,666
1400000US48201452201,48201452201,"Census Tract 4522.01, Harris County, Texas",4270,547,3389,454,881,357
1400000US48201452202,48201452202,"Census Tract 4522.02, Harris County, Texas",2155,314,1743,240,412,227
1400000US48201452300,48201452300,"Census Tract 4523, Harris County, Texas",2533,289,1377,287,1156,202
1400000US48201452400,48201452400,"Census Tract 4524, Harris County, Texas",8219,803,4393,599,3826,657
1400000US48201452500,48201452500,"Census Tract 4525, Harris County, Texas",7648,842,3709,590,3939,872
1400000US48201452600,48201452600,"Census Tract 4526, Harris County, Texas",6992,771,4308,687,2684,780
1400000US48201452700,48201452700,"Census Tract 4527, Harris County, Texas",9893,986,7469,798,2424,721
1400000US48201452801,48201452801,"Census Tract 4528.01, Harris County, Texas",5766,552,3686,501,2080,411
1400000US48201452802,48201452802,"Census Tract 4528.02, Harris County, Texas",4848,546,2543,336,2305,547
1400000US48201452900,48201452900,"Census Tract 4529, Harris County, Texas",4006,467,2245,553,1761,623
1400000US48201453000,48201453000,"Census Tract 4530, Harris County, Texas",6867,693,2579,588,4288,590
1400000US48201453100,48201453100,"Census Tract 4531, Harris County, Texas",3717,540,1847,404,1870,458
1400000US48201453200,48201453200,"Census Tract 4532, Harris County, Texas",6799,896,3170,590,3629,897
1400000US48201453300,48201453300,"Census Tract 4533, Harris County, Texas",2935,355,2131,347,804,325
1400000US48201453401,48201453401,"Census Tract 4534.01, Harris County, Texas",3023,433,1648,430,1375,313
1400000US48201453402,48201453402,"Census Tract 4534.02, Harris County, Texas",7810,902,4444,854,3366,597
1400000US48201453403,48201453403,"Census Tract 4534.03, Harris County, Texas",3653,497,2382,380,1271,370
1400000US48201453501,48201453501,"Census Tract 4535.01, Harris County, Texas",6415,715,3267,513,3148,945
1400000US48201453502,48201453502,"Census Tract 4535.02, Harris County, Texas",3407,368,2284,403,1123,184
1400000US48201453601,48201453601,"Census Tract 4536.01, Harris County, Texas",1846,238,1049,186,797,225
1400000US48201453602,48201453602,"Census Tract 4536.02, Harris County, Texas",7448,659,4233,604,3215,662
1400000US48201453700,48201453700,"Census Tract 4537, Harris County, Texas",8619,987,4904,788,3715,625
1400000US48201453800,48201453800,"Census Tract 4538, Harris County, Texas",3977,471,2075,311,1902,563
1400000US48201453900,48201453900,"Census Tract 4539, Harris County, Texas",9792,730,7032,665,2760,507
1400000US48201454000,48201454000,"Census Tract 4540, Harris County, Texas",5142,456,3424,410,1718,371
1400000US48201454100,48201454100,"Census Tract 4541, Harris County, Texas",3612,366,2689,373,923,223
1400000US48201454200,48201454200,"Census Tract 4542, Harris County, Texas",4085,418,1631,276,2454,463
1400000US48201454301,48201454301,"Census Tract 4543.01, Harris County, Texas",10715,953,6290,871,4425,1076
1400000US48201454302,48201454302,"Census Tract 4543.02, Harris County, Texas",6820,784,4053,778,2767,377
1400000US48201454400,48201454400,"Census Tract 4544, Harris County, Texas",313,115,178,71,135,97
1400000US48201454501,48201454501,"Census Tract 4545.01, Harris County, Texas",7966,499,7185,451,781,262
1400000US48201454502,48201454502,"Census Tract 4545.02, Harris County, Texas",2398,265,1766,309,632,292
1400000US48201454600,48201454600,"Census Tract 4546, Harris County, Texas",4450,489,3598,313,852,410
1400000US48201454700,48201454700,"Census Tract 4547, Harris County, Texas",6818,375,5906,449,912,286
1400000US48201454800,48201454800,"Census Tract 4548, Harris County, Texas",7275,524,6301,556,974,333
1400000US48201454900,48201454900,"Census Tract 4549, Harris County, Texas",10165,556,8241,592,1924,437
1400000US48201455000,48201455000,"Census Tract 4550, Harris County, Texas",2730,218,2323,243,407,234
1400000US48201455101,48201455101,"Census Tract 4551.01, Harris County, Texas",6811,623,5337,613,1474,440
1400000US48201455102,48201455102,"Census Tract 4551.02, Harris County, Texas",3725,362,3249,348,476,137
1400000US48201455200,48201455200,"Census Tract 4552, Harris County, Texas",4104,464,3027,397,1077,552
1400000US48201455300,48201455300,"Census Tract 4553, Harris County, Texas",2647,320,2233,332,414,258
1400000US48201510100,48201510100,"Census Tract 5101, Harris County, Texas",1884,327,927,204,957,266
1400000US48201510200,48201510200,"Census Tract 5102, Harris County, Texas",5142,428,3945,388,1197,350
1400000US48201510300,48201510300,"Census Tract 5103, Harris County, Texas",5905,536,4360,602,1545,308
1400000US48201510400,48201510400,"Census Tract 5104, Harris County, Texas",4223,434,3106,365,1117,288
1400000US48201510500,48201510500,"Census Tract 5105, Harris County, Texas",2920,294,2082,210,838,259
1400000US48201510600,48201510600,"Census Tract 5106, Harris County, Texas",4191,485,3005,441,1186,344
1400000US48201510700,48201510700,"Census Tract 5107, Harris County, Texas",2853,306,2296,261,557,163
1400000US48201510800,48201510800,"Census Tract 5108, Harris County, Texas",6363,468,5540,553,823,247
1400000US48201510900,48201510900,"Census Tract 5109, Harris County, Texas",6262,1014,3270,616,2992,1096
1400000US48201511001,48201511001,"Census Tract 5110.01, Harris County, Texas",2374,326,1886,285,488,120
1400000US48201511002,48201511002,"Census Tract 5110.02, Harris County, Texas",4484,394,2723,332,1761,461
1400000US48201511100,48201511100,"Census Tract 5111, Harris County, Texas",2911,383,2212,335,699,300
1400000US48201511200,48201511200,"Census Tract 5112, Harris County, Texas",4060,407,2078,275,1982,377
1400000US48201511301,48201511301,"Census Tract 5113.01, Harris County, Texas",3696,360,2598,319,1098,382
1400000US48201511302,48201511302,"Census Tract 5113.02, Harris County, Texas",3763,403,3020,404,743,198
1400000US48201511400,48201511400,"Census Tract 5114, Harris County, Texas",3254,425,1997,226,1257,360
1400000US48201511500,48201511500,"Census Tract 5115, Harris County, Texas",6052,566,3214,363,2838,527
1400000US48201511600,48201511600,"Census Tract 5116, Harris County, Texas",3883,496,976,161,2907,537
1400000US48201520100,48201520100,"Census Tract 5201, Harris County, Texas",2305,339,1209,272,1096,425
1400000US48201520200,48201520200,"Census Tract 5202, Harris County, Texas",3795,394,2608,324,1187,444
1400000US48201520300,48201520300,"Census Tract 5203, Harris County, Texas",4337,514,1843,365,2494,566
1400000US48201520400,48201520400,"Census Tract 5204, Harris County, Texas",3316,460,618,141,2698,506
1400000US48201520500,48201520500,"Census Tract 5205, Harris County, Texas",7725,936,1783,617,5942,872
1400000US48201520601,48201520601,"Census Tract 5206.01, Harris County, Texas",2511,495,352,182,2159,500
1400000US48201520602,48201520602,"Census Tract 5206.02, Harris County, Texas",6492,975,1299,452,5193,1013
1400000US48201520700,48201520700,"Census Tract 5207, Harris County, Texas",3859,475,2435,366,1424,411
1400000US48201521000,48201521000,"Census Tract 5210, Harris County, Texas",2213,391,686,153,1527,386
1400000US48201521100,48201521100,"Census Tract 5211, Harris County, Texas",2019,389,320,79,1699,372
1400000US48201521200,48201521200,"Census Tract 5212, Harris County, Texas",6610,945,1479,476,5131,937
1400000US48201521300,48201521300,"Census Tract 5213, Harris County, Texas",5747,551,2232,302,3515,540
1400000US48201521400,48201521400,"Census Tract 5214, Harris County, Texas",7527,1000,425,174,7102,1014
1400000US48201521500,48201521500,"Census Tract 5215, Harris County, Texas",6291,617,2083,301,4208,641
1400000US48201521600,48201521600,"Census Tract 5216, Harris County, Texas",3537,388,1045,196,2492,462
1400000US48201521700,48201521700,"Census Tract 5217, Harris County, Texas",6451,774,2881,498,3570,691
1400000US48201521800,48201521800,"Census Tract 5218, Harris County, Texas",5383,337,2779,302,2604,344
1400000US48201521900,48201521900,"Census Tract 5219, Harris County, Texas",7346,1938,3537,406,3809,1987
1400000US48201522000,48201522000,"Census Tract 5220, Harris County, Texas",4527,588,2076,276,2451,564
1400000US48201522100,48201522100,"Census Tract 5221, Harris County, Texas",8521,879,2844,507,5677,1003
1400000US48201522201,48201522201,"Census Tract 5222.01, Harris County, Texas",4101,549,1277,231,2824,628
1400000US48201522202,48201522202,"Census Tract 5222.02, Harris County, Texas",4011,451,1521,319,2490,566
1400000US48201522301,48201522301,"Census Tract 5223.01, Harris County, Texas",4871,587,1862,410,3009,721
1400000US48201522302,48201522302,"Census Tract 5223.02, Harris County, Texas",3866,539,1397,357,2469,553
1400000US48201522401,48201522401,"Census Tract 5224.01, Harris County, Texas",4518,662,2764,347,1754,690
1400000US48201522402,48201522402,"Census Tract 5224.02, Harris County, Texas",3599,569,1643,343,1956,664
1400000US48201522500,48201522500,"Census Tract 5225, Harris County, Texas",4581,155,4409,153,172,95
1400000US48201530100,48201530100,"Census Tract 5301, Harris County, Texas",6844,856,1875,451,4969,958
1400000US48201530200,48201530200,"Census Tract 5302, Harris County, Texas",4067,368,2627,331,1440,459
1400000US48201530300,48201530300,"Census Tract 5303, Harris County, Texas",2460,295,1809,335,651,251
1400000US48201530400,48201530400,"Census Tract 5304, Harris County, Texas",2639,462,1569,203,1070,418
1400000US48201530500,48201530500,"Census Tract 5305, Harris County, Texas",4495,421,2357,413,2138,438
1400000US48201530600,48201530600,"Census Tract 5306, Harris County, Texas",3321,511,1425,222,1896,454
1400000US48201530700,48201530700,"Census Tract 5307, Harris County, Texas",5855,634,2202,448,3653,559
1400000US48201530800,48201530800,"Census Tract 5308, Harris County, Texas",3989,526,3019,503,970,355
1400000US48201530900,48201530900,"Census Tract 5309, Harris County, Texas",4318,523,2938,368,1380,488
1400000US48201531000,48201531000,"Census Tract 5310, Harris County, Texas",3936,346,2459,213,1477,326
1400000US48201531100,48201531100,"Census Tract 5311, Harris County, Texas",2955,260,1757,255,1198,282
1400000US48201531200,48201531200,"Census Tract 5312, Harris County, Texas",3002,596,2079,358,923,522
1400000US48201531300,48201531300,"Census Tract 5313, Harris County, Texas",5777,718,2592,662,3185,699
1400000US48201531400,48201531400,"Census Tract 5314, Harris County, Texas",1901,249,1181,161,720,257
1400000US48201531500,48201531500,"Census Tract 5315, Harris County, Texas",2954,236,1791,185,1163,210
1400000US48201531600,48201531600,"Census Tract 5316, Harris County, Texas",2915,328,1963,233,952,346
1400000US48201531700,48201531700,"Census Tract 5317, Harris County, Texas",2966,246,2409,288,557,330
1400000US48201531800,48201531800,"Census Tract 5318, Harris County, Texas",2006,335,1415,340,591,289
1400000US48201531900,48201531900,"Census Tract 5319, Harris County, Texas",4688,518,3850,541,838,205
1400000US48201532001,48201532001,"Census Tract 5320.01, Harris County, Texas",5629,866,3931,710,1698,649
1400000US48201532002,48201532002,"Census Tract 5320.02, Harris County, Texas",992,173,818,203,174,147
1400000US48201532100,48201532100,"Census Tract 5321, Harris County, Texas",6430,733,3479,530,2951,622
1400000US48201532200,48201532200,"Census Tract 5322, Harris County, Texas",2768,421,1636,388,1132,318
1400000US48201532300,48201532300,"Census Tract 5323, Harris County, Texas",5127,546,3125,396,2002,537
1400000US48201532400,48201532400,"Census Tract 5324, Harris County, Texas",5789,763,2767,379,3022,706
1400000US48201532501,48201532501,"Census Tract 5325.01, Harris County, Texas",8567,874,3338,331,5229,896
1400000US48201532502,48201532502,"Census Tract 5325.02, Harris County, Texas",5358,788,1130,296,4228,742
1400000US48201532600,48201532600,"Census Tract 5326, Harris County, Texas",5863,772,4074,749,1789,485
1400000US48201532700,48201532700,"Census Tract 5327, Harris County, Texas",5184,571,3350,403,1834,713
1400000US48201532800,48201532800,"Census Tract 5328, Harris County, Texas",1776,236,993,176,783,241
1400000US48201532900,48201532900,"Census Tract 5329, Harris County, Texas",4637,402,3089,545,1548,350
1400000US48201533000,48201533000,"Census Tract 5330, Harris County, Texas",2511,463,1496,342,1015,449
1400000US48201533100,48201533100,"Census Tract 5331, Harris County, Texas",6428,667,4587,635,1841,521
1400000US48201533200,48201533200,"Census Tract 5332, Harris County, Texas",3422,526,2793,439,629,342
1400000US48201533300,48201533300,"Census Tract 5333, Harris County, Texas",6357,621,5613,661,744,214
1400000US48201533400,48201533400,"Census Tract 5334, Harris County, Texas",10169,1086,4320,662,5849,925
1400000US48201533500,48201533500,"Census Tract 5335, Harris County, Texas",4723,472,1693,275,3030,462
1400000US48201533600,48201533600,"Census Tract 5336, Harris County, Texas",5558,462,2543,441,3015,461
1400000US48201533701,48201533701,"Census Tract 5337.01, Harris County, Texas",6281,828,1256,476,5025,752
1400000US48201533702,48201533702,"Census Tract 5337.02, Harris County, Texas",3285,502,1167,430,2118,547
1400000US48201533801,48201533801,"Census Tract 5338.01, Harris County, Texas",8549,764,2842,486,5707,775
1400000US48201533802,48201533802,"Census Tract 5338.02, Harris County, Texas",5975,843,2132,397,3843,831
1400000US48201533901,48201533901,"Census Tract 5339.01, Harris County, Texas",9671,846,4211,572,5460,770
1400000US48201533902,48201533902,"Census Tract 5339.02, Harris County, Texas",4551,701,2659,732,1892,587
1400000US48201534001,48201534001,"Census Tract 5340.01, Harris County, Texas",2359,439,576,164,1783,419
1400000US48201534002,48201534002,"Census Tract 5340.02, Harris County, Texas",5854,510,1987,347,3867,462
1400000US48201534003,48201534003,"Census Tract 5340.03, Harris County, Texas",2719,279,1227,290,1492,315
1400000US48201534100,48201534100,"Census Tract 5341, Harris County, Texas",7268,539,3479,400,3789,504
1400000US48201534201,48201534201,"Census Tract 5342.01, Harris County, Texas",2463,579,1177,327,1286,548
1400000US48201534202,48201534202,"Census Tract 5342.02, Harris County, Texas",8374,663,6214,593,2160,481
1400000US48201534203,48201534203,"Census Tract 5342.03, Harris County, Texas",1738,455,895,573,843,380
1400000US48201540100,48201540100,"Census Tract 5401, Harris County, Texas",11384,710,8297,657,3087,576
1400000US48201540200,48201540200,"Census Tract 5402, Harris County, Texas",2691,240,922,196,1769,322
1400000US48201540501,48201540501,"Census Tract 5405.01, Harris County, Texas",5994,827,2041,615,3953,834
1400000US48201540502,48201540502,"Census Tract 5405.02, Harris County, Texas",5099,434,3404,330,1695,387
1400000US48201540601,48201540601,"Census Tract 5406.01, Harris County, Texas",3932,570,2515,372,1417,414
1400000US48201540602,48201540602,"Census Tract 5406.02, Harris County, Texas",7370,857,4331,756,3039,629
1400000US48201540700,48201540700,"Census Tract 5407, Harris County, Texas",7845,473,4375,445,3470,558
1400000US48201540800,48201540800,"Census Tract 5408, Harris County, Texas",8388,710,3470,425,4918,780
1400000US48201540901,48201540901,"Census Tract 5409.01, Harris County, Texas",2703,633,2558,633,145,135
1400000US48201540902,48201540902,"Census Tract 5409.02, Harris County, Texas",6955,565,5786,539,1169,398
1400000US48201541001,48201541001,"Census Tract 5410.01, Harris County, Texas",9072,555,7060,555,2012,463
1400000US48201541002,48201541002,"Census Tract 5410.02, Harris County, Texas",8184,578,6430,647,1754,754
1400000US48201541003,48201541003,"Census Tract 5410.03, Harris County, Texas",13090,754,9620,644,3470,909
1400000US48201541100,48201541100,"Census Tract 5411, Harris County, Texas",6765,355,5527,393,1238,304
1400000US48201541201,48201541201,"Census Tract 5412.01, Harris County, Texas",8241,366,6531,411,1710,337
1400000US48201541202,48201541202,"Census Tract 5412.02, Harris County, Texas",8833,551,5857,589,2976,547
1400000US48201541203,48201541203,"Census Tract 5412.03, Harris County, Texas",2494,304,2166,276,328,174
1400000US48201541300,48201541300,"Census Tract 5413, Harris County, Texas",12172,853,5877,863,6295,866
1400000US48201541400,48201541400,"Census Tract 5414, Harris County, Texas",13556,971,8443,889,5113,830
1400000US48201541500,48201541500,"Census Tract 5415, Harris County, Texas",5558,385,3187,328,2371,500
1400000US48201541601,48201541601,"Census Tract 5416.01, Harris County, Texas",4674,313,3876,313,798,135
1400000US48201541602,48201541602,"Census Tract 5416.02, Harris County, Texas",10241,1192,4480,840,5761,1040
1400000US48201541700,48201541700,"Census Tract 5417, Harris County, Texas",11142,912,6484,807,4658,905
1400000US48201541800,48201541800,"Census Tract 5418, Harris County, Texas",5700,494,3714,410,1986,397
1400000US48201541900,48201541900,"Census Tract 5419, Harris County, Texas",6757,451,4231,367,2526,386
1400000US48201542000,48201542000,"Census Tract 5420, Harris County, Texas",14167,952,8080,785,6087,878
1400000US48201542101,48201542101,"Census Tract 5421.01, Harris County, Texas",16565,1368,8094,1229,8471,1475
1400000US48201542102,48201542102,"Census Tract 5421.02, Harris County, Texas",13611,1128,6337,951,7274,1205
1400000US48201542200,48201542200,"Census Tract 5422, Harris County, Texas",16208,1114,8155,845,8053,1183
1400000US48201542301,48201542301,"Census Tract 5423.01, Harris County, Texas",13128,695,6810,548,6318,851
1400000US48201542302,48201542302,"Census Tract 5423.02, Harris County, Texas",6336,547,2988,690,3348,792
1400000US48201542400,48201542400,"Census Tract 5424, Harris County, Texas",8826,711,4579,639,4247,484
1400000US48201542500,48201542500,"Census Tract 5425, Harris County, Texas",2277,214,1955,229,322,188
1400000US48201542600,48201542600,"Census Tract 5426, Harris County, Texas",4203,430,2702,326,1501,351
1400000US48201542700,48201542700,"Census Tract 5427, Harris County, Texas",4368,302,3012,341,1356,390
1400000US48201542800,48201542800,"Census Tract 5428, Harris County, Texas",7009,306,4354,473,2655,552
1400000US48201542900,48201542900,"Census Tract 5429, Harris County, Texas",10916,1040,6826,778,4090,913
1400000US48201543001,48201543001,"Census Tract 5430.01, Harris County, Texas",7675,712,5985,675,1690,458
1400000US48201543002,48201543002,"Census Tract 5430.02, Harris County, Texas",10135,792,7859,835,2276,605
1400000US48201543003,48201543003,"Census Tract 5430.03, Harris County, Texas",16199,1069,8688,938,7511,911
1400000US48201543100,48201543100,"Census Tract 5431, Harris County, Texas",2247,457,1088,313,1159,365
1400000US48201543200,48201543200,"Census Tract 5432, Harris County, Texas",5647,841,3831,764,1816,451
1400000US48201550100,48201550100,"Census Tract 5501, Harris County, Texas",4869,579,2417,419,2452,513
1400000US48201550200,48201550200,"Census Tract 5502, Harris County, Texas",3727,479,2373,388,1354,413
1400000US48201550301,48201550301,"Census Tract 5503.01, Harris County, Texas",7446,817,5574,812,1872,679
1400000US48201550302,48201550302,"Census Tract 5503.02, Harris County, Texas",9535,1089,6766,1076,2769,915
1400000US48201550401,48201550401,"Census Tract 5504.01, Harris County, Texas",10359,1310,5816,769,4543,1366
1400000US48201550402,48201550402,"Census Tract 5504.02, Harris County, Texas",9743,867,7491,928,2252,742
1400000US48201550500,48201550500,"Census Tract 5505, Harris County, Texas",4547,575,2381,418,2166,471
1400000US48201550601,48201550601,"Census Tract 5506.01, Harris County, Texas",6983,615,3673,573,3310,626
1400000US48201550602,48201550602,"Census Tract 5506.02, Harris County, Texas",2868,355,1594,437,1274,490
1400000US48201550603,48201550603,"Census Tract 5506.03, Harris County, Texas",5584,635,1627,469,3957,727
1400000US48201550700,48201550700,"Census Tract 5507, Harris County, Texas",2773,336,1716,262,1057,277
1400000US48201550800,48201550800,"Census Tract 5508, Harris County, Texas",3782,389,2684,450,1098,242
1400000US48201550900,48201550900,"Census Tract 5509, Harris County, Texas",9323,840,4203,580,5120,822
1400000US48201551000,48201551000,"Census Tract 5510, Harris County, Texas",3070,298,1243,290,1827,271
1400000US48201551100,48201551100,"Census Tract 5511, Harris County, Texas",9747,844,6003,825,3744,739
1400000US48201551200,48201551200,"Census Tract 5512, Harris County, Texas",6182,673,4607,537,1575,626
1400000US48201551300,48201551300,"Census Tract 5513, Harris County, Texas",3831,265,2722,256,1109,222
1400000US48201551400,48201551400,"Census Tract 5514, Harris County, Texas",4767,551,3378,539,1389,388
1400000US48201551500,48201551500,"Census Tract 5515, Harris County, Texas",7580,610,4544,467,3036,448
1400000US48201551600,48201551600,"Census Tract 5516, Harris County, Texas",7892,812,4236,544,3656,681
1400000US48201551701,48201551701,"Census Tract 5517.01, Harris County, Texas",8133,743,6647,642,1486,462
1400000US48201551702,48201551702,"Census Tract 5517.02, Harris County, Texas",3952,315,3410,345,542,187
1400000US48201551703,48201551703,"Census Tract 5517.03, Harris County, Texas",7239,589,5190,506,2049,513
1400000US48201551800,48201551800,"Census Tract 5518, Harris County, Texas",4712,368,4267,397,445,243
1400000US48201551900,48201551900,"Census Tract 5519, Harris County, Texas",5245,535,3524,350,1721,507
1400000US48201552001,48201552001,"Census Tract 5520.01, Harris County, Texas",8624,831,6667,784,1957,499
1400000US48201552002,48201552002,"Census Tract 5520.02, Harris County, Texas",2090,371,1728,394,362,324
1400000US48201552101,48201552101,"Census Tract 5521.01, Harris County, Texas",3799,439,2911,348,888,407
1400000US48201552102,48201552102,"Census Tract 5521.02, Harris County, Texas",6116,427,5142,466,974,268
1400000US48201552103,48201552103,"Census Tract 5521.03, Harris County, Texas",3041,320,2161,349,880,254
1400000US48201552200,48201552200,"Census Tract 5522, Harris County, Texas",6408,577,4899,400,1509,482
1400000US48201552301,48201552301,"Census Tract 5523.01, Harris County, Texas",3855,223,3285,355,570,301
1400000US48201552302,48201552302,"Census Tract 5523.02, Harris County, Texas",4856,603,4120,617,736,344
1400000US48201552400,48201552400,"Census Tract 5524, Harris County, Texas",6543,429,4413,412,2130,509
1400000US48201552500,48201552500,"Census Tract 5525, Harris County, Texas",10230,690,7237,661,2993,639
1400000US48201552601,48201552601,"Census Tract 5526.01, Harris County, Texas",5033,560,3657,401,1376,535
1400000US48201552602,48201552602,"Census Tract 5526.02, Harris County, Texas",6131,1000,4542,571,1589,1004
1400000US48201552700,48201552700,"Census Tract 5527, Harris County, Texas",7809,682,5641,588,2168,649
1400000US48201552800,48201552800,"Census Tract 5528, Harris County, Texas",8678,662,7367,502,1311,584
1400000US48201552900,48201552900,"Census Tract 5529, Harris County, Texas",6192,479,5484,491,708,209
1400000US48201553001,48201553001,"Census Tract 5530.01, Harris County, Texas",5553,582,4058,529,1495,456
1400000US48201553002,48201553002,"Census Tract 5530.02, Harris County, Texas",4529,310,3333,498,1196,570
1400000US48201553100,48201553100,"Census Tract 5531, Harris County, Texas",5769,581,4205,505,1564,440
1400000US48201553200,48201553200,"Census Tract 5532, Harris County, Texas",6912,738,4479,626,2433,686
1400000US48201553300,48201553300,"Census Tract 5533, Harris County, Texas",4048,524,3180,477,868,338
1400000US48201553401,48201553401,"Census Tract 5534.01, Harris County, Texas",3745,368,2961,383,784,257
1400000US48201553402,48201553402,"Census Tract 5534.02, Harris County, Texas",6818,552,5764,528,1054,359
1400000US48201553403,48201553403,"Census Tract 5534.03, Harris County, Texas",6116,551,4717,621,1399,378
1400000US48201553500,48201553500,"Census Tract 5535, Harris County, Texas",5942,485,4751,441,1191,339
1400000US48201553600,48201553600,"Census Tract 5536, Harris County, Texas",6854,806,5598,708,1256,604
1400000US48201553700,48201553700,"Census Tract 5537, Harris County, Texas",4089,379,3379,344,710,368
1400000US48201553801,48201553801,"Census Tract 5538.01, Harris County, Texas",2704,381,2186,227,518,422
1400000US48201553802,48201553802,"Census Tract 5538.02, Harris County, Texas",7299,505,6060,389,1239,424
1400000US48201553900,48201553900,"Census Tract 5539, Harris County, Texas",7856,704,7428,713,428,176
1400000US48201554001,48201554001,"Census Tract 5540.01, Harris County, Texas",3596,316,2943,310,653,178
1400000US48201554002,48201554002,"Census Tract 5540.02, Harris County, Texas",4356,477,3995,461,361,148
1400000US48201554101,48201554101,"Census Tract 5541.01, Harris County, Texas",1056,76,1003,79,53,62
1400000US48201554102,48201554102,"Census Tract 5541.02, Harris County, Texas",9910,523,8675,551,1235,435
1400000US48201554200,48201554200,"Census Tract 5542, Harris County, Texas",6591,685,4288,493,2303,571
1400000US48201554301,48201554301,"Census Tract 5543.01, Harris County, Texas",6641,449,5914,433,727,193
1400000US48201554302,48201554302,"Census Tract 5543.02, Harris County, Texas",4363,344,3758,401,605,270
1400000US48201554401,48201554401,"Census Tract 5544.01, Harris County, Texas",12871,596,11676,655,1195,394
1400000US48201554402,48201554402,"Census Tract 5544.02, Harris County, Texas",12125,822,10990,817,1135,485
1400000US48201554403,48201554403,"Census Tract 5544.03, Harris County, Texas",8709,475,5990,597,2719,620
1400000US48201554501,48201554501,"Census Tract 5545.01, Harris County, Texas",5776,585,4152,496,1624,614
1400000US48201554502,48201554502,"Census Tract 5545.02, Harris County, Texas",6372,261,5874,323,498,210
1400000US48201554600,48201554600,"Census Tract 5546, Harris County, Texas",4846,259,4325,255,521,201
1400000US48201554700,48201554700,"Census Tract 5547, Harris County, Texas",6973,436,5923,461,1050,300
1400000US48201554801,48201554801,"Census Tract 5548.01, Harris County, Texas",15096,905,10954,909,4142,905
1400000US48201554802,48201554802,"Census Tract 5548.02, Harris County, Texas",14028,919,11885,770,2143,726
1400000US48201554901,48201554901,"Census Tract 5549.01, Harris County, Texas",8908,828,6967,798,1941,563
1400000US48201554902,48201554902,"Census Tract 5549.02, Harris County, Texas",6655,816,5595,778,1060,401
1400000US48201554903,48201554903,"Census Tract 5549.03, Harris County, Texas",10993,622,9050,635,1943,442
1400000US48201555000,48201555000,"Census Tract 5550, Harris County, Texas",7978,375,6494,484,1484,315
1400000US48201555100,48201555100,"Census Tract 5551, Harris County, Texas",8120,516,5937,467,2183,436
1400000US48201555200,48201555200,"Census Tract 5552, Harris County, Texas",6568,680,4490,501,2078,562
1400000US48201555301,48201555301,"Census Tract 5553.01, Harris County, Texas",815,135,765,156,50,59
1400000US48201555302,48201555302,"Census Tract 5553.02, Harris County, Texas",10327,967,8345,857,1982,843
1400000US48201555303,48201555303,"Census Tract 5553.03, Harris County, Texas",4263,417,3357,423,906,190
1400000US48201555401,48201555401,"Census Tract 5554.01, Harris County, Texas",2485,372,1988,331,497,261
1400000US48201555402,48201555402,"Census Tract 5554.02, Harris County, Texas",8110,455,6716,530,1394,423
1400000US48201555501,48201555501,"Census Tract 5555.01, Harris County, Texas",4432,648,3258,478,1174,655
1400000US48201555502,48201555502,"Census Tract 5555.02, Harris County, Texas",17223,1144,12898,937,4325,1319
1400000US48201555600,48201555600,"Census Tract 5556, Harris County, Texas",4734,475,3488,286,1246,425
1400000US48201555701,48201555701,"Census Tract 5557.01, Harris County, Texas",6712,478,5421,544,1291,393
1400000US48201555702,48201555702,"Census Tract 5557.02, Harris County, Texas",9440,464,8484,516,956,305
1400000US48201556000,48201556000,"Census Tract 5560, Harris County, Texas",6838,631,4604,608,2234,559
1400000US48201980000,48201980000,"Census Tract 9800, Harris County, Texas",44,58,4,6,40,58
1400000US48201980100,48201980100,"Census Tract 9801, Harris County, Texas",534,226,289,201,245,135
1400000US48203020102,48203020102,"Census Tract 201.02, Harrison County, Texas",4953,484,4663,490,290,185
1400000US48203020103,48203020103,"Census Tract 201.03, Harrison County, Texas",4142,584,3764,565,378,296
1400000US48203020104,48203020104,"Census Tract 201.04, Harrison County, Texas",3979,466,3606,406,373,303
1400000US48203020200,48203020200,"Census Tract 202, Harrison County, Texas",7197,521,6800,507,397,257
1400000US48203020301,48203020301,"Census Tract 203.01, Harrison County, Texas",4212,365,3849,398,363,223
1400000US48203020302,48203020302,"Census Tract 203.02, Harrison County, Texas",4074,450,2890,600,1184,577
1400000US48203020401,48203020401,"Census Tract 204.01, Harrison County, Texas",4662,491,3685,491,977,293
1400000US48203020402,48203020402,"Census Tract 204.02, Harrison County, Texas",5597,414,4813,417,784,164
1400000US48203020501,48203020501,"Census Tract 205.01, Harrison County, Texas",2589,445,1853,416,736,211
1400000US48203020502,48203020502,"Census Tract 205.02, Harrison County, Texas",4608,449,4102,429,506,221
1400000US48203020603,48203020603,"Census Tract 206.03, Harrison County, Texas",5801,795,5174,737,627,365
1400000US48203020604,48203020604,"Census Tract 206.04, Harrison County, Texas",4098,729,4052,751,46,92
1400000US48203020605,48203020605,"Census Tract 206.05, Harrison County, Texas",5132,576,4894,570,238,158
1400000US48203020606,48203020606,"Census Tract 206.06, Harrison County, Texas",4914,434,4560,496,354,227
1400000US48205950200,48205950200,"Census Tract 9502, Hartley County, Texas",6015,,4613,,1402,
1400000US48207950300,48207950300,"Census Tract 9503, Haskell County, Texas",3735,146,2645,159,1090,105
1400000US48207950400,48207950400,"Census Tract 9504, Haskell County, Texas",2156,146,1822,159,334,105
1400000US48209010100,48209010100,"Census Tract 101, Hays County, Texas",2295,274,1903,283,392,129
1400000US48209010200,48209010200,"Census Tract 102, Hays County, Texas",6054,653,4727,560,1327,254
1400000US48209010302,48209010302,"Census Tract 103.02, Hays County, Texas",4262,494,1437,328,2825,414
1400000US48209010303,48209010303,"Census Tract 103.03, Hays County, Texas",7041,739,4122,579,2919,665
1400000US48209010304,48209010304,"Census Tract 103.04, Hays County, Texas",5886,665,2901,423,2985,605
1400000US48209010400,48209010400,"Census Tract 104, Hays County, Texas",7700,706,3564,535,4136,670
1400000US48209010500,48209010500,"Census Tract 105, Hays County, Texas",3597,403,1360,341,2237,361
1400000US48209010600,48209010600,"Census Tract 106, Hays County, Texas",9452,767,6950,648,2502,556
1400000US48209010701,48209010701,"Census Tract 107.01, Hays County, Texas",7383,586,5696,486,1687,500
1400000US48209010702,48209010702,"Census Tract 107.02, Hays County, Texas",2681,424,2177,407,504,200
1400000US48209010803,48209010803,"Census Tract 108.03, Hays County, Texas",4274,487,3893,512,381,212
1400000US48209010804,48209010804,"Census Tract 108.04, Hays County, Texas",8711,650,8126,657,585,214
1400000US48209010805,48209010805,"Census Tract 108.05, Hays County, Texas",5822,503,5283,486,539,188
1400000US48209010806,48209010806,"Census Tract 108.06, Hays County, Texas",3909,553,3756,591,153,105
1400000US48209010807,48209010807,"Census Tract 108.07, Hays County, Texas",2043,340,1459,291,584,271
1400000US48209010808,48209010808,"Census Tract 108.08, Hays County, Texas",5952,451,5267,445,685,295
1400000US48209010809,48209010809,"Census Tract 108.09, Hays County, Texas",5151,483,4361,490,790,472
1400000US48209010901,48209010901,"Census Tract 109.01, Hays County, Texas",7818,489,6619,570,1199,309
1400000US48209010902,48209010902,"Census Tract 109.02, Hays County, Texas",10258,665,6895,567,3363,500
1400000US48209010905,48209010905,"Census Tract 109.05, Hays County, Texas",5641,563,3316,507,2325,537
1400000US48209010906,48209010906,"Census Tract 109.06, Hays County, Texas",11196,625,4189,656,7007,773
1400000US48209010907,48209010907,"Census Tract 109.07, Hays County, Texas",10171,909,3048,531,7123,750
1400000US48209010908,48209010908,"Census Tract 109.08, Hays County, Texas",8014,777,3688,658,4326,940
1400000US48209010909,48209010909,"Census Tract 109.09, Hays County, Texas",4756,419,3677,414,1079,298
1400000US48209010910,48209010910,"Census Tract 109.10, Hays County, Texas",8397,568,3948,418,4449,596
1400000US48211950300,48211950300,"Census Tract 9503, Hemphill County, Texas",3863,,2692,143,1171,143
1400000US48213950100,48213950100,"Census Tract 9501, Henderson County, Texas",6891,820,6498,849,393,217
1400000US48213950200,48213950200,"Census Tract 9502, Henderson County, Texas",4580,600,4037,514,543,281
1400000US48213950300,48213950300,"Census Tract 9503, Henderson County, Texas",7559,647,6876,613,683,315
1400000US48213950400,48213950400,"Census Tract 9504, Henderson County, Texas",4460,507,4216,493,244,146
1400000US48213950500,48213950500,"Census Tract 9505, Henderson County, Texas",2396,276,2319,274,77,73
1400000US48213950601,48213950601,"Census Tract 9506.01, Henderson County, Texas",3120,423,2644,443,476,229
1400000US48213950602,48213950602,"Census Tract 9506.02, Henderson County, Texas",5365,492,4976,439,389,290
1400000US48213950700,48213950700,"Census Tract 9507, Henderson County, Texas",4327,564,3884,537,443,273
1400000US48213950800,48213950800,"Census Tract 9508, Henderson County, Texas",5196,524,4797,507,399,241
1400000US48213950901,48213950901,"Census Tract 9509.01, Henderson County, Texas",5023,505,4699,506,324,157
1400000US48213950902,48213950902,"Census Tract 9509.02, Henderson County, Texas",2045,230,1981,237,64,49
1400000US48213950903,48213950903,"Census Tract 9509.03, Henderson County, Texas",2484,343,2419,315,65,69
1400000US48213951000,48213951000,"Census Tract 9510, Henderson County, Texas",2469,300,2179,285,290,163
1400000US48213951100,48213951100,"Census Tract 9511, Henderson County, Texas",3433,453,3022,458,411,202
1400000US48213951200,48213951200,"Census Tract 9512, Henderson County, Texas",6155,465,3848,422,2307,413
1400000US48213951300,48213951300,"Census Tract 9513, Henderson County, Texas",6187,549,5123,422,1064,560
1400000US48213951400,48213951400,"Census Tract 9514, Henderson County, Texas",6868,666,6486,514,382,299
1400000US48215020101,48215020101,"Census Tract 201.01, Hidalgo County, Texas",6352,693,269,146,6083,691
1400000US48215020102,48215020102,"Census Tract 201.02, Hidalgo County, Texas",8654,1389,1163,254,7491,1415
1400000US48215020201,48215020201,"Census Tract 202.01, Hidalgo County, Texas",7285,886,113,69,7172,899
1400000US48215020202,48215020202,"Census Tract 202.02, Hidalgo County, Texas",7280,626,218,119,7062,641
1400000US48215020204,48215020204,"Census Tract 202.04, Hidalgo County, Texas",8143,844,869,262,7274,821
1400000US48215020205,48215020205,"Census Tract 202.05, Hidalgo County, Texas",4821,661,125,94,4696,686
1400000US48215020301,48215020301,"Census Tract 203.01, Hidalgo County, Texas",10068,1066,2238,520,7830,1084
1400000US48215020302,48215020302,"Census Tract 203.02, Hidalgo County, Texas",9202,1043,1564,464,7638,979
1400000US48215020402,48215020402,"Census Tract 204.02, Hidalgo County, Texas",7850,756,1864,450,5986,783
1400000US48215020403,48215020403,"Census Tract 204.03, Hidalgo County, Texas",5445,723,346,199,5099,709
1400000US48215020404,48215020404,"Census Tract 204.04, Hidalgo County, Texas",4738,565,1924,360,2814,551
1400000US48215020501,48215020501,"Census Tract 205.01, Hidalgo County, Texas",4894,663,308,107,4586,684
1400000US48215020503,48215020503,"Census Tract 205.03, Hidalgo County, Texas",10763,770,239,136,10524,787
1400000US48215020504,48215020504,"Census Tract 205.04, Hidalgo County, Texas",6813,650,411,190,6402,664
1400000US48215020600,48215020600,"Census Tract 206, Hidalgo County, Texas",2390,401,16,30,2374,402
1400000US48215020701,48215020701,"Census Tract 207.01, Hidalgo County, Texas",9633,850,1471,352,8162,866
1400000US48215020721,48215020721,"Census Tract 207.21, Hidalgo County, Texas",8154,676,744,242,7410,686
1400000US48215020723,48215020723,"Census Tract 207.23, Hidalgo County, Texas",6032,664,210,209,5822,653
1400000US48215020724,48215020724,"Census Tract 207.24, Hidalgo County, Texas",4253,506,742,185,3511,469
1400000US48215020725,48215020725,"Census Tract 207.25, Hidalgo County, Texas",4373,488,299,166,4074,508
1400000US48215020726,48215020726,"Census Tract 207.26, Hidalgo County, Texas",5825,677,937,308,4888,645
1400000US48215020802,48215020802,"Census Tract 208.02, Hidalgo County, Texas",7054,807,1105,345,5949,741
1400000US48215020803,48215020803,"Census Tract 208.03, Hidalgo County, Texas",5405,490,1164,330,4241,580
1400000US48215020804,48215020804,"Census Tract 208.04, Hidalgo County, Texas",3812,545,1219,337,2593,453
1400000US48215020901,48215020901,"Census Tract 209.01, Hidalgo County, Texas",5108,734,1330,369,3778,712
1400000US48215020903,48215020903,"Census Tract 209.03, Hidalgo County, Texas",5191,583,1194,427,3997,613
1400000US48215020904,48215020904,"Census Tract 209.04, Hidalgo County, Texas",4372,474,1174,263,3198,471
1400000US48215021000,48215021000,"Census Tract 210, Hidalgo County, Texas",6842,779,630,222,6212,802
1400000US48215021100,48215021100,"Census Tract 211, Hidalgo County, Texas",2596,514,112,83,2484,507
1400000US48215021201,48215021201,"Census Tract 212.01, Hidalgo County, Texas",2861,500,873,314,1988,454
1400000US48215021202,48215021202,"Census Tract 212.02, Hidalgo County, Texas",4802,651,1061,245,3741,644
1400000US48215021302,48215021302,"Census Tract 213.02, Hidalgo County, Texas",16325,1009,383,302,15942,1038
1400000US48215021303,48215021303,"Census Tract 213.03, Hidalgo County, Texas",8332,925,115,167,8217,918
1400000US48215021304,48215021304,"Census Tract 213.04, Hidalgo County, Texas",6230,614,80,71,6150,630
1400000US48215021305,48215021305,"Census Tract 213.05, Hidalgo County, Texas",6520,644,46,64,6474,644
1400000US48215021401,48215021401,"Census Tract 214.01, Hidalgo County, Texas",5732,921,431,199,5301,933
1400000US48215021403,48215021403,"Census Tract 214.03, Hidalgo County, Texas",5062,665,631,298,4431,654
1400000US48215021404,48215021404,"Census Tract 214.04, Hidalgo County, Texas",7689,920,1845,354,5844,909
1400000US48215021500,48215021500,"Census Tract 215, Hidalgo County, Texas",3770,500,4,4,3766,500
1400000US48215021600,48215021600,"Census Tract 216, Hidalgo County, Texas",3777,500,138,114,3639,488
1400000US48215021701,48215021701,"Census Tract 217.01, Hidalgo County, Texas",8631,989,1186,392,7445,973
1400000US48215021702,48215021702,"Census Tract 217.02, Hidalgo County, Texas",11517,1318,580,310,10937,1321
1400000US48215021803,48215021803,"Census Tract 218.03, Hidalgo County, Texas",4610,738,56,50,4554,734
1400000US48215021804,48215021804,"Census Tract 218.04, Hidalgo County, Texas",4784,773,240,295,4544,811
1400000US48215021805,48215021805,"Census Tract 218.05, Hidalgo County, Texas",9157,884,138,155,9019,878
1400000US48215021806,48215021806,"Census Tract 218.06, Hidalgo County, Texas",8848,1061,174,148,8674,1094
1400000US48215021901,48215021901,"Census Tract 219.01, Hidalgo County, Texas",9889,1052,1743,312,8146,1031
1400000US48215021903,48215021903,"Census Tract 219.03, Hidalgo County, Texas",4466,663,342,253,4124,694
1400000US48215021904,48215021904,"Census Tract 219.04, Hidalgo County, Texas",4811,687,814,180,3997,648
1400000US48215022001,48215022001,"Census Tract 220.01, Hidalgo County, Texas",10781,806,509,216,10272,791
1400000US48215022003,48215022003,"Census Tract 220.03, Hidalgo County, Texas",6468,799,956,315,5512,833
1400000US48215022004,48215022004,"Census Tract 220.04, Hidalgo County, Texas",10792,1213,1113,294,9679,1164
1400000US48215022103,48215022103,"Census Tract 221.03, Hidalgo County, Texas",5413,720,1052,332,4361,703
1400000US48215022104,48215022104,"Census Tract 221.04, Hidalgo County, Texas",9731,1323,225,191,9506,1318
1400000US48215022105,48215022105,"Census Tract 221.05, Hidalgo County, Texas",4165,794,284,280,3881,827
1400000US48215022106,48215022106,"Census Tract 221.06, Hidalgo County, Texas",4748,875,394,157,4354,896
1400000US48215022201,48215022201,"Census Tract 222.01, Hidalgo County, Texas",6818,901,660,184,6158,928
1400000US48215022203,48215022203,"Census Tract 222.03, Hidalgo County, Texas",3486,466,186,90,3300,454
1400000US48215022204,48215022204,"Census Tract 222.04, Hidalgo County, Texas",5274,624,84,98,5190,629
1400000US48215022300,48215022300,"Census Tract 223, Hidalgo County, Texas",9919,911,3026,619,6893,798
1400000US48215022401,48215022401,"Census Tract 224.01, Hidalgo County, Texas",4110,723,200,127,3910,668
1400000US48215022402,48215022402,"Census Tract 224.02, Hidalgo County, Texas",5486,681,115,116,5371,689
1400000US48215022501,48215022501,"Census Tract 225.01, Hidalgo County, Texas",6711,880,167,152,6544,844
1400000US48215022502,48215022502,"Census Tract 225.02, Hidalgo County, Texas",5321,580,317,159,5004,594
1400000US48215022600,48215022600,"Census Tract 226, Hidalgo County, Texas",2407,452,28,28,2379,459
1400000US48215022701,48215022701,"Census Tract 227.01, Hidalgo County, Texas",5067,676,1671,344,3396,586
1400000US48215022702,48215022702,"Census Tract 227.02, Hidalgo County, Texas",5451,700,1271,264,4180,698
1400000US48215022800,48215022800,"Census Tract 228, Hidalgo County, Texas",8077,632,357,193,7720,611
1400000US48215022900,48215022900,"Census Tract 229, Hidalgo County, Texas",4666,536,598,161,4068,521
1400000US48215023000,48215023000,"Census Tract 230, Hidalgo County, Texas",4188,481,256,102,3932,480
1400000US48215023102,48215023102,"Census Tract 231.02, Hidalgo County, Texas",7306,928,182,132,7124,931
1400000US48215023103,48215023103,"Census Tract 231.03, Hidalgo County, Texas",6920,849,221,148,6699,854
1400000US48215023104,48215023104,"Census Tract 231.04, Hidalgo County, Texas",5164,726,197,142,4967,747
1400000US48215023503,48215023503,"Census Tract 235.03, Hidalgo County, Texas",8025,818,366,167,7659,809
1400000US48215023504,48215023504,"Census Tract 235.04, Hidalgo County, Texas",9257,786,747,336,8510,729
1400000US48215023507,48215023507,"Census Tract 235.07, Hidalgo County, Texas",9252,948,432,247,8820,953
1400000US48215023509,48215023509,"Census Tract 235.09, Hidalgo County, Texas",9696,898,2490,594,7206,815
1400000US48215023510,48215023510,"Census Tract 235.10, Hidalgo County, Texas",9908,883,2722,465,7186,903
1400000US48215023511,48215023511,"Census Tract 235.11, Hidalgo County, Texas",9578,1304,235,179,9343,1311
1400000US48215023512,48215023512,"Census Tract 235.12, Hidalgo County, Texas",2814,408,1225,188,1589,290
1400000US48215023513,48215023513,"Census Tract 235.13, Hidalgo County, Texas",7973,1277,350,169,7623,1260
1400000US48215023514,48215023514,"Census Tract 235.14, Hidalgo County, Texas",8362,915,295,209,8067,933
1400000US48215023515,48215023515,"Census Tract 235.15, Hidalgo County, Texas",10218,1425,125,101,10093,1459
1400000US48215023600,48215023600,"Census Tract 236, Hidalgo County, Texas",8393,889,479,158,7914,897
1400000US48215023700,48215023700,"Census Tract 237, Hidalgo County, Texas",5085,513,247,172,4838,555
1400000US48215023801,48215023801,"Census Tract 238.01, Hidalgo County, Texas",8464,826,788,248,7676,823
1400000US48215023802,48215023802,"Census Tract 238.02, Hidalgo County, Texas",8658,817,1258,430,7400,833
1400000US48215023902,48215023902,"Census Tract 239.02, Hidalgo County, Texas",11139,879,2606,460,8533,931
1400000US48215023903,48215023903,"Census Tract 239.03, Hidalgo County, Texas",4158,529,314,143,3844,557
1400000US48215023904,48215023904,"Census Tract 239.04, Hidalgo County, Texas",8185,687,917,269,7268,756
1400000US48215024000,48215024000,"Census Tract 240, Hidalgo County, Texas",16564,1089,1556,439,15008,1076
1400000US48215024105,48215024105,"Census Tract 241.05, Hidalgo County, Texas",8985,947,855,262,8130,927
1400000US48215024106,48215024106,"Census Tract 241.06, Hidalgo County, Texas",11505,1479,1320,408,10185,1395
1400000US48215024107,48215024107,"Census Tract 241.07, Hidalgo County, Texas",5337,723,309,118,5028,709
1400000US48215024108,48215024108,"Census Tract 241.08, Hidalgo County, Texas",6377,864,77,81,6300,888
1400000US48215024109,48215024109,"Census Tract 241.09, Hidalgo County, Texas",5867,794,129,166,5738,792
1400000US48215024110,48215024110,"Census Tract 241.10, Hidalgo County, Texas",9838,1185,265,315,9573,1174
1400000US48215024111,48215024111,"Census Tract 241.11, Hidalgo County, Texas",5084,686,240,182,4844,672
1400000US48215024112,48215024112,"Census Tract 241.12, Hidalgo County, Texas",13128,1373,112,111,13016,1371
1400000US48215024113,48215024113,"Census Tract 241.13, Hidalgo County, Texas",7243,770,197,211,7046,808
1400000US48215024114,48215024114,"Census Tract 241.14, Hidalgo County, Texas",9794,975,113,121,9681,976
1400000US48215024201,48215024201,"Census Tract 242.01, Hidalgo County, Texas",14492,1277,10,12,14482,1278
1400000US48215024203,48215024203,"Census Tract 242.03, Hidalgo County, Texas",5833,824,1517,365,4316,734
1400000US48215024204,48215024204,"Census Tract 242.04, Hidalgo County, Texas",3599,513,280,265,3319,553
1400000US48215024205,48215024205,"Census Tract 242.05, Hidalgo County, Texas",7257,804,38,30,7219,804
1400000US48215024301,48215024301,"Census Tract 243.01, Hidalgo County, Texas",1196,310,208,128,988,257
1400000US48215024302,48215024302,"Census Tract 243.02, Hidalgo County, Texas",1049,283,219,172,830,269
1400000US48215024402,48215024402,"Census Tract 244.02, Hidalgo County, Texas",9809,1256,364,352,9445,1192
1400000US48215024403,48215024403,"Census Tract 244.03, Hidalgo County, Texas",5457,473,0,18,5457,473
1400000US48215024404,48215024404,"Census Tract 244.04, Hidalgo County, Texas",3731,637,156,171,3575,663
1400000US48215024500,48215024500,"Census Tract 245, Hidalgo County, Texas",7687,716,139,182,7548,706
1400000US48215024600,48215024600,"Census Tract 246, Hidalgo County, Texas",6193,709,38,26,6155,712
1400000US48215980000,48215980000,"Census Tract 9800, Hidalgo County, Texas",0,13,0,13,0,13
1400000US48217960100,48217960100,"Census Tract 9601, Hill County, Texas",4255,322,3567,319,688,151
1400000US48217960200,48217960200,"Census Tract 9602, Hill County, Texas",4046,365,3958,369,88,57
1400000US48217960400,48217960400,"Census Tract 9604, Hill County, Texas",1758,304,1685,300,73,62
1400000US48217960500,48217960500,"Census Tract 9605, Hill County, Texas",5778,515,5430,511,348,189
1400000US48217960600,48217960600,"Census Tract 9606, Hill County, Texas",1426,213,1139,227,287,117
1400000US48217960700,48217960700,"Census Tract 9607, Hill County, Texas",2095,227,1729,203,366,157
1400000US48217960800,48217960800,"Census Tract 9608, Hill County, Texas",3193,341,2301,251,892,381
1400000US48217960900,48217960900,"Census Tract 9609, Hill County, Texas",2673,288,913,229,1760,245
1400000US48217961000,48217961000,"Census Tract 9610, Hill County, Texas",1937,255,1099,231,838,253
1400000US48217961100,48217961100,"Census Tract 9611, Hill County, Texas",3721,361,3042,317,679,224
1400000US48217961400,48217961400,"Census Tract 9614, Hill County, Texas",4197,399,3762,400,435,165
1400000US48219950100,48219950100,"Census Tract 9501, Hockley County, Texas",1466,188,787,142,679,201
1400000US48219950200,48219950200,"Census Tract 9502, Hockley County, Texas",4405,317,3042,319,1363,284
1400000US48219950300,48219950300,"Census Tract 9503, Hockley County, Texas",4609,366,2662,276,1947,404
1400000US48219950400,48219950400,"Census Tract 9504, Hockley County, Texas",4760,391,1425,202,3335,410
1400000US48219950500,48219950500,"Census Tract 9505, Hockley County, Texas",4846,360,3323,381,1523,253
1400000US48219950600,48219950600,"Census Tract 9506, Hockley County, Texas",1475,160,911,118,564,143
1400000US48219950700,48219950700,"Census Tract 9507, Hockley County, Texas",1427,198,722,142,705,205
1400000US48221160100,48221160100,"Census Tract 1601, Hood County, Texas",4389,440,3837,349,552,287
1400000US48221160204,48221160204,"Census Tract 1602.04, Hood County, Texas",3192,458,3022,499,170,167
1400000US48221160205,48221160205,"Census Tract 1602.05, Hood County, Texas",6333,845,5435,688,898,362
1400000US48221160206,48221160206,"Census Tract 1602.06, Hood County, Texas",3537,304,3330,318,207,181
1400000US48221160207,48221160207,"Census Tract 1602.07, Hood County, Texas",5664,436,5453,413,211,140
1400000US48221160208,48221160208,"Census Tract 1602.08, Hood County, Texas",5570,624,4221,449,1349,496
1400000US48221160209,48221160209,"Census Tract 1602.09, Hood County, Texas",7338,457,6785,485,553,235
1400000US48221160210,48221160210,"Census Tract 1602.10, Hood County, Texas",5142,371,4698,392,444,252
1400000US48221160301,48221160301,"Census Tract 1603.01, Hood County, Texas",5646,445,4937,437,709,199
1400000US48221160302,48221160302,"Census Tract 1603.02, Hood County, Texas",4350,425,4144,405,206,134
1400000US48223950100,48223950100,"Census Tract 9501, Hopkins County, Texas",3303,257,2880,244,423,174
1400000US48223950200,48223950200,"Census Tract 9502, Hopkins County, Texas",4430,355,4105,388,325,192
1400000US48223950300,48223950300,"Census Tract 9503, Hopkins County, Texas",5770,549,4480,365,1290,451
1400000US48223950401,48223950401,"Census Tract 9504.01, Hopkins County, Texas",4063,396,3251,351,812,398
1400000US48223950402,48223950402,"Census Tract 9504.02, Hopkins County, Texas",3485,363,3031,332,454,159
1400000US48223950500,48223950500,"Census Tract 9505, Hopkins County, Texas",3302,320,2765,306,537,177
1400000US48223950600,48223950600,"Census Tract 9506, Hopkins County, Texas",4016,432,3602,378,414,273
1400000US48223950700,48223950700,"Census Tract 9507, Hopkins County, Texas",4394,407,3780,358,614,226
1400000US48223950800,48223950800,"Census Tract 9508, Hopkins County, Texas",2325,308,1880,277,445,214
1400000US48225950100,48225950100,"Census Tract 9501, Houston County, Texas",5307,502,5027,503,280,162
1400000US48225950200,48225950200,"Census Tract 9502, Houston County, Texas",1764,298,1419,262,345,208
1400000US48225950300,48225950300,"Census Tract 9503, Houston County, Texas",2502,353,2348,344,154,93
1400000US48225950400,48225950400,"Census Tract 9504, Houston County, Texas",3811,361,3226,369,585,229
1400000US48225950500,48225950500,"Census Tract 9505, Houston County, Texas",4293,385,3878,391,415,171
1400000US48225950600,48225950600,"Census Tract 9506, Houston County, Texas",1771,296,1669,282,102,114
1400000US48225950700,48225950700,"Census Tract 9507, Houston County, Texas",4064,440,3580,426,484,114
1400000US48227950100,48227950100,"Census Tract 9501, Howard County, Texas",2384,230,1885,249,499,163
1400000US48227950200,48227950200,"Census Tract 9502, Howard County, Texas",1947,216,1512,219,435,156
1400000US48227950300,48227950300,"Census Tract 9503, Howard County, Texas",1834,336,614,175,1220,273
1400000US48227950400,48227950400,"Census Tract 9504, Howard County, Texas",3341,385,2360,309,981,344
1400000US48227950500,48227950500,"Census Tract 9505, Howard County, Texas",3172,363,1562,352,1610,324
1400000US48227950600,48227950600,"Census Tract 9506, Howard County, Texas",4342,343,3438,348,904,191
1400000US48227950700,48227950700,"Census Tract 9507, Howard County, Texas",3076,384,1737,354,1339,284
1400000US48227950801,48227950801,"Census Tract 9508.01, Howard County, Texas",4585,407,3052,353,1533,389
1400000US48227950802,48227950802,"Census Tract 9508.02, Howard County, Texas",6760,514,2442,279,4318,400
1400000US48227950900,48227950900,"Census Tract 9509, Howard County, Texas",3486,289,2939,316,547,163
1400000US48229950300,48229950300,"Census Tract 9503, Hudspeth County, Texas",3407,,707,,2700,
1400000US48231960100,48231960100,"Census Tract 9601, Hunt County, Texas",2542,398,2428,398,114,96
1400000US48231960200,48231960200,"Census Tract 9602, Hunt County, Texas",2529,350,2231,213,298,279
1400000US48231960300,48231960300,"Census Tract 9603, Hunt County, Texas",3996,393,3549,321,447,271
1400000US48231960400,48231960400,"Census Tract 9604, Hunt County, Texas",5196,585,4009,427,1187,455
1400000US48231960500,48231960500,"Census Tract 9605, Hunt County, Texas",3665,294,3211,351,454,233
1400000US48231960600,48231960600,"Census Tract 9606, Hunt County, Texas",4061,297,3447,427,614,341
1400000US48231960700,48231960700,"Census Tract 9607, Hunt County, Texas",5695,500,5102,502,593,290
1400000US48231960800,48231960800,"Census Tract 9608, Hunt County, Texas",4297,520,1942,373,2355,412
1400000US48231960900,48231960900,"Census Tract 9609, Hunt County, Texas",4505,640,3387,463,1118,423
1400000US48231961000,48231961000,"Census Tract 9610, Hunt County, Texas",3996,445,3158,362,838,253
1400000US48231961100,48231961100,"Census Tract 9611, Hunt County, Texas",6790,701,6401,698,389,322
1400000US48231961200,48231961200,"Census Tract 9612, Hunt County, Texas",4157,438,3913,403,244,142
1400000US48231961300,48231961300,"Census Tract 9613, Hunt County, Texas",6441,565,5833,542,608,153
1400000US48231961400,48231961400,"Census Tract 9614, Hunt County, Texas",6941,481,5953,410,988,340
1400000US48231961501,48231961501,"Census Tract 9615.01, Hunt County, Texas",3274,446,3117,472,157,150
1400000US48231961502,48231961502,"Census Tract 9615.02, Hunt County, Texas",4864,522,4139,480,725,272
1400000US48231961503,48231961503,"Census Tract 9615.03, Hunt County, Texas",4204,333,3983,371,221,151
1400000US48231961600,48231961600,"Census Tract 9616, Hunt County, Texas",5635,491,5289,497,346,189
1400000US48231961700,48231961700,"Census Tract 9617, Hunt County, Texas",3167,496,3063,484,104,100
1400000US48233950200,48233950200,"Census Tract 9502, Hutchinson County, Texas",2528,264,2296,247,232,88
1400000US48233950500,48233950500,"Census Tract 9505, Hutchinson County, Texas",5265,310,4893,348,372,200
1400000US48233950600,48233950600,"Census Tract 9506, Hutchinson County, Texas",3813,410,2241,416,1572,389
1400000US48233950700,48233950700,"Census Tract 9507, Hutchinson County, Texas",1822,309,1272,237,550,248
1400000US48233950800,48233950800,"Census Tract 9508, Hutchinson County, Texas",479,177,256,78,223,137
1400000US48233950900,48233950900,"Census Tract 9509, Hutchinson County, Texas",4467,379,3529,346,938,311
1400000US48233951000,48233951000,"Census Tract 9510, Hutchinson County, Texas",3618,489,3085,330,533,354
1400000US48235950100,48235950100,"Census Tract 9501, Irion County, Texas",1596,136,1136,131,460,48
1400000US48237950100,48237950100,"Census Tract 9501, Jack County, Texas",2835,265,2428,252,407,145
1400000US48237950300,48237950300,"Census Tract 9503, Jack County, Texas",3329,149,2683,210,646,162
1400000US48237950500,48237950500,"Census Tract 9505, Jack County, Texas",2863,214,2613,207,250,125
1400000US48239950100,48239950100,"Census Tract 9501, Jackson County, Texas",5130,438,3721,417,1409,286
1400000US48239950200,48239950200,"Census Tract 9502, Jackson County, Texas",3790,398,2546,312,1244,280
1400000US48239950300,48239950300,"Census Tract 9503, Jackson County, Texas",5155,468,3695,388,1460,298
1400000US48241950100,48241950100,"Census Tract 9501, Jasper County, Texas",6102,561,5995,550,107,82
1400000US48241950200,48241950200,"Census Tract 9502, Jasper County, Texas",3406,350,2952,311,454,199
1400000US48241950300,48241950300,"Census Tract 9503, Jasper County, Texas",3471,340,2956,289,515,209
1400000US48241950400,48241950400,"Census Tract 9504, Jasper County, Texas",5022,526,4577,482,445,153
1400000US48241950500,48241950500,"Census Tract 9505, Jasper County, Texas",4473,396,4398,397,75,63
1400000US48241950600,48241950600,"Census Tract 9506, Jasper County, Texas",2389,257,2132,284,257,121
1400000US48241950700,48241950700,"Census Tract 9507, Jasper County, Texas",8328,600,8165,612,163,115
1400000US48241950800,48241950800,"Census Tract 9508, Jasper County, Texas",2512,387,2493,386,19,23
1400000US48243950100,48243950100,"Census Tract 9501, Jeff Davis County, Texas",2319,,1286,213,1033,213
1400000US48245000101,48245000101,"Census Tract 1.01, Jefferson County, Texas",5051,596,4534,519,517,285
1400000US48245000102,48245000102,"Census Tract 1.02, Jefferson County, Texas",1839,251,1627,244,212,157
1400000US48245000103,48245000103,"Census Tract 1.03, Jefferson County, Texas",2750,343,2568,362,182,139
1400000US48245000200,48245000200,"Census Tract 2, Jefferson County, Texas",4896,295,4511,285,385,110
1400000US48245000302,48245000302,"Census Tract 3.02, Jefferson County, Texas",6809,571,6443,622,366,212
1400000US48245000304,48245000304,"Census Tract 3.04, Jefferson County, Texas",6953,558,5556,595,1397,435
1400000US48245000306,48245000306,"Census Tract 3.06, Jefferson County, Texas",4137,280,3832,319,305,161
1400000US48245000307,48245000307,"Census Tract 3.07, Jefferson County, Texas",3056,343,2713,356,343,240
1400000US48245000308,48245000308,"Census Tract 3.08, Jefferson County, Texas",5585,619,5287,651,298,235
1400000US48245000309,48245000309,"Census Tract 3.09, Jefferson County, Texas",2654,318,2528,333,126,105
1400000US48245000310,48245000310,"Census Tract 3.10, Jefferson County, Texas",5484,645,4909,648,575,329
1400000US48245000400,48245000400,"Census Tract 4, Jefferson County, Texas",4355,478,4224,487,131,97
1400000US48245000500,48245000500,"Census Tract 5, Jefferson County, Texas",2104,311,1492,251,612,248
1400000US48245000600,48245000600,"Census Tract 6, Jefferson County, Texas",7224,1003,5960,1036,1264,549
1400000US48245000700,48245000700,"Census Tract 7, Jefferson County, Texas",3211,492,3146,495,65,65
1400000US48245000900,48245000900,"Census Tract 9, Jefferson County, Texas",1992,299,1798,276,194,169
1400000US48245001100,48245001100,"Census Tract 11, Jefferson County, Texas",2598,383,2208,323,390,252
1400000US48245001200,48245001200,"Census Tract 12, Jefferson County, Texas",2461,337,1752,306,709,281
1400000US48245001301,48245001301,"Census Tract 13.01, Jefferson County, Texas",5393,537,4465,448,928,482
1400000US48245001302,48245001302,"Census Tract 13.02, Jefferson County, Texas",2854,380,2449,313,405,210
1400000US48245001303,48245001303,"Census Tract 13.03, Jefferson County, Texas",3043,255,2866,248,177,137
1400000US48245001700,48245001700,"Census Tract 17, Jefferson County, Texas",1809,241,1783,243,26,35
1400000US48245001900,48245001900,"Census Tract 19, Jefferson County, Texas",3050,481,1729,367,1321,270
1400000US48245002000,48245002000,"Census Tract 20, Jefferson County, Texas",2419,215,1608,183,811,203
1400000US48245002100,48245002100,"Census Tract 21, Jefferson County, Texas",4012,497,3500,429,512,387
1400000US48245002200,48245002200,"Census Tract 22, Jefferson County, Texas",2897,330,2844,335,53,69
1400000US48245002300,48245002300,"Census Tract 23, Jefferson County, Texas",3094,458,2895,435,199,150
1400000US48245002400,48245002400,"Census Tract 24, Jefferson County, Texas",2422,325,2026,307,396,176
1400000US48245002500,48245002500,"Census Tract 25, Jefferson County, Texas",4463,525,3501,448,962,431
1400000US48245002600,48245002600,"Census Tract 26, Jefferson County, Texas",5517,544,5186,519,331,132
1400000US48245005100,48245005100,"Census Tract 51, Jefferson County, Texas",977,267,967,264,10,16
1400000US48245005400,48245005400,"Census Tract 54, Jefferson County, Texas",1318,277,1030,254,288,181
1400000US48245005500,48245005500,"Census Tract 55, Jefferson County, Texas",2302,273,1640,236,662,219
1400000US48245005600,48245005600,"Census Tract 56, Jefferson County, Texas",3805,478,1514,432,2291,493
1400000US48245005900,48245005900,"Census Tract 59, Jefferson County, Texas",1526,274,1514,275,12,19
1400000US48245006100,48245006100,"Census Tract 61, Jefferson County, Texas",1169,189,1156,188,13,20
1400000US48245006300,48245006300,"Census Tract 63, Jefferson County, Texas",1643,301,1491,274,152,217
1400000US48245006400,48245006400,"Census Tract 64, Jefferson County, Texas",1316,342,886,259,430,236
1400000US48245006500,48245006500,"Census Tract 65, Jefferson County, Texas",3331,309,1821,353,1510,382
1400000US48245006600,48245006600,"Census Tract 66, Jefferson County, Texas",4209,463,2840,314,1369,362
1400000US48245006700,48245006700,"Census Tract 67, Jefferson County, Texas",2888,455,1205,242,1683,360
1400000US48245006800,48245006800,"Census Tract 68, Jefferson County, Texas",1921,218,1129,166,792,169
1400000US48245006900,48245006900,"Census Tract 69, Jefferson County, Texas",3150,322,3127,320,23,37
1400000US48245007001,48245007001,"Census Tract 70.01, Jefferson County, Texas",5668,462,5109,507,559,225
1400000US48245007002,48245007002,"Census Tract 70.02, Jefferson County, Texas",4654,472,4115,503,539,179
1400000US48245007100,48245007100,"Census Tract 71, Jefferson County, Texas",3918,431,2818,402,1100,389
1400000US48245010100,48245010100,"Census Tract 101, Jefferson County, Texas",2882,425,1041,316,1841,425
1400000US48245010200,48245010200,"Census Tract 102, Jefferson County, Texas",1834,238,1261,219,573,207
1400000US48245010300,48245010300,"Census Tract 103, Jefferson County, Texas",3338,563,1418,375,1920,454
1400000US48245010400,48245010400,"Census Tract 104, Jefferson County, Texas",3006,259,2773,299,233,132
1400000US48245010500,48245010500,"Census Tract 105, Jefferson County, Texas",4026,490,3086,445,940,330
1400000US48245010600,48245010600,"Census Tract 106, Jefferson County, Texas",5686,363,4728,428,958,323
1400000US48245010700,48245010700,"Census Tract 107, Jefferson County, Texas",3242,279,3004,250,238,136
1400000US48245010800,48245010800,"Census Tract 108, Jefferson County, Texas",5092,337,4775,327,317,170
1400000US48245010901,48245010901,"Census Tract 109.01, Jefferson County, Texas",3153,317,2976,298,177,144
1400000US48245010902,48245010902,"Census Tract 109.02, Jefferson County, Texas",4767,300,4314,281,453,321
1400000US48245011001,48245011001,"Census Tract 110.01, Jefferson County, Texas",5475,430,4961,469,514,272
1400000US48245011002,48245011002,"Census Tract 110.02, Jefferson County, Texas",3859,297,3471,291,388,152
1400000US48245011101,48245011101,"Census Tract 111.01, Jefferson County, Texas",4275,243,3639,274,636,181
1400000US48245011102,48245011102,"Census Tract 111.02, Jefferson County, Texas",2530,298,2299,311,231,144
1400000US48245011201,48245011201,"Census Tract 112.01, Jefferson County, Texas",8551,892,7177,792,1374,585
1400000US48245011202,48245011202,"Census Tract 112.02, Jefferson County, Texas",3857,744,2779,606,1078,210
1400000US48245011203,48245011203,"Census Tract 112.03, Jefferson County, Texas",1910,179,1381,158,529,132
1400000US48245011302,48245011302,"Census Tract 113.02, Jefferson County, Texas",5268,343,3350,267,1918,231
1400000US48245011303,48245011303,"Census Tract 113.03, Jefferson County, Texas",2191,281,2025,275,166,126
1400000US48245011304,48245011304,"Census Tract 113.04, Jefferson County, Texas",4063,390,3665,309,398,198
1400000US48245011400,48245011400,"Census Tract 114, Jefferson County, Texas",6996,420,6201,411,795,277
1400000US48245011500,48245011500,"Census Tract 115, Jefferson County, Texas",2263,302,2083,310,180,111
1400000US48245011600,48245011600,"Census Tract 116, Jefferson County, Texas",1848,290,1541,208,307,257
1400000US48245011700,48245011700,"Census Tract 117, Jefferson County, Texas",1766,447,952,262,814,423
1400000US48245011800,48245011800,"Census Tract 118, Jefferson County, Texas",1729,303,1563,306,166,150
1400000US48245980000,48245980000,"Census Tract 9800, Jefferson County, Texas",93,83,93,83,0,13
1400000US48245990000,48245990000,"Census Tract 9900, Jefferson County, Texas",0,13,0,13,0,13
1400000US48247950200,48247950200,"Census Tract 9502, Jim Hogg County, Texas",2604,386,89,71,2515,385
1400000US48247950400,48247950400,"Census Tract 9504, Jim Hogg County, Texas",2653,386,259,111,2394,418
1400000US48249950100,48249950100,"Census Tract 9501, Jim Wells County, Texas",8273,730,3979,397,4294,775
1400000US48249950200,48249950200,"Census Tract 9502, Jim Wells County, Texas",7763,724,1136,379,6627,742
1400000US48249950300,48249950300,"Census Tract 9503, Jim Wells County, Texas",7051,535,1379,288,5672,514
1400000US48249950400,48249950400,"Census Tract 9504, Jim Wells County, Texas",4061,397,832,198,3229,429
1400000US48249950500,48249950500,"Census Tract 9505, Jim Wells County, Texas",5918,629,681,244,5237,636
1400000US48249950600,48249950600,"Census Tract 9506, Jim Wells County, Texas",4550,441,201,95,4349,445
1400000US48249950700,48249950700,"Census Tract 9507, Jim Wells County, Texas",3398,251,441,164,2957,288
1400000US48251130100,48251130100,"Census Tract 1301, Johnson County, Texas",3972,511,3425,367,547,330
1400000US48251130204,48251130204,"Census Tract 1302.04, Johnson County, Texas",10220,550,9076,447,1144,345
1400000US48251130205,48251130205,"Census Tract 1302.05, Johnson County, Texas",3981,314,3373,328,608,216
1400000US48251130207,48251130207,"Census Tract 1302.07, Johnson County, Texas",6304,285,5615,482,689,386
1400000US48251130208,48251130208,"Census Tract 1302.08, Johnson County, Texas",5476,401,5015,396,461,167
1400000US48251130210,48251130210,"Census Tract 1302.10, Johnson County, Texas",4254,421,3978,415,276,192
1400000US48251130211,48251130211,"Census Tract 1302.11, Johnson County, Texas",6354,757,5069,635,1285,557
1400000US48251130212,48251130212,"Census Tract 1302.12, Johnson County, Texas",5645,785,4817,765,828,282
1400000US48251130213,48251130213,"Census Tract 1302.13, Johnson County, Texas",4756,500,3528,360,1228,407
1400000US48251130214,48251130214,"Census Tract 1302.14, Johnson County, Texas",4589,466,3961,447,628,235
1400000US48251130215,48251130215,"Census Tract 1302.15, Johnson County, Texas",3651,334,3402,341,249,123
1400000US48251130302,48251130302,"Census Tract 1303.02, Johnson County, Texas",5436,495,4509,607,927,333
1400000US48251130303,48251130303,"Census Tract 1303.03, Johnson County, Texas",3619,505,2240,449,1379,424
1400000US48251130304,48251130304,"Census Tract 1303.04, Johnson County, Texas",5383,718,3700,724,1683,687
1400000US48251130405,48251130405,"Census Tract 1304.05, Johnson County, Texas",5787,390,5096,461,691,321
1400000US48251130406,48251130406,"Census Tract 1304.06, Johnson County, Texas",5919,542,5453,537,466,190
1400000US48251130407,48251130407,"Census Tract 1304.07, Johnson County, Texas",7780,801,4233,539,3547,734
1400000US48251130408,48251130408,"Census Tract 1304.08, Johnson County, Texas",7449,570,5906,487,1543,449
1400000US48251130409,48251130409,"Census Tract 1304.09, Johnson County, Texas",6281,697,5638,657,643,304
1400000US48251130410,48251130410,"Census Tract 1304.10, Johnson County, Texas",7252,775,5449,581,1803,564
1400000US48251130500,48251130500,"Census Tract 1305, Johnson County, Texas",6907,518,6257,535,650,210
1400000US48251130601,48251130601,"Census Tract 1306.01, Johnson County, Texas",6589,401,6223,431,366,250
1400000US48251130602,48251130602,"Census Tract 1306.02, Johnson County, Texas",1822,325,1552,301,270,205
1400000US48251130700,48251130700,"Census Tract 1307, Johnson County, Texas",4322,335,3188,264,1134,275
1400000US48251130800,48251130800,"Census Tract 1308, Johnson County, Texas",4253,536,2669,439,1584,430
1400000US48251130900,48251130900,"Census Tract 1309, Johnson County, Texas",3118,384,2028,387,1090,434
1400000US48251131000,48251131000,"Census Tract 1310, Johnson County, Texas",4967,354,4568,398,399,220
1400000US48251131100,48251131100,"Census Tract 1311, Johnson County, Texas",5088,491,3840,528,1248,565
1400000US48253020101,48253020101,"Census Tract 201.01, Jones County, Texas",1435,284,1272,254,163,101
1400000US48253020102,48253020102,"Census Tract 201.02, Jones County, Texas",6168,1331,4072,1048,2096,352
1400000US48253020200,48253020200,"Census Tract 202, Jones County, Texas",2703,480,1598,318,1105,320
1400000US48253020300,48253020300,"Census Tract 203, Jones County, Texas",2210,363,1712,282,498,199
1400000US48253020400,48253020400,"Census Tract 204, Jones County, Texas",3403,156,2665,273,738,280
1400000US48253020500,48253020500,"Census Tract 205, Jones County, Texas",4218,624,3762,538,456,305
1400000US48255970100,48255970100,"Census Tract 9701, Karnes County, Texas",2421,265,2166,247,255,127
1400000US48255970200,48255970200,"Census Tract 9702, Karnes County, Texas",3850,183,1385,190,2465,185
1400000US48255970300,48255970300,"Census Tract 9703, Karnes County, Texas",7381,318,3396,255,3985,221
1400000US48255970400,48255970400,"Census Tract 9704, Karnes County, Texas",1284,219,523,140,761,152
1400000US48257050201,48257050201,"Census Tract 502.01, Kaufman County, Texas",5939,317,5075,361,864,191
1400000US48257050203,48257050203,"Census Tract 502.03, Kaufman County, Texas",7422,490,6818,508,604,244
1400000US48257050204,48257050204,"Census Tract 502.04, Kaufman County, Texas",5427,466,3787,608,1640,534
1400000US48257050205,48257050205,"Census Tract 502.05, Kaufman County, Texas",5474,444,4768,454,706,231
1400000US48257050206,48257050206,"Census Tract 502.06, Kaufman County, Texas",9267,536,7829,625,1438,338
1400000US48257050300,48257050300,"Census Tract 503, Kaufman County, Texas",3656,413,2425,427,1231,554
1400000US48257050400,48257050400,"Census Tract 504, Kaufman County, Texas",7631,494,4458,519,3173,569
1400000US48257050500,48257050500,"Census Tract 505, Kaufman County, Texas",4921,468,4041,449,880,386
1400000US48257050600,48257050600,"Census Tract 506, Kaufman County, Texas",6652,901,6117,844,535,298
1400000US48257050701,48257050701,"Census Tract 507.01, Kaufman County, Texas",4788,511,3940,450,848,237
1400000US48257050703,48257050703,"Census Tract 507.03, Kaufman County, Texas",3248,499,2741,478,507,217
1400000US48257050704,48257050704,"Census Tract 507.04, Kaufman County, Texas",5831,652,4891,484,940,405
1400000US48257050800,48257050800,"Census Tract 508, Kaufman County, Texas",9387,609,8867,578,520,154
1400000US48257051000,48257051000,"Census Tract 510, Kaufman County, Texas",1713,320,891,253,822,269
1400000US48257051100,48257051100,"Census Tract 511, Kaufman County, Texas",4551,383,2949,362,1602,321
1400000US48257051201,48257051201,"Census Tract 512.01, Kaufman County, Texas",3037,634,2647,609,390,208
1400000US48257051202,48257051202,"Census Tract 512.02, Kaufman County, Texas",4931,320,4585,324,346,136
1400000US48257051300,48257051300,"Census Tract 513, Kaufman County, Texas",9510,780,8788,696,722,233
1400000US48259970100,48259970100,"Census Tract 9701, Kendall County, Texas",6098,723,4214,583,1884,624
1400000US48259970301,48259970301,"Census Tract 9703.01, Kendall County, Texas",5205,704,4348,638,857,419
1400000US48259970302,48259970302,"Census Tract 9703.02, Kendall County, Texas",4301,513,3717,393,584,346
1400000US48259970401,48259970401,"Census Tract 9704.01, Kendall County, Texas",6817,498,5199,492,1618,519
1400000US48259970402,48259970402,"Census Tract 9704.02, Kendall County, Texas",6186,483,5472,456,714,228
1400000US48259970500,48259970500,"Census Tract 9705, Kendall County, Texas",5138,356,3833,409,1305,351
1400000US48261950100,48261950100,"Census Tract 9501, Kenedy County, Texas",451,199,114,62,337,179
1400000US48261990000,48261990000,"Census Tract 9900, Kenedy County, Texas",0,13,0,13,0,13
1400000US48263950100,48263950100,"Census Tract 9501, Kent County, Texas",829,96,764,102,65,44
1400000US48265960100,48265960100,"Census Tract 9601, Kerr County, Texas",5718,673,4678,657,1040,444
1400000US48265960200,48265960200,"Census Tract 9602, Kerr County, Texas",3507,339,3117,293,390,221
1400000US48265960301,48265960301,"Census Tract 9603.01, Kerr County, Texas",4438,530,3182,384,1256,541
1400000US48265960302,48265960302,"Census Tract 9603.02, Kerr County, Texas",7494,566,6566,573,928,243
1400000US48265960401,48265960401,"Census Tract 9604.01, Kerr County, Texas",2166,272,1305,234,861,269
1400000US48265960402,48265960402,"Census Tract 9604.02, Kerr County, Texas",5845,566,4684,427,1161,430
1400000US48265960500,48265960500,"Census Tract 9605, Kerr County, Texas",5004,411,2767,327,2237,326
1400000US48265960600,48265960600,"Census Tract 9606, Kerr County, Texas",7496,464,4609,490,2887,396
1400000US48265960700,48265960700,"Census Tract 9607, Kerr County, Texas",4683,345,4267,333,416,181
1400000US48265960800,48265960800,"Census Tract 9608, Kerr County, Texas",3118,456,2372,411,746,233
1400000US48267950100,48267950100,"Census Tract 9501, Kimble County, Texas",1971,231,1637,195,334,116
1400000US48267950200,48267950200,"Census Tract 9502, Kimble County, Texas",2606,231,1741,212,865,190
1400000US48269950100,48269950100,"Census Tract 9501, King County, Texas",227,65,207,57,20,22
1400000US48271950100,48271950100,"Census Tract 9501, Kinney County, Texas",3574,,1517,176,2057,176
1400000US48273020100,48273020100,"Census Tract 201, Kleberg County, Texas",5604,152,2449,328,3155,340
1400000US48273020200,48273020200,"Census Tract 202, Kleberg County, Texas",5596,553,807,276,4789,592
1400000US48273020300,48273020300,"Census Tract 203, Kleberg County, Texas",7267,586,2348,302,4919,592
1400000US48273020400,48273020400,"Census Tract 204, Kleberg County, Texas",6658,622,1887,393,4771,625
1400000US48273020500,48273020500,"Census Tract 205, Kleberg County, Texas",6800,609,2057,366,4743,539
1400000US48273990000,48273990000,"Census Tract 9900, Kleberg County, Texas",0,13,0,13,0,13
1400000US48275950100,48275950100,"Census Tract 9501, Knox County, Texas",1899,128,1409,113,490,83
1400000US48275950200,48275950200,"Census Tract 9502, Knox County, Texas",1814,128,1187,113,627,83
1400000US48277000101,48277000101,"Census Tract 1.01, Lamar County, Texas",4950,440,4381,402,569,336
1400000US48277000102,48277000102,"Census Tract 1.02, Lamar County, Texas",4418,480,4297,462,121,90
1400000US48277000200,48277000200,"Census Tract 2, Lamar County, Texas",3229,300,3050,317,179,119
1400000US48277000300,48277000300,"Census Tract 3, Lamar County, Texas",5856,437,5412,454,444,222
1400000US48277000401,48277000401,"Census Tract 4.01, Lamar County, Texas",3652,369,3483,373,169,149
1400000US48277000402,48277000402,"Census Tract 4.02, Lamar County, Texas",6442,490,5882,461,560,183
1400000US48277000500,48277000500,"Census Tract 5, Lamar County, Texas",3738,411,3454,395,284,164
1400000US48277000600,48277000600,"Census Tract 6, Lamar County, Texas",2392,405,2392,405,0,13
1400000US48277000700,48277000700,"Census Tract 7, Lamar County, Texas",3313,349,3106,366,207,149
1400000US48277000800,48277000800,"Census Tract 8, Lamar County, Texas",3866,393,3616,394,250,99
1400000US48277000900,48277000900,"Census Tract 9, Lamar County, Texas",4350,410,4278,439,72,78
1400000US48277001000,48277001000,"Census Tract 10, Lamar County, Texas",3534,375,3177,403,357,184
1400000US48279950100,48279950100,"Census Tract 9501, Lamb County, Texas",2713,240,941,159,1772,227
1400000US48279950200,48279950200,"Census Tract 9502, Lamb County, Texas",1642,244,754,122,888,233
1400000US48279950300,48279950300,"Census Tract 9503, Lamb County, Texas",2330,264,1274,210,1056,198
1400000US48279950500,48279950500,"Census Tract 9505, Lamb County, Texas",3644,326,1223,197,2421,276
1400000US48279950600,48279950600,"Census Tract 9506, Lamb County, Texas",3667,270,2523,254,1144,263
1400000US48281950100,48281950100,"Census Tract 9501, Lampasas County, Texas",2678,340,2333,284,345,201
1400000US48281950301,48281950301,"Census Tract 9503.01, Lampasas County, Texas",6278,482,5653,497,625,247
1400000US48281950302,48281950302,"Census Tract 9503.02, Lampasas County, Texas",3627,439,3197,424,430,277
1400000US48281950400,48281950400,"Census Tract 9504, Lampasas County, Texas",3625,374,2419,360,1206,292
1400000US48281950500,48281950500,"Census Tract 9505, Lampasas County, Texas",3629,305,2757,324,872,302
1400000US48283950300,48283950300,"Census Tract 9503, La Salle County, Texas",6850,199,1107,201,5743,243
1400000US48285000100,48285000100,"Census Tract 1, Lavaca County, Texas",3363,341,3258,357,105,71
1400000US48285000200,48285000200,"Census Tract 2, Lavaca County, Texas",3848,303,3447,280,401,154
1400000US48285000300,48285000300,"Census Tract 3, Lavaca County, Texas",2420,266,2044,252,376,179
1400000US48285000400,48285000400,"Census Tract 4, Lavaca County, Texas",3635,326,3343,317,292,170
1400000US48285000500,48285000500,"Census Tract 5, Lavaca County, Texas",3105,269,2546,297,559,265
1400000US48285000600,48285000600,"Census Tract 6, Lavaca County, Texas",2898,251,1507,215,1391,292
1400000US48287000100,48287000100,"Census Tract 1, Lee County, Texas",5285,391,4836,362,449,241
1400000US48287000200,48287000200,"Census Tract 2, Lee County, Texas",2744,326,2418,298,326,185
1400000US48287000300,48287000300,"Census Tract 3, Lee County, Texas",3001,345,2644,298,357,264
1400000US48287000400,48287000400,"Census Tract 4, Lee County, Texas",5561,219,3003,309,2558,246
1400000US48289950100,48289950100,"Census Tract 9501, Leon County, Texas",7323,517,5944,436,1379,278
1400000US48289950200,48289950200,"Census Tract 9502, Leon County, Texas",4753,520,4390,475,363,199
1400000US48289950300,48289950300,"Census Tract 9503, Leon County, Texas",4751,540,4251,466,500,269
1400000US48291700100,48291700100,"Census Tract 7001, Liberty County, Texas",5112,593,3501,477,1611,412
1400000US48291700200,48291700200,"Census Tract 7002, Liberty County, Texas",2948,302,2611,359,337,223
1400000US48291700300,48291700300,"Census Tract 7003, Liberty County, Texas",9564,1067,6842,829,2722,668
1400000US48291700400,48291700400,"Census Tract 7004, Liberty County, Texas",6721,624,6490,613,231,118
1400000US48291700500,48291700500,"Census Tract 7005, Liberty County, Texas",2256,316,2152,323,104,95
1400000US48291700600,48291700600,"Census Tract 7006, Liberty County, Texas",2865,506,2588,488,277,282
1400000US48291700700,48291700700,"Census Tract 7007, Liberty County, Texas",2571,517,2195,408,376,404
1400000US48291700800,48291700800,"Census Tract 7008, Liberty County, Texas",8680,672,7841,689,839,326
1400000US48291700900,48291700900,"Census Tract 7009, Liberty County, Texas",6266,1516,4350,844,1916,738
1400000US48291701000,48291701000,"Census Tract 7010, Liberty County, Texas",6150,617,4111,461,2039,494
1400000US48291701100,48291701100,"Census Tract 7011, Liberty County, Texas",5900,557,5659,506,241,171
1400000US48291701200,48291701200,"Census Tract 7012, Liberty County, Texas",5585,544,4265,571,1320,445
1400000US48291701300,48291701300,"Census Tract 7013, Liberty County, Texas",3050,437,2982,443,68,58
1400000US48291701400,48291701400,"Census Tract 7014, Liberty County, Texas",7994,702,6425,719,1569,446
1400000US48293970100,48293970100,"Census Tract 9701, Limestone County, Texas",1868,224,1558,219,310,110
1400000US48293970200,48293970200,"Census Tract 9702, Limestone County, Texas",4455,519,3947,471,508,226
1400000US48293970300,48293970300,"Census Tract 9703, Limestone County, Texas",2349,353,1793,312,556,255
1400000US48293970400,48293970400,"Census Tract 9704, Limestone County, Texas",1562,349,1039,319,523,228
1400000US48293970500,48293970500,"Census Tract 9705, Limestone County, Texas",2581,373,1792,390,789,213
1400000US48293970600,48293970600,"Census Tract 9706, Limestone County, Texas",6045,353,4434,403,1611,321
1400000US48293970700,48293970700,"Census Tract 9707, Limestone County, Texas",1593,309,1540,308,53,47
1400000US48293970800,48293970800,"Census Tract 9708, Limestone County, Texas",2897,393,2799,399,98,55
1400000US48295950200,48295950200,"Census Tract 9502, Lipscomb County, Texas",2042,109,1261,121,781,145
1400000US48295950300,48295950300,"Census Tract 9503, Lipscomb County, Texas",1282,109,1117,114,165,78
1400000US48297950100,48297950100,"Census Tract 9501, Live Oak County, Texas",4725,353,2733,285,1992,276
1400000US48297950200,48297950200,"Census Tract 9502, Live Oak County, Texas",2047,277,857,144,1190,241
1400000US48297950300,48297950300,"Census Tract 9503, Live Oak County, Texas",2625,305,1932,268,693,214
1400000US48297950400,48297950400,"Census Tract 9504, Live Oak County, Texas",2129,268,1867,282,262,164
1400000US48299970100,48299970100,"Census Tract 9701, Llano County, Texas",2481,398,2308,399,173,124
1400000US48299970200,48299970200,"Census Tract 9702, Llano County, Texas",3600,201,3127,260,473,221
1400000US48299970300,48299970300,"Census Tract 9703, Llano County, Texas",2046,307,1975,308,71,45
1400000US48299970400,48299970400,"Census Tract 9704, Llano County, Texas",3594,900,3480,831,114,126
1400000US48299970500,48299970500,"Census Tract 9705, Llano County, Texas",5834,645,5121,621,713,241
1400000US48299970600,48299970600,"Census Tract 9706, Llano County, Texas",1560,322,1531,327,29,53
1400000US48301950100,48301950100,"Census Tract 9501, Loving County, Texas",85,53,53,24,32,43
1400000US48303000100,48303000100,"Census Tract 1, Lubbock County, Texas",2653,327,966,164,1687,286
1400000US48303000201,48303000201,"Census Tract 2.01, Lubbock County, Texas",2059,295,1077,268,982,340
1400000US48303000202,48303000202,"Census Tract 2.02, Lubbock County, Texas",2059,256,276,123,1783,289
1400000US48303000301,48303000301,"Census Tract 3.01, Lubbock County, Texas",3649,363,2122,362,1527,235
1400000US48303000302,48303000302,"Census Tract 3.02, Lubbock County, Texas",7076,509,1446,330,5630,583
1400000US48303000402,48303000402,"Census Tract 4.02, Lubbock County, Texas",4617,488,3308,471,1309,301
1400000US48303000403,48303000403,"Census Tract 4.03, Lubbock County, Texas",3727,273,3037,310,690,206
1400000US48303000404,48303000404,"Census Tract 4.04, Lubbock County, Texas",7534,535,5347,489,2187,435
1400000US48303000405,48303000405,"Census Tract 4.05, Lubbock County, Texas",10979,943,7230,918,3749,877
1400000US48303000500,48303000500,"Census Tract 5, Lubbock County, Texas",8412,898,7079,852,1333,250
1400000US48303000603,48303000603,"Census Tract 6.03, Lubbock County, Texas",2278,448,2020,361,258,152
1400000US48303000605,48303000605,"Census Tract 6.05, Lubbock County, Texas",767,235,609,217,158,119
1400000US48303000607,48303000607,"Census Tract 6.07, Lubbock County, Texas",2057,357,1603,344,454,104
1400000US48303000700,48303000700,"Census Tract 7, Lubbock County, Texas",1340,176,251,119,1089,161
1400000US48303000900,48303000900,"Census Tract 9, Lubbock County, Texas",4362,527,2706,458,1656,460
1400000US48303001000,48303001000,"Census Tract 10, Lubbock County, Texas",2887,381,1584,361,1303,174
1400000US48303001200,48303001200,"Census Tract 12, Lubbock County, Texas",2324,411,1791,367,533,132
1400000US48303001300,48303001300,"Census Tract 13, Lubbock County, Texas",3668,456,776,217,2892,500
1400000US48303001400,48303001400,"Census Tract 14, Lubbock County, Texas",5070,801,2670,523,2400,630
1400000US48303001501,48303001501,"Census Tract 15.01, Lubbock County, Texas",1992,276,1724,308,268,162
1400000US48303001502,48303001502,"Census Tract 15.02, Lubbock County, Texas",2205,439,1901,425,304,157
1400000US48303001601,48303001601,"Census Tract 16.01, Lubbock County, Texas",2579,426,2043,435,536,200
1400000US48303001602,48303001602,"Census Tract 16.02, Lubbock County, Texas",3510,350,2442,362,1068,287
1400000US48303001702,48303001702,"Census Tract 17.02, Lubbock County, Texas",5516,457,4279,341,1237,440
1400000US48303001705,48303001705,"Census Tract 17.05, Lubbock County, Texas",6470,370,5937,397,533,254
1400000US48303001706,48303001706,"Census Tract 17.06, Lubbock County, Texas",5014,553,3275,497,1739,430
1400000US48303001707,48303001707,"Census Tract 17.07, Lubbock County, Texas",3805,213,3311,228,494,183
1400000US48303001708,48303001708,"Census Tract 17.08, Lubbock County, Texas",2878,381,1508,348,1370,499
1400000US48303001709,48303001709,"Census Tract 17.09, Lubbock County, Texas",4594,532,2770,382,1824,484
1400000US48303001801,48303001801,"Census Tract 18.01, Lubbock County, Texas",5543,461,3775,494,1768,333
1400000US48303001803,48303001803,"Census Tract 18.03, Lubbock County, Texas",5594,453,3952,399,1642,340
1400000US48303001804,48303001804,"Census Tract 18.04, Lubbock County, Texas",4149,224,3520,273,629,185
1400000US48303001901,48303001901,"Census Tract 19.01, Lubbock County, Texas",4469,536,3160,455,1309,375
1400000US48303001903,48303001903,"Census Tract 19.03, Lubbock County, Texas",5156,398,4631,354,525,180
1400000US48303001904,48303001904,"Census Tract 19.04, Lubbock County, Texas",1464,108,1192,145,272,141
1400000US48303002001,48303002001,"Census Tract 20.01, Lubbock County, Texas",1856,190,1344,204,512,180
1400000US48303002002,48303002002,"Census Tract 20.02, Lubbock County, Texas",2759,377,1513,240,1246,255
1400000US48303002101,48303002101,"Census Tract 21.01, Lubbock County, Texas",5568,489,4178,570,1390,548
1400000US48303002102,48303002102,"Census Tract 21.02, Lubbock County, Texas",2712,228,1904,264,808,266
1400000US48303002202,48303002202,"Census Tract 22.02, Lubbock County, Texas",5138,335,2792,304,2346,347
1400000US48303002203,48303002203,"Census Tract 22.03, Lubbock County, Texas",3121,407,2114,251,1007,335
1400000US48303002204,48303002204,"Census Tract 22.04, Lubbock County, Texas",4857,530,1919,346,2938,460
1400000US48303002300,48303002300,"Census Tract 23, Lubbock County, Texas",4479,505,1717,401,2762,498
1400000US48303002400,48303002400,"Census Tract 24, Lubbock County, Texas",6432,567,1588,418,4844,585
1400000US48303002500,48303002500,"Census Tract 25, Lubbock County, Texas",2374,252,863,127,1511,260
1400000US48303010101,48303010101,"Census Tract 101.01, Lubbock County, Texas",1652,300,1482,302,170,98
1400000US48303010102,48303010102,"Census Tract 101.02, Lubbock County, Texas",2804,281,1632,240,1172,213
1400000US48303010200,48303010200,"Census Tract 102, Lubbock County, Texas",8484,953,4699,664,3785,763
1400000US48303010301,48303010301,"Census Tract 103.01, Lubbock County, Texas",3632,431,3025,421,607,261
1400000US48303010302,48303010302,"Census Tract 103.02, Lubbock County, Texas",2702,211,1914,243,788,190
1400000US48303010402,48303010402,"Census Tract 104.02, Lubbock County, Texas",1844,268,1176,196,668,213
1400000US48303010403,48303010403,"Census Tract 104.03, Lubbock County, Texas",5706,466,4744,548,962,284
1400000US48303010404,48303010404,"Census Tract 104.04, Lubbock County, Texas",2830,378,2090,313,740,359
1400000US48303010405,48303010405,"Census Tract 104.05, Lubbock County, Texas",3783,468,2817,422,966,303
1400000US48303010406,48303010406,"Census Tract 104.06, Lubbock County, Texas",4443,480,3921,557,522,303
1400000US48303010407,48303010407,"Census Tract 104.07, Lubbock County, Texas",7363,750,6571,766,792,295
1400000US48303010408,48303010408,"Census Tract 104.08, Lubbock County, Texas",8824,784,7332,774,1492,344
1400000US48303010502,48303010502,"Census Tract 105.02, Lubbock County, Texas",3076,253,2990,262,86,60
1400000US48303010504,48303010504,"Census Tract 105.04, Lubbock County, Texas",4058,232,3683,249,375,152
1400000US48303010505,48303010505,"Census Tract 105.05, Lubbock County, Texas",4363,425,3327,354,1036,356
1400000US48303010506,48303010506,"Census Tract 105.06, Lubbock County, Texas",4266,241,3354,259,912,271
1400000US48303010508,48303010508,"Census Tract 105.08, Lubbock County, Texas",8034,776,5651,624,2383,574
1400000US48303010509,48303010509,"Census Tract 105.09, Lubbock County, Texas",2570,265,2334,334,236,200
1400000US48303010510,48303010510,"Census Tract 105.10, Lubbock County, Texas",2389,385,2209,397,180,147
1400000US48303010511,48303010511,"Census Tract 105.11, Lubbock County, Texas",3599,310,2757,280,842,243
1400000US48303010600,48303010600,"Census Tract 106, Lubbock County, Texas",6036,76,3120,585,2916,590
1400000US48303010700,48303010700,"Census Tract 107, Lubbock County, Texas",4129,411,3141,424,988,386
1400000US48303980000,48303980000,"Census Tract 9800, Lubbock County, Texas",0,13,0,13,0,13
1400000US48305950400,48305950400,"Census Tract 9504, Lynn County, Texas",1891,154,1091,121,800,126
1400000US48305950500,48305950500,"Census Tract 9505, Lynn County, Texas",2686,68,1351,111,1335,108
1400000US48305950600,48305950600,"Census Tract 9506, Lynn County, Texas",1309,144,709,115,600,128
1400000US48307950300,48307950300,"Census Tract 9503, McCulloch County, Texas",5468,196,3417,236,2051,197
1400000US48307950400,48307950400,"Census Tract 9504, McCulloch County, Texas",1616,243,1311,255,305,160
1400000US48307950500,48307950500,"Census Tract 9505, McCulloch County, Texas",1197,196,1051,197,146,78
1400000US48309000100,48309000100,"Census Tract 1, McLennan County, Texas",1931,339,1299,264,632,243
1400000US48309000200,48309000200,"Census Tract 2, McLennan County, Texas",2998,369,2536,341,462,144
1400000US48309000300,48309000300,"Census Tract 3, McLennan County, Texas",4445,415,4010,359,435,182
1400000US48309000400,48309000400,"Census Tract 4, McLennan County, Texas",5773,661,3966,585,1807,395
1400000US48309000598,48309000598,"Census Tract 5.98, McLennan County, Texas",5760,514,885,257,4875,468
1400000US48309000700,48309000700,"Census Tract 7, McLennan County, Texas",2814,324,1359,248,1455,250
1400000US48309000800,48309000800,"Census Tract 8, McLennan County, Texas",2930,440,1340,298,1590,325
1400000US48309000900,48309000900,"Census Tract 9, McLennan County, Texas",5089,556,2510,540,2579,570
1400000US48309001000,48309001000,"Census Tract 10, McLennan County, Texas",2691,343,1110,240,1581,401
1400000US48309001100,48309001100,"Census Tract 11, McLennan County, Texas",6114,541,2782,484,3332,431
1400000US48309001200,48309001200,"Census Tract 12, McLennan County, Texas",3325,394,2051,324,1274,313
1400000US48309001300,48309001300,"Census Tract 13, McLennan County, Texas",2218,280,1204,223,1014,276
1400000US48309001400,48309001400,"Census Tract 14, McLennan County, Texas",7930,704,7063,616,867,383
1400000US48309001500,48309001500,"Census Tract 15, McLennan County, Texas",2415,309,2073,283,342,160
1400000US48309001600,48309001600,"Census Tract 16, McLennan County, Texas",5740,563,3356,459,2384,568
1400000US48309001700,48309001700,"Census Tract 17, McLennan County, Texas",5377,453,3881,397,1496,305
1400000US48309001800,48309001800,"Census Tract 18, McLennan County, Texas",2125,340,1605,271,520,252
1400000US48309001900,48309001900,"Census Tract 19, McLennan County, Texas",4404,538,3672,519,732,233
1400000US48309002000,48309002000,"Census Tract 20, McLennan County, Texas",3273,249,2796,222,477,175
1400000US48309002100,48309002100,"Census Tract 21, McLennan County, Texas",4822,582,3069,456,1753,455
1400000US48309002302,48309002302,"Census Tract 23.02, McLennan County, Texas",5419,465,3928,465,1491,408
1400000US48309002498,48309002498,"Census Tract 24.98, McLennan County, Texas",4641,416,3104,387,1537,419
1400000US48309002501,48309002501,"Census Tract 25.01, McLennan County, Texas",4707,420,3414,391,1293,386
1400000US48309002503,48309002503,"Census Tract 25.03, McLennan County, Texas",5849,437,5322,428,527,288
1400000US48309002504,48309002504,"Census Tract 25.04, McLennan County, Texas",3417,226,3057,264,360,206
1400000US48309002600,48309002600,"Census Tract 26, McLennan County, Texas",5247,295,4795,325,452,146
1400000US48309002700,48309002700,"Census Tract 27, McLennan County, Texas",4078,390,2165,289,1913,384
1400000US48309002800,48309002800,"Census Tract 28, McLennan County, Texas",3683,307,3290,334,393,193
1400000US48309002900,48309002900,"Census Tract 29, McLennan County, Texas",3567,216,3256,239,311,111
1400000US48309003000,48309003000,"Census Tract 30, McLennan County, Texas",4210,367,3082,423,1128,411
1400000US48309003200,48309003200,"Census Tract 32, McLennan County, Texas",5033,470,3860,337,1173,450
1400000US48309003300,48309003300,"Census Tract 33, McLennan County, Texas",1511,271,1309,265,202,103
1400000US48309003400,48309003400,"Census Tract 34, McLennan County, Texas",6392,670,5977,631,415,312
1400000US48309003500,48309003500,"Census Tract 35, McLennan County, Texas",4006,302,3752,313,254,125
1400000US48309003601,48309003601,"Census Tract 36.01, McLennan County, Texas",3244,490,2610,355,634,285
1400000US48309003602,48309003602,"Census Tract 36.02, McLennan County, Texas",2282,201,2038,232,244,88
1400000US48309003701,48309003701,"Census Tract 37.01, McLennan County, Texas",3091,332,2574,335,517,179
1400000US48309003703,48309003703,"Census Tract 37.03, McLennan County, Texas",5361,344,4831,317,530,142
1400000US48309003706,48309003706,"Census Tract 37.06, McLennan County, Texas",9099,522,7834,552,1265,374
1400000US48309003707,48309003707,"Census Tract 37.07, McLennan County, Texas",8503,619,7138,601,1365,388
1400000US48309003708,48309003708,"Census Tract 37.08, McLennan County, Texas",6762,517,5868,469,894,218
1400000US48309003801,48309003801,"Census Tract 38.01, McLennan County, Texas",7131,477,6625,495,506,162
1400000US48309003802,48309003802,"Census Tract 38.02, McLennan County, Texas",5908,372,5140,356,768,282
1400000US48309003900,48309003900,"Census Tract 39, McLennan County, Texas",8253,446,6761,459,1492,350
1400000US48309004000,48309004000,"Census Tract 40, McLennan County, Texas",4856,289,4626,280,230,115
1400000US48309004102,48309004102,"Census Tract 41.02, McLennan County, Texas",5256,336,4872,355,384,171
1400000US48309004103,48309004103,"Census Tract 41.03, McLennan County, Texas",7154,398,6270,401,884,306
1400000US48309004201,48309004201,"Census Tract 42.01, McLennan County, Texas",3832,375,3340,390,492,174
1400000US48309004202,48309004202,"Census Tract 42.02, McLennan County, Texas",3251,308,2899,264,352,171
1400000US48309004300,48309004300,"Census Tract 43, McLennan County, Texas",6709,487,2952,330,3757,418
1400000US48309980000,48309980000,"Census Tract 9800, McLennan County, Texas",0,13,0,13,0,13
1400000US48311950100,48311950100,"Census Tract 9501, McMullen County, Texas",696,133,405,106,291,100
1400000US48313000100,48313000100,"Census Tract 1, Madison County, Texas",4262,1148,3098,497,1164,710
1400000US48313000200,48313000200,"Census Tract 2, Madison County, Texas",1595,541,1314,379,281,230
1400000US48313000300,48313000300,"Census Tract 3, Madison County, Texas",2778,689,2686,607,92,130
1400000US48313000400,48313000400,"Census Tract 4, Madison County, Texas",4955,271,3771,384,1184,463
1400000US48315950100,48315950100,"Census Tract 9501, Marion County, Texas",2236,379,2185,372,51,51
1400000US48315950200,48315950200,"Census Tract 9502, Marion County, Texas",3434,344,3350,338,84,91
1400000US48315950300,48315950300,"Census Tract 9503, Marion County, Texas",2911,321,2754,325,157,81
1400000US48315950400,48315950400,"Census Tract 9504, Marion County, Texas",1963,230,1917,229,46,44
1400000US48317950100,48317950100,"Census Tract 9501, Martin County, Texas",1218,221,832,145,386,198
1400000US48317950200,48317950200,"Census Tract 9502, Martin County, Texas",3586,221,1817,189,1769,188
1400000US48319950100,48319950100,"Census Tract 9501, Mason County, Texas",2112,232,1383,271,729,161
1400000US48319950200,48319950200,"Census Tract 9502, Mason County, Texas",1866,232,1747,233,119,77
1400000US48321730100,48321730100,"Census Tract 7301, Matagorda County, Texas",2553,375,1322,229,1231,296
1400000US48321730201,48321730201,"Census Tract 7302.01, Matagorda County, Texas",7391,800,4315,619,3076,658
1400000US48321730202,48321730202,"Census Tract 7302.02, Matagorda County, Texas",1826,467,1550,501,276,239
1400000US48321730301,48321730301,"Census Tract 7303.01, Matagorda County, Texas",4148,492,2271,324,1877,563
1400000US48321730302,48321730302,"Census Tract 7303.02, Matagorda County, Texas",4214,519,2508,404,1706,457
1400000US48321730303,48321730303,"Census Tract 7303.03, Matagorda County, Texas",746,177,507,159,239,190
1400000US48321730400,48321730400,"Census Tract 7304, Matagorda County, Texas",2957,421,2078,384,879,327
1400000US48321730501,48321730501,"Census Tract 7305.01, Matagorda County, Texas",3570,542,3181,495,389,208
1400000US48321730600,48321730600,"Census Tract 7306, Matagorda County, Texas",5384,299,2403,327,2981,394
1400000US48321730700,48321730700,"Census Tract 7307, Matagorda County, Texas",3864,519,2463,431,1401,428
1400000US48321990000,48321990000,"Census Tract 9900, Matagorda County, Texas",0,13,0,13,0,13
1400000US48323950201,48323950201,"Census Tract 9502.01, Maverick County, Texas",6517,855,575,103,5942,861
1400000US48323950204,48323950204,"Census Tract 9502.04, Maverick County, Texas",4305,595,117,123,4188,644
1400000US48323950205,48323950205,"Census Tract 9502.05, Maverick County, Texas",8698,979,58,81,8640,967
1400000US48323950300,48323950300,"Census Tract 9503, Maverick County, Texas",7427,536,573,162,6854,566
1400000US48323950400,48323950400,"Census Tract 9504, Maverick County, Texas",3611,354,132,92,3479,364
1400000US48323950500,48323950500,"Census Tract 9505, Maverick County, Texas",6129,610,228,112,5901,612
1400000US48323950601,48323950601,"Census Tract 9506.01, Maverick County, Texas",2791,428,127,88,2664,427
1400000US48323950602,48323950602,"Census Tract 9506.02, Maverick County, Texas",5737,562,1,3,5736,562
1400000US48323950700,48323950700,"Census Tract 9507, Maverick County, Texas",8892,757,604,241,8288,793
1400000US48325000101,48325000101,"Census Tract 1.01, Medina County, Texas",6467,584,3598,386,2869,529
1400000US48325000102,48325000102,"Census Tract 1.02, Medina County, Texas",7744,737,4956,604,2788,641
1400000US48325000200,48325000200,"Census Tract 2, Medina County, Texas",1763,277,1130,180,633,259
1400000US48325000300,48325000300,"Census Tract 3, Medina County, Texas",8678,612,4571,487,4107,539
1400000US48325000401,48325000401,"Census Tract 4.01, Medina County, Texas",5089,626,1435,320,3654,588
1400000US48325000402,48325000402,"Census Tract 4.02, Medina County, Texas",4378,627,2102,347,2276,533
1400000US48325000500,48325000500,"Census Tract 5, Medina County, Texas",4854,637,1950,345,2904,595
1400000US48325000800,48325000800,"Census Tract 8, Medina County, Texas",7036,551,3326,482,3710,552
1400000US48327950300,48327950300,"Census Tract 9503, Menard County, Texas",2232,,1565,158,667,158
1400000US48329000100,48329000100,"Census Tract 1, Midland County, Texas",5489,467,2964,414,2525,379
1400000US48329000200,48329000200,"Census Tract 2, Midland County, Texas",4736,434,3411,416,1325,384
1400000US48329000302,48329000302,"Census Tract 3.02, Midland County, Texas",4955,423,3840,450,1115,345
1400000US48329000303,48329000303,"Census Tract 3.03, Midland County, Texas",4359,239,3754,276,605,179
1400000US48329000304,48329000304,"Census Tract 3.04, Midland County, Texas",4084,328,3261,280,823,315
1400000US48329000305,48329000305,"Census Tract 3.05, Midland County, Texas",4686,452,4262,412,424,221
1400000US48329000401,48329000401,"Census Tract 4.01, Midland County, Texas",3068,353,1778,192,1290,339
1400000US48329000402,48329000402,"Census Tract 4.02, Midland County, Texas",4723,495,2843,358,1880,459
1400000US48329000500,48329000500,"Census Tract 5, Midland County, Texas",5156,440,3526,353,1630,501
1400000US48329000600,48329000600,"Census Tract 6, Midland County, Texas",4192,393,2898,383,1294,244
1400000US48329001100,48329001100,"Census Tract 11, Midland County, Texas",5818,508,2133,342,3685,524
1400000US48329001200,48329001200,"Census Tract 12, Midland County, Texas",7208,526,2782,373,4426,669
1400000US48329001300,48329001300,"Census Tract 13, Midland County, Texas",5659,426,2827,310,2832,417
1400000US48329001400,48329001400,"Census Tract 14, Midland County, Texas",4606,519,606,237,4000,524
1400000US48329001500,48329001500,"Census Tract 15, Midland County, Texas",4210,555,1274,292,2936,555
1400000US48329001700,48329001700,"Census Tract 17, Midland County, Texas",4088,379,969,216,3119,407
1400000US48329010104,48329010104,"Census Tract 101.04, Midland County, Texas",7267,597,5722,422,1545,465
1400000US48329010105,48329010105,"Census Tract 101.05, Midland County, Texas",3425,417,2432,295,993,381
1400000US48329010106,48329010106,"Census Tract 101.06, Midland County, Texas",5858,409,3903,498,1955,614
1400000US48329010107,48329010107,"Census Tract 101.07, Midland County, Texas",4622,479,3573,388,1049,527
1400000US48329010108,48329010108,"Census Tract 101.08, Midland County, Texas",3562,417,2960,249,602,383
1400000US48329010109,48329010109,"Census Tract 101.09, Midland County, Texas",7543,737,3635,716,3908,683
1400000US48329010112,48329010112,"Census Tract 101.12, Midland County, Texas",10895,832,8534,718,2361,533
1400000US48329010113,48329010113,"Census Tract 101.13, Midland County, Texas",9131,679,6773,694,2358,495
1400000US48329010114,48329010114,"Census Tract 101.14, Midland County, Texas",5987,636,4522,615,1465,430
1400000US48329010200,48329010200,"Census Tract 102, Midland County, Texas",3145,356,588,134,2557,324
1400000US48329980000,48329980000,"Census Tract 9800, Midland County, Texas",0,13,0,13,0,13
1400000US48331950100,48331950100,"Census Tract 9501, Milam County, Texas",2220,322,1722,308,498,205
1400000US48331950300,48331950300,"Census Tract 9503, Milam County, Texas",3657,523,2764,413,893,332
1400000US48331950401,48331950401,"Census Tract 9504.01, Milam County, Texas",3163,379,1982,397,1181,463
1400000US48331950402,48331950402,"Census Tract 9504.02, Milam County, Texas",3509,451,2600,371,909,312
1400000US48331950500,48331950500,"Census Tract 9505, Milam County, Texas",3054,306,2783,281,271,134
1400000US48331950700,48331950700,"Census Tract 9507, Milam County, Texas",5877,233,4298,355,1579,383
1400000US48331950800,48331950800,"Census Tract 9508, Milam County, Texas",3211,301,2735,298,476,185
1400000US48333950100,48333950100,"Census Tract 9501, Mills County, Texas",1769,197,1593,194,176,84
1400000US48333950200,48333950200,"Census Tract 9502, Mills County, Texas",3111,197,2457,229,654,143
1400000US48335950200,48335950200,"Census Tract 9502, Mitchell County, Texas",7343,324,4382,258,2961,164
1400000US48335950400,48335950400,"Census Tract 9504, Mitchell County, Texas",2024,324,1514,258,510,164
1400000US48337950100,48337950100,"Census Tract 9501, Montague County, Texas",2582,269,2454,260,128,67
1400000US48337950200,48337950200,"Census Tract 9502, Montague County, Texas",1639,216,1506,208,133,83
1400000US48337950300,48337950300,"Census Tract 9503, Montague County, Texas",2906,73,2405,170,501,149
1400000US48337950400,48337950400,"Census Tract 9504, Montague County, Texas",4807,315,4406,330,401,155
1400000US48337950500,48337950500,"Census Tract 9505, Montague County, Texas",5735,366,5063,349,672,211
1400000US48337950600,48337950600,"Census Tract 9506, Montague County, Texas",2068,214,1975,209,93,57
1400000US48339690100,48339690100,"Census Tract 6901, Montgomery County, Texas",10507,640,8561,753,1946,896
1400000US48339690201,48339690201,"Census Tract 6902.01, Montgomery County, Texas",9386,861,8414,826,972,424
1400000US48339690202,48339690202,"Census Tract 6902.02, Montgomery County, Texas",6906,709,5612,688,1294,567
1400000US48339690300,48339690300,"Census Tract 6903, Montgomery County, Texas",4576,449,3554,378,1022,415
1400000US48339690401,48339690401,"Census Tract 6904.01, Montgomery County, Texas",5628,433,4807,575,821,451
1400000US48339690402,48339690402,"Census Tract 6904.02, Montgomery County, Texas",16698,1183,12629,1002,4069,1001
1400000US48339690500,48339690500,"Census Tract 6905, Montgomery County, Texas",7373,575,6735,577,638,212
1400000US48339690601,48339690601,"Census Tract 6906.01, Montgomery County, Texas",20764,976,18198,972,2566,476
1400000US48339690602,48339690602,"Census Tract 6906.02, Montgomery County, Texas",18121,1001,14985,968,3136,673
1400000US48339690700,48339690700,"Census Tract 6907, Montgomery County, Texas",8760,876,7870,801,890,318
1400000US48339690800,48339690800,"Census Tract 6908, Montgomery County, Texas",4135,280,3914,251,221,122
1400000US48339690900,48339690900,"Census Tract 6909, Montgomery County, Texas",4547,224,4253,228,294,127
1400000US48339691000,48339691000,"Census Tract 6910, Montgomery County, Texas",4321,253,4086,305,235,122
1400000US48339691100,48339691100,"Census Tract 6911, Montgomery County, Texas",4494,249,3960,226,534,212
1400000US48339691200,48339691200,"Census Tract 6912, Montgomery County, Texas",7745,436,6881,447,864,227
1400000US48339691301,48339691301,"Census Tract 6913.01, Montgomery County, Texas",4908,506,4047,570,861,515
1400000US48339691302,48339691302,"Census Tract 6913.02, Montgomery County, Texas",5443,516,4629,551,814,203
1400000US48339691400,48339691400,"Census Tract 6914, Montgomery County, Texas",8444,583,7250,638,1194,446
1400000US48339691500,48339691500,"Census Tract 6915, Montgomery County, Texas",3790,410,2959,413,831,337
1400000US48339691601,48339691601,"Census Tract 6916.01, Montgomery County, Texas",4253,454,3620,454,633,377
1400000US48339691602,48339691602,"Census Tract 6916.02, Montgomery County, Texas",5354,615,3479,374,1875,619
1400000US48339691700,48339691700,"Census Tract 6917, Montgomery County, Texas",1282,275,1018,253,264,131
1400000US48339691800,48339691800,"Census Tract 6918, Montgomery County, Texas",7717,686,6459,660,1258,430
1400000US48339691900,48339691900,"Census Tract 6919, Montgomery County, Texas",6371,562,5022,536,1349,362
1400000US48339692001,48339692001,"Census Tract 6920.01, Montgomery County, Texas",26942,1319,22314,1371,4628,849
1400000US48339692002,48339692002,"Census Tract 6920.02, Montgomery County, Texas",6058,626,5218,610,840,225
1400000US48339692100,48339692100,"Census Tract 6921, Montgomery County, Texas",10488,664,8623,635,1865,403
1400000US48339692200,48339692200,"Census Tract 6922, Montgomery County, Texas",9161,905,6669,788,2492,888
1400000US48339692300,48339692300,"Census Tract 6923, Montgomery County, Texas",15580,980,11313,1059,4267,744
1400000US48339692400,48339692400,"Census Tract 6924, Montgomery County, Texas",8300,807,6590,738,1710,573
1400000US48339692500,48339692500,"Census Tract 6925, Montgomery County, Texas",9082,944,6748,725,2334,568
1400000US48339692601,48339692601,"Census Tract 6926.01, Montgomery County, Texas",3550,640,2746,530,804,500
1400000US48339692602,48339692602,"Census Tract 6926.02, Montgomery County, Texas",9828,972,7275,820,2553,723
1400000US48339692700,48339692700,"Census Tract 6927, Montgomery County, Texas",7272,548,6419,589,853,334
1400000US48339692801,48339692801,"Census Tract 6928.01, Montgomery County, Texas",8574,625,7322,557,1252,364
1400000US48339692802,48339692802,"Census Tract 6928.02, Montgomery County, Texas",3732,567,3000,610,732,232
1400000US48339692900,48339692900,"Census Tract 6929, Montgomery County, Texas",4321,611,3608,595,713,379
1400000US48339693000,48339693000,"Census Tract 6930, Montgomery County, Texas",10411,802,5642,753,4769,775
1400000US48339693101,48339693101,"Census Tract 6931.01, Montgomery County, Texas",5943,608,2348,362,3595,657
1400000US48339693102,48339693102,"Census Tract 6931.02, Montgomery County, Texas",4677,475,1803,393,2874,601
1400000US48339693200,48339693200,"Census Tract 6932, Montgomery County, Texas",7253,479,6433,458,820,273
1400000US48339693300,48339693300,"Census Tract 6933, Montgomery County, Texas",6249,551,4868,501,1381,433
1400000US48339693400,48339693400,"Census Tract 6934, Montgomery County, Texas",4561,637,1981,401,2580,616
1400000US48339693500,48339693500,"Census Tract 6935, Montgomery County, Texas",6110,520,4583,496,1527,501
1400000US48339693600,48339693600,"Census Tract 6936, Montgomery County, Texas",3190,395,2478,384,712,241
1400000US48339693700,48339693700,"Census Tract 6937, Montgomery County, Texas",7451,661,5954,852,1497,685
1400000US48339693800,48339693800,"Census Tract 6938, Montgomery County, Texas",3843,384,2112,331,1731,420
1400000US48339693900,48339693900,"Census Tract 6939, Montgomery County, Texas",11032,968,4031,385,7001,942
1400000US48339694000,48339694000,"Census Tract 6940, Montgomery County, Texas",9196,1091,7134,939,2062,728
1400000US48339694101,48339694101,"Census Tract 6941.01, Montgomery County, Texas",11136,1028,7714,807,3422,930
1400000US48339694102,48339694102,"Census Tract 6941.02, Montgomery County, Texas",5341,617,3554,571,1787,420
1400000US48339694201,48339694201,"Census Tract 6942.01, Montgomery County, Texas",6016,906,5456,886,560,235
1400000US48339694202,48339694202,"Census Tract 6942.02, Montgomery County, Texas",10052,793,9218,773,834,386
1400000US48339694301,48339694301,"Census Tract 6943.01, Montgomery County, Texas",11460,909,10346,855,1114,269
1400000US48339694302,48339694302,"Census Tract 6943.02, Montgomery County, Texas",7659,624,7048,668,611,283
1400000US48339694400,48339694400,"Census Tract 6944, Montgomery County, Texas",6731,631,5785,619,946,319
1400000US48339694500,48339694500,"Census Tract 6945, Montgomery County, Texas",5956,545,5485,543,471,156
1400000US48339694600,48339694600,"Census Tract 6946, Montgomery County, Texas",6365,841,5567,789,798,308
1400000US48339694700,48339694700,"Census Tract 6947, Montgomery County, Texas",3296,384,3079,381,217,180
1400000US48341950100,48341950100,"Census Tract 9501, Moore County, Texas",2342,302,1317,207,1025,230
1400000US48341950200,48341950200,"Census Tract 9502, Moore County, Texas",6360,400,3137,324,3223,410
1400000US48341950300,48341950300,"Census Tract 9503, Moore County, Texas",7574,422,3648,265,3926,468
1400000US48341950400,48341950400,"Census Tract 9504, Moore County, Texas",5489,358,2193,292,3296,384
1400000US48343950100,48343950100,"Census Tract 9501, Morris County, Texas",4714,407,4455,388,259,144
1400000US48343950200,48343950200,"Census Tract 9502, Morris County, Texas",5675,410,5279,387,396,185
1400000US48343950300,48343950300,"Census Tract 9503, Morris County, Texas",2525,55,2165,137,360,130
1400000US48345950100,48345950100,"Census Tract 9501, Motley County, Texas",1153,112,1015,105,138,70
1400000US48347950100,48347950100,"Census Tract 9501, Nacogdoches County, Texas",2392,310,2173,304,219,117
1400000US48347950200,48347950200,"Census Tract 9502, Nacogdoches County, Texas",4411,428,4185,406,226,165
1400000US48347950301,48347950301,"Census Tract 9503.01, Nacogdoches County, Texas",6811,611,5499,480,1312,472
1400000US48347950302,48347950302,"Census Tract 9503.02, Nacogdoches County, Texas",7328,713,4130,475,3198,530
1400000US48347950400,48347950400,"Census Tract 9504, Nacogdoches County, Texas",8365,524,7662,537,703,284
1400000US48347950501,48347950501,"Census Tract 9505.01, Nacogdoches County, Texas",2638,339,2535,341,103,95
1400000US48347950502,48347950502,"Census Tract 9505.02, Nacogdoches County, Texas",4829,450,4535,458,294,282
1400000US48347950600,48347950600,"Census Tract 9506, Nacogdoches County, Texas",6917,630,6297,641,620,197
1400000US48347950700,48347950700,"Census Tract 9507, Nacogdoches County, Texas",4500,451,3056,400,1444,379
1400000US48347950800,48347950800,"Census Tract 9508, Nacogdoches County, Texas",4121,510,2342,331,1779,511
1400000US48347950900,48347950900,"Census Tract 9509, Nacogdoches County, Texas",2650,491,2197,366,453,331
1400000US48347951000,48347951000,"Census Tract 9510, Nacogdoches County, Texas",4618,454,3918,496,700,353
1400000US48347951100,48347951100,"Census Tract 9511, Nacogdoches County, Texas",5067,363,4825,326,242,149
1400000US48349970100,48349970100,"Census Tract 9701, Navarro County, Texas",3835,476,2630,363,1205,337
1400000US48349970200,48349970200,"Census Tract 9702, Navarro County, Texas",5240,495,4102,531,1138,323
1400000US48349970300,48349970300,"Census Tract 9703, Navarro County, Texas",8067,579,5929,559,2138,504
1400000US48349970400,48349970400,"Census Tract 9704, Navarro County, Texas",4551,399,3957,361,594,211
1400000US48349970500,48349970500,"Census Tract 9705, Navarro County, Texas",4004,374,3255,315,749,286
1400000US48349970600,48349970600,"Census Tract 9706, Navarro County, Texas",3490,367,3204,356,286,148
1400000US48349970700,48349970700,"Census Tract 9707, Navarro County, Texas",5903,541,5444,528,459,177
1400000US48349970800,48349970800,"Census Tract 9708, Navarro County, Texas",1658,239,877,201,781,232
1400000US48349970900,48349970900,"Census Tract 9709, Navarro County, Texas",7648,568,4211,502,3437,472
1400000US48349971000,48349971000,"Census Tract 9710, Navarro County, Texas",3343,352,2821,289,522,287
1400000US48351950100,48351950100,"Census Tract 9501, Newton County, Texas",2481,485,2481,485,0,13
1400000US48351950200,48351950200,"Census Tract 9502, Newton County, Texas",5513,603,5344,591,169,74
1400000US48351950300,48351950300,"Census Tract 9503, Newton County, Texas",2285,438,2219,443,66,79
1400000US48351950400,48351950400,"Census Tract 9504, Newton County, Texas",4093,615,3904,590,189,111
1400000US48353950100,48353950100,"Census Tract 9501, Nolan County, Texas",1981,192,1735,181,246,140
1400000US48353950200,48353950200,"Census Tract 9502, Nolan County, Texas",4175,326,2978,278,1197,281
1400000US48353950300,48353950300,"Census Tract 9503, Nolan County, Texas",1930,303,1121,207,809,274
1400000US48353950400,48353950400,"Census Tract 9504, Nolan County, Texas",4387,403,2183,301,2204,311
1400000US48353950500,48353950500,"Census Tract 9505, Nolan County, Texas",2631,207,1971,192,660,191
1400000US48355000500,48355000500,"Census Tract 5, Nueces County, Texas",1276,297,657,231,619,255
1400000US48355000600,48355000600,"Census Tract 6, Nueces County, Texas",7167,868,1321,320,5846,863
1400000US48355000700,48355000700,"Census Tract 7, Nueces County, Texas",4643,499,1213,262,3430,470
1400000US48355000800,48355000800,"Census Tract 8, Nueces County, Texas",4022,495,846,239,3176,498
1400000US48355000900,48355000900,"Census Tract 9, Nueces County, Texas",3698,534,128,83,3570,534
1400000US48355001000,48355001000,"Census Tract 10, Nueces County, Texas",3036,464,271,109,2765,478
1400000US48355001100,48355001100,"Census Tract 11, Nueces County, Texas",1812,340,359,160,1453,320
1400000US48355001200,48355001200,"Census Tract 12, Nueces County, Texas",3762,556,1258,217,2504,485
1400000US48355001300,48355001300,"Census Tract 13, Nueces County, Texas",4141,597,81,53,4060,597
1400000US48355001400,48355001400,"Census Tract 14, Nueces County, Texas",3963,477,2387,458,1576,424
1400000US48355001500,48355001500,"Census Tract 15, Nueces County, Texas",4202,444,501,222,3701,433
1400000US48355001601,48355001601,"Census Tract 16.01, Nueces County, Texas",4475,521,471,242,4004,588
1400000US48355001602,48355001602,"Census Tract 16.02, Nueces County, Texas",3834,509,121,120,3713,488
1400000US48355001701,48355001701,"Census Tract 17.01, Nueces County, Texas",6357,786,1031,367,5326,867
1400000US48355001702,48355001702,"Census Tract 17.02, Nueces County, Texas",1824,329,252,156,1572,326
1400000US48355001801,48355001801,"Census Tract 18.01, Nueces County, Texas",5508,451,589,217,4919,488
1400000US48355001802,48355001802,"Census Tract 18.02, Nueces County, Texas",2456,227,330,222,2126,298
1400000US48355001902,48355001902,"Census Tract 19.02, Nueces County, Texas",8110,843,892,333,7218,895
1400000US48355001903,48355001903,"Census Tract 19.03, Nueces County, Texas",3565,508,464,205,3101,494
1400000US48355001904,48355001904,"Census Tract 19.04, Nueces County, Texas",4641,512,337,112,4304,511
1400000US48355002001,48355002001,"Census Tract 20.01, Nueces County, Texas",3986,451,588,227,3398,421
1400000US48355002002,48355002002,"Census Tract 20.02, Nueces County, Texas",4292,489,497,200,3795,500
1400000US48355002101,48355002101,"Census Tract 21.01, Nueces County, Texas",3809,380,1112,384,2697,410
1400000US48355002102,48355002102,"Census Tract 21.02, Nueces County, Texas",3390,289,2259,264,1131,241
1400000US48355002200,48355002200,"Census Tract 22, Nueces County, Texas",5853,667,1255,319,4598,539
1400000US48355002301,48355002301,"Census Tract 23.01, Nueces County, Texas",3852,383,727,186,3125,407
1400000US48355002303,48355002303,"Census Tract 23.03, Nueces County, Texas",4730,420,1136,238,3594,430
1400000US48355002304,48355002304,"Census Tract 23.04, Nueces County, Texas",5813,500,1594,324,4219,539
1400000US48355002400,48355002400,"Census Tract 24, Nueces County, Texas",6365,655,2233,311,4132,637
1400000US48355002500,48355002500,"Census Tract 25, Nueces County, Texas",4658,545,2903,460,1755,502
1400000US48355002601,48355002601,"Census Tract 26.01, Nueces County, Texas",2391,305,1404,320,987,412
1400000US48355002602,48355002602,"Census Tract 26.02, Nueces County, Texas",2155,305,659,164,1496,316
1400000US48355002603,48355002603,"Census Tract 26.03, Nueces County, Texas",3520,335,1603,251,1917,366
1400000US48355002703,48355002703,"Census Tract 27.03, Nueces County, Texas",5560,447,2655,360,2905,362
1400000US48355002704,48355002704,"Census Tract 27.04, Nueces County, Texas",5422,549,3540,503,1882,565
1400000US48355002705,48355002705,"Census Tract 27.05, Nueces County, Texas",5478,641,3568,516,1910,516
1400000US48355002706,48355002706,"Census Tract 27.06, Nueces County, Texas",1577,702,979,431,598,287
1400000US48355002900,48355002900,"Census Tract 29, Nueces County, Texas",1387,281,1191,268,196,64
1400000US48355003001,48355003001,"Census Tract 30.01, Nueces County, Texas",4395,528,3050,495,1345,372
1400000US48355003002,48355003002,"Census Tract 30.02, Nueces County, Texas",5204,502,3635,454,1569,322
1400000US48355003101,48355003101,"Census Tract 31.01, Nueces County, Texas",6422,782,5008,601,1414,625
1400000US48355003102,48355003102,"Census Tract 31.02, Nueces County, Texas",5398,547,3567,405,1831,579
1400000US48355003202,48355003202,"Census Tract 32.02, Nueces County, Texas",5889,434,2466,419,3423,395
1400000US48355003203,48355003203,"Census Tract 32.03, Nueces County, Texas",5330,576,2319,369,3011,574
1400000US48355003204,48355003204,"Census Tract 32.04, Nueces County, Texas",4897,382,2294,366,2603,403
1400000US48355003303,48355003303,"Census Tract 33.03, Nueces County, Texas",1469,284,237,181,1232,273
1400000US48355003304,48355003304,"Census Tract 33.04, Nueces County, Texas",5552,563,2369,369,3183,525
1400000US48355003305,48355003305,"Census Tract 33.05, Nueces County, Texas",4965,617,1426,261,3539,639
1400000US48355003306,48355003306,"Census Tract 33.06, Nueces County, Texas",4505,491,2072,386,2433,415
1400000US48355003401,48355003401,"Census Tract 34.01, Nueces County, Texas",4493,438,1712,296,2781,420
1400000US48355003402,48355003402,"Census Tract 34.02, Nueces County, Texas",5668,471,2345,473,3323,451
1400000US48355003500,48355003500,"Census Tract 35, Nueces County, Texas",2503,273,658,209,1845,243
1400000US48355003601,48355003601,"Census Tract 36.01, Nueces County, Texas",6028,834,3460,518,2568,699
1400000US48355003602,48355003602,"Census Tract 36.02, Nueces County, Texas",7013,572,3693,542,3320,336
1400000US48355003603,48355003603,"Census Tract 36.03, Nueces County, Texas",3655,288,1817,417,1838,433
1400000US48355003700,48355003700,"Census Tract 37, Nueces County, Texas",3663,494,1654,345,2009,610
1400000US48355005102,48355005102,"Census Tract 51.02, Nueces County, Texas",3198,173,2817,260,381,235
1400000US48355005404,48355005404,"Census Tract 54.04, Nueces County, Texas",2499,221,1472,197,1027,242
1400000US48355005406,48355005406,"Census Tract 54.06, Nueces County, Texas",2870,299,1600,253,1270,273
1400000US48355005407,48355005407,"Census Tract 54.07, Nueces County, Texas",2136,230,789,187,1347,222
1400000US48355005408,48355005408,"Census Tract 54.08, Nueces County, Texas",3595,473,1165,245,2430,509
1400000US48355005409,48355005409,"Census Tract 54.09, Nueces County, Texas",3770,262,1919,261,1851,254
1400000US48355005410,48355005410,"Census Tract 54.10, Nueces County, Texas",3840,434,1622,443,2218,525
1400000US48355005411,48355005411,"Census Tract 54.11, Nueces County, Texas",3703,411,1934,347,1769,413
1400000US48355005412,48355005412,"Census Tract 54.12, Nueces County, Texas",4985,387,3057,507,1928,345
1400000US48355005413,48355005413,"Census Tract 54.13, Nueces County, Texas",2872,435,1280,250,1592,468
1400000US48355005414,48355005414,"Census Tract 54.14, Nueces County, Texas",1970,204,1043,142,927,225
1400000US48355005415,48355005415,"Census Tract 54.15, Nueces County, Texas",4553,342,2188,324,2365,343
1400000US48355005416,48355005416,"Census Tract 54.16, Nueces County, Texas",3470,287,2608,279,862,251
1400000US48355005417,48355005417,"Census Tract 54.17, Nueces County, Texas",4245,448,2321,309,1924,339
1400000US48355005601,48355005601,"Census Tract 56.01, Nueces County, Texas",6399,584,435,188,5964,622
1400000US48355005602,48355005602,"Census Tract 56.02, Nueces County, Texas",6972,611,573,261,6399,618
1400000US48355005801,48355005801,"Census Tract 58.01, Nueces County, Texas",6325,453,4640,437,1685,401
1400000US48355005802,48355005802,"Census Tract 58.02, Nueces County, Texas",5980,544,2740,371,3240,443
1400000US48355005900,48355005900,"Census Tract 59, Nueces County, Texas",3166,407,729,247,2437,457
1400000US48355006000,48355006000,"Census Tract 60, Nueces County, Texas",2320,355,610,211,1710,365
1400000US48355006100,48355006100,"Census Tract 61, Nueces County, Texas",3330,57,1083,206,2247,208
1400000US48355006200,48355006200,"Census Tract 62, Nueces County, Texas",9263,1009,7708,729,1555,632
1400000US48355006300,48355006300,"Census Tract 63, Nueces County, Texas",2734,324,1113,244,1621,322
1400000US48355006400,48355006400,"Census Tract 64, Nueces County, Texas",2571,407,1123,193,1448,384
1400000US48355980000,48355980000,"Census Tract 9800, Nueces County, Texas",23,32,7,9,16,22
1400000US48355990000,48355990000,"Census Tract 9900, Nueces County, Texas",0,13,0,13,0,13
1400000US48357950100,48357950100,"Census Tract 9501, Ochiltree County, Texas",1483,262,1051,194,432,237
1400000US48357950300,48357950300,"Census Tract 9503, Ochiltree County, Texas",4157,288,1555,239,2602,313
1400000US48357950400,48357950400,"Census Tract 9504, Ochiltree County, Texas",4674,315,2676,256,1998,275
1400000US48359950100,48359950100,"Census Tract 9501, Oldham County, Texas",2048,,1832,84,216,84
1400000US48361020200,48361020200,"Census Tract 202, Orange County, Texas",3772,368,3732,369,40,64
1400000US48361020300,48361020300,"Census Tract 203, Orange County, Texas",2528,351,2448,342,80,47
1400000US48361020500,48361020500,"Census Tract 205, Orange County, Texas",3245,144,2994,181,251,123
1400000US48361020700,48361020700,"Census Tract 207, Orange County, Texas",4677,370,4308,388,369,173
1400000US48361020800,48361020800,"Census Tract 208, Orange County, Texas",1765,249,1616,255,149,134
1400000US48361020900,48361020900,"Census Tract 209, Orange County, Texas",3235,315,3007,332,228,167
1400000US48361021000,48361021000,"Census Tract 210, Orange County, Texas",2114,186,2051,194,63,56
1400000US48361021100,48361021100,"Census Tract 211, Orange County, Texas",1915,223,1875,231,40,33
1400000US48361021200,48361021200,"Census Tract 212, Orange County, Texas",4759,499,4454,468,305,183
1400000US48361021300,48361021300,"Census Tract 213, Orange County, Texas",6318,419,6092,399,226,136
1400000US48361021400,48361021400,"Census Tract 214, Orange County, Texas",3922,374,3799,390,123,121
1400000US48361021501,48361021501,"Census Tract 215.01, Orange County, Texas",2368,267,1998,435,370,282
1400000US48361021502,48361021502,"Census Tract 215.02, Orange County, Texas",7503,660,7067,691,436,258
1400000US48361021600,48361021600,"Census Tract 216, Orange County, Texas",3554,437,3430,440,124,95
1400000US48361021700,48361021700,"Census Tract 217, Orange County, Texas",2607,313,2449,325,158,134
1400000US48361021800,48361021800,"Census Tract 218, Orange County, Texas",2694,332,2572,378,122,128
1400000US48361021900,48361021900,"Census Tract 219, Orange County, Texas",5867,632,5734,643,133,80
1400000US48361022000,48361022000,"Census Tract 220, Orange County, Texas",3981,407,3747,390,234,150
1400000US48361022200,48361022200,"Census Tract 222, Orange County, Texas",3336,390,3173,359,163,142
1400000US48361022300,48361022300,"Census Tract 223, Orange County, Texas",7131,629,6709,636,422,287
1400000US48361022400,48361022400,"Census Tract 224, Orange County, Texas",5015,477,4185,469,830,281
1400000US48363000100,48363000100,"Census Tract 1, Palo Pinto County, Texas",2865,345,2624,340,241,127
1400000US48363000200,48363000200,"Census Tract 2, Palo Pinto County, Texas",1901,210,1666,203,235,79
1400000US48363000300,48363000300,"Census Tract 3, Palo Pinto County, Texas",3657,372,3494,380,163,88
1400000US48363000400,48363000400,"Census Tract 4, Palo Pinto County, Texas",6204,452,5961,477,243,146
1400000US48363000500,48363000500,"Census Tract 5, Palo Pinto County, Texas",1600,192,1343,184,257,142
1400000US48363000600,48363000600,"Census Tract 6, Palo Pinto County, Texas",3169,454,2381,310,788,330
1400000US48363000700,48363000700,"Census Tract 7, Palo Pinto County, Texas",3325,369,2273,313,1052,225
1400000US48363000800,48363000800,"Census Tract 8, Palo Pinto County, Texas",2993,296,1612,272,1381,206
1400000US48363000900,48363000900,"Census Tract 9, Palo Pinto County, Texas",2296,260,1644,196,652,219
1400000US48365950100,48365950100,"Census Tract 9501, Panola County, Texas",4084,431,4009,437,75,56
1400000US48365950200,48365950200,"Census Tract 9502, Panola County, Texas",2732,368,2566,344,166,127
1400000US48365950300,48365950300,"Census Tract 9503, Panola County, Texas",5246,440,3981,474,1265,247
1400000US48365950400,48365950400,"Census Tract 9504, Panola County, Texas",6755,147,6356,255,399,179
1400000US48365950500,48365950500,"Census Tract 9505, Panola County, Texas",2971,317,2965,317,6,12
1400000US48365950600,48365950600,"Census Tract 9506, Panola County, Texas",2026,276,1987,280,39,37
1400000US48367140101,48367140101,"Census Tract 1401.01, Parker County, Texas",4888,379,3617,392,1271,422
1400000US48367140102,48367140102,"Census Tract 1401.02, Parker County, Texas",4427,486,3742,480,685,327
1400000US48367140200,48367140200,"Census Tract 1402, Parker County, Texas",6517,522,5955,563,562,260
1400000US48367140300,48367140300,"Census Tract 1403, Parker County, Texas",5626,447,4365,410,1261,349
1400000US48367140403,48367140403,"Census Tract 1404.03, Parker County, Texas",6228,568,5826,561,402,146
1400000US48367140405,48367140405,"Census Tract 1404.05, Parker County, Texas",5713,452,5357,409,356,153
1400000US48367140407,48367140407,"Census Tract 1404.07, Parker County, Texas",10307,631,9326,662,981,306
1400000US48367140408,48367140408,"Census Tract 1404.08, Parker County, Texas",4042,361,3809,347,233,96
1400000US48367140409,48367140409,"Census Tract 1404.09, Parker County, Texas",3654,513,2749,494,905,335
1400000US48367140410,48367140410,"Census Tract 1404.10, Parker County, Texas",3434,445,3033,375,401,379
1400000US48367140411,48367140411,"Census Tract 1404.11, Parker County, Texas",4268,488,4005,468,263,301
1400000US48367140501,48367140501,"Census Tract 1405.01, Parker County, Texas",7083,402,6668,421,415,197
1400000US48367140502,48367140502,"Census Tract 1405.02, Parker County, Texas",6859,414,6074,387,785,109
1400000US48367140601,48367140601,"Census Tract 1406.01, Parker County, Texas",6949,559,6418,526,531,350
1400000US48367140602,48367140602,"Census Tract 1406.02, Parker County, Texas",9251,733,8138,716,1113,340
1400000US48367140703,48367140703,"Census Tract 1407.03, Parker County, Texas",6429,531,6046,544,383,172
1400000US48367140704,48367140704,"Census Tract 1407.04, Parker County, Texas",7445,526,6961,519,484,162
1400000US48367140705,48367140705,"Census Tract 1407.05, Parker County, Texas",7603,645,6552,393,1051,671
1400000US48367140706,48367140706,"Census Tract 1407.06, Parker County, Texas",6097,389,5728,343,369,240
1400000US48369950200,48369950200,"Census Tract 9502, Parmer County, Texas",4939,290,1784,278,3155,217
1400000US48369950300,48369950300,"Census Tract 9503, Parmer County, Texas",5233,290,2319,278,2914,217
1400000US48371950100,48371950100,"Census Tract 9501, Pecos County, Texas",2273,246,1036,191,1237,217
1400000US48371950300,48371950300,"Census Tract 9503, Pecos County, Texas",3000,290,217,105,2783,271
1400000US48371950400,48371950400,"Census Tract 9504, Pecos County, Texas",4155,303,1202,214,2953,304
1400000US48371950500,48371950500,"Census Tract 9505, Pecos County, Texas",6082,377,2628,297,3454,378
1400000US48373210101,48373210101,"Census Tract 2101.01, Polk County, Texas",4434,570,4008,653,426,278
1400000US48373210102,48373210102,"Census Tract 2101.02, Polk County, Texas",6790,742,6420,705,370,184
1400000US48373210203,48373210203,"Census Tract 2102.03, Polk County, Texas",6679,1176,4640,716,2039,806
1400000US48373210204,48373210204,"Census Tract 2102.04, Polk County, Texas",4310,514,3496,450,814,287
1400000US48373210205,48373210205,"Census Tract 2102.05, Polk County, Texas",2806,406,2673,398,133,96
1400000US48373210206,48373210206,"Census Tract 2102.06, Polk County, Texas",3723,525,3625,508,98,78
1400000US48373210301,48373210301,"Census Tract 2103.01, Polk County, Texas",3457,531,3396,519,61,42
1400000US48373210302,48373210302,"Census Tract 2103.02, Polk County, Texas",4655,655,4189,634,466,208
1400000US48373210400,48373210400,"Census Tract 2104, Polk County, Texas",4529,520,3518,467,1011,292
1400000US48373210500,48373210500,"Census Tract 2105, Polk County, Texas",4235,420,3695,403,540,223
1400000US48375010100,48375010100,"Census Tract 101, Potter County, Texas",1926,244,1709,237,217,107
1400000US48375010200,48375010200,"Census Tract 102, Potter County, Texas",2008,152,1930,141,78,73
1400000US48375010300,48375010300,"Census Tract 103, Potter County, Texas",1128,228,733,162,395,186
1400000US48375010400,48375010400,"Census Tract 104, Potter County, Texas",3338,258,2792,308,546,263
1400000US48375010600,48375010600,"Census Tract 106, Potter County, Texas",2548,242,464,185,2084,294
1400000US48375010700,48375010700,"Census Tract 107, Potter County, Texas",3574,439,1619,277,1955,441
1400000US48375011000,48375011000,"Census Tract 110, Potter County, Texas",2363,236,669,163,1694,307
1400000US48375011500,48375011500,"Census Tract 115, Potter County, Texas",3310,358,2725,271,585,273
1400000US48375011600,48375011600,"Census Tract 116, Potter County, Texas",4248,380,3240,320,1008,242
1400000US48375011700,48375011700,"Census Tract 117, Potter County, Texas",4133,475,3284,499,849,237
1400000US48375011800,48375011800,"Census Tract 118, Potter County, Texas",3748,315,3019,306,729,169
1400000US48375011900,48375011900,"Census Tract 119, Potter County, Texas",3573,402,2323,370,1250,422
1400000US48375012000,48375012000,"Census Tract 120, Potter County, Texas",1854,268,1096,235,758,282
1400000US48375012200,48375012200,"Census Tract 122, Potter County, Texas",4184,544,1141,287,3043,572
1400000US48375012600,48375012600,"Census Tract 126, Potter County, Texas",3628,505,1086,330,2542,576
1400000US48375012800,48375012800,"Census Tract 128, Potter County, Texas",4431,466,1799,300,2632,457
1400000US48375013000,48375013000,"Census Tract 130, Potter County, Texas",1824,286,1622,295,202,116
1400000US48375013200,48375013200,"Census Tract 132, Potter County, Texas",1685,138,1522,185,163,117
1400000US48375013300,48375013300,"Census Tract 133, Potter County, Texas",5133,346,4686,346,447,207
1400000US48375013400,48375013400,"Census Tract 134, Potter County, Texas",4036,420,3779,416,257,85
1400000US48375013900,48375013900,"Census Tract 139, Potter County, Texas",3500,404,2477,326,1023,197
1400000US48375014100,48375014100,"Census Tract 141, Potter County, Texas",2796,291,1505,343,1291,263
1400000US48375014300,48375014300,"Census Tract 143, Potter County, Texas",6453,484,6031,516,422,176
1400000US48375014401,48375014401,"Census Tract 144.01, Potter County, Texas",5246,302,3808,275,1438,211
1400000US48375014500,48375014500,"Census Tract 145, Potter County, Texas",6127,744,2199,428,3928,661
1400000US48375014700,48375014700,"Census Tract 147, Potter County, Texas",4674,482,3573,489,1101,390
1400000US48375014800,48375014800,"Census Tract 148, Potter County, Texas",2671,478,1576,284,1095,531
1400000US48375014900,48375014900,"Census Tract 149, Potter County, Texas",5657,448,3771,441,1886,388
1400000US48375015000,48375015000,"Census Tract 150, Potter County, Texas",7282,668,3172,599,4110,675
1400000US48375015100,48375015100,"Census Tract 151, Potter County, Texas",3543,307,2784,286,759,219
1400000US48375015200,48375015200,"Census Tract 152, Potter County, Texas",2672,204,2342,233,330,151
1400000US48375015300,48375015300,"Census Tract 153, Potter County, Texas",5058,540,2948,476,2110,569
1400000US48375015400,48375015400,"Census Tract 154, Potter County, Texas",2748,295,797,221,1951,244
1400000US48375980000,48375980000,"Census Tract 9800, Potter County, Texas",0,13,0,13,0,13
1400000US48377950100,48377950100,"Census Tract 9501, Presidio County, Texas",2925,262,991,196,1934,302
1400000US48377950200,48377950200,"Census Tract 9502, Presidio County, Texas",4753,262,322,177,4431,300
1400000US48379950100,48379950100,"Census Tract 9501, Rains County, Texas",6429,421,5680,402,749,93
1400000US48379950200,48379950200,"Census Tract 9502, Rains County, Texas",4547,421,4424,402,123,93
1400000US48381020100,48381020100,"Census Tract 201, Randall County, Texas",2250,208,2060,176,190,123
1400000US48381020200,48381020200,"Census Tract 202, Randall County, Texas",2195,194,1897,258,298,156
1400000US48381020300,48381020300,"Census Tract 203, Randall County, Texas",2017,232,1574,201,443,184
1400000US48381020400,48381020400,"Census Tract 204, Randall County, Texas",1804,166,1531,179,273,147
1400000US48381020500,48381020500,"Census Tract 205, Randall County, Texas",3731,347,2583,328,1148,349
1400000US48381020600,48381020600,"Census Tract 206, Randall County, Texas",4129,427,2100,356,2029,373
1400000US48381020800,48381020800,"Census Tract 208, Randall County, Texas",6653,501,5633,462,1020,312
1400000US48381020900,48381020900,"Census Tract 209, Randall County, Texas",3102,485,2446,462,656,216
1400000US48381021000,48381021000,"Census Tract 210, Randall County, Texas",2465,201,1730,263,735,215
1400000US48381021101,48381021101,"Census Tract 211.01, Randall County, Texas",4088,385,3467,345,621,233
1400000US48381021102,48381021102,"Census Tract 211.02, Randall County, Texas",1912,281,1437,285,475,215
1400000US48381021200,48381021200,"Census Tract 212, Randall County, Texas",4856,411,4330,402,526,280
1400000US48381021300,48381021300,"Census Tract 213, Randall County, Texas",5300,494,4413,416,887,437
1400000US48381021500,48381021500,"Census Tract 215, Randall County, Texas",4806,307,4350,264,456,154
1400000US48381021602,48381021602,"Census Tract 216.02, Randall County, Texas",5470,375,5161,352,309,192
1400000US48381021603,48381021603,"Census Tract 216.03, Randall County, Texas",1965,175,1716,197,249,120
1400000US48381021604,48381021604,"Census Tract 216.04, Randall County, Texas",4600,433,4196,387,404,233
1400000US48381021605,48381021605,"Census Tract 216.05, Randall County, Texas",2117,145,1968,148,149,79
1400000US48381021606,48381021606,"Census Tract 216.06, Randall County, Texas",5364,415,4709,379,655,310
1400000US48381021608,48381021608,"Census Tract 216.08, Randall County, Texas",6106,406,5331,467,775,230
1400000US48381021609,48381021609,"Census Tract 216.09, Randall County, Texas",2986,292,2551,236,435,256
1400000US48381021702,48381021702,"Census Tract 217.02, Randall County, Texas",3444,338,2888,277,556,209
1400000US48381021703,48381021703,"Census Tract 217.03, Randall County, Texas",7326,555,5823,590,1503,414
1400000US48381021704,48381021704,"Census Tract 217.04, Randall County, Texas",6919,501,6475,551,444,191
1400000US48381021801,48381021801,"Census Tract 218.01, Randall County, Texas",6557,396,5485,410,1072,244
1400000US48381021802,48381021802,"Census Tract 218.02, Randall County, Texas",5315,378,4413,356,902,256
1400000US48381021900,48381021900,"Census Tract 219, Randall County, Texas",4073,388,3619,448,454,328
1400000US48381022001,48381022001,"Census Tract 220.01, Randall County, Texas",4056,359,3280,296,776,342
1400000US48381022002,48381022002,"Census Tract 220.02, Randall County, Texas",5484,585,3854,491,1630,447
1400000US48383950100,48383950100,"Census Tract 9501, Reagan County, Texas",3384,,1196,127,2188,127
1400000US48385950100,48385950100,"Census Tract 9501, Real County, Texas",3326,,2651,166,675,166
1400000US48387950100,48387950100,"Census Tract 9501, Red River County, Texas",2765,252,2635,237,130,90
1400000US48387950500,48387950500,"Census Tract 9505, Red River County, Texas",4380,292,3812,299,568,135
1400000US48387950600,48387950600,"Census Tract 9506, Red River County, Texas",2694,256,2633,255,61,81
1400000US48387950700,48387950700,"Census Tract 9507, Red River County, Texas",2956,314,2867,303,89,70
1400000US48389950100,48389950100,"Census Tract 9501, Reeves County, Texas",3754,460,892,301,2862,476
1400000US48389950200,48389950200,"Census Tract 9502, Reeves County, Texas",2420,318,230,170,2190,321
1400000US48389950300,48389950300,"Census Tract 9503, Reeves County, Texas",2027,361,324,210,1703,340
1400000US48389950400,48389950400,"Census Tract 9504, Reeves County, Texas",3852,377,1529,288,2323,389
1400000US48389950500,48389950500,"Census Tract 9505, Reeves County, Texas",1553,392,543,208,1010,301
1400000US48391950200,48391950200,"Census Tract 9502, Refugio County, Texas",3601,174,1900,163,1701,182
1400000US48391950400,48391950400,"Census Tract 9504, Refugio County, Texas",3751,174,1958,163,1793,182
1400000US48393950100,48393950100,"Census Tract 9501, Roberts County, Texas",992,116,961,114,31,50
1400000US48395960100,48395960100,"Census Tract 9601, Robertson County, Texas",2083,291,2035,290,48,36
1400000US48395960200,48395960200,"Census Tract 9602, Robertson County, Texas",1352,230,1164,204,188,115
1400000US48395960300,48395960300,"Census Tract 9603, Robertson County, Texas",4614,366,4309,325,305,133
1400000US48395960400,48395960400,"Census Tract 9604, Robertson County, Texas",3069,406,2254,383,815,290
1400000US48395960500,48395960500,"Census Tract 9605, Robertson County, Texas",5478,266,3805,372,1673,293
1400000US48397040101,48397040101,"Census Tract 401.01, Rockwall County, Texas",6508,441,5659,571,849,389
1400000US48397040102,48397040102,"Census Tract 401.02, Rockwall County, Texas",6874,417,6112,438,762,252
1400000US48397040200,48397040200,"Census Tract 402, Rockwall County, Texas",4206,333,3747,293,459,196
1400000US48397040301,48397040301,"Census Tract 403.01, Rockwall County, Texas",5335,316,4436,328,899,248
1400000US48397040302,48397040302,"Census Tract 403.02, Rockwall County, Texas",7266,490,6600,484,666,298
1400000US48397040401,48397040401,"Census Tract 404.01, Rockwall County, Texas",8917,623,7200,571,1717,600
1400000US48397040402,48397040402,"Census Tract 404.02, Rockwall County, Texas",9356,691,7661,484,1695,601
1400000US48397040503,48397040503,"Census Tract 405.03, Rockwall County, Texas",7216,483,3770,499,3446,574
1400000US48397040504,48397040504,"Census Tract 405.04, Rockwall County, Texas",6006,496,5476,463,530,291
1400000US48397040505,48397040505,"Census Tract 405.05, Rockwall County, Texas",10367,563,8987,630,1380,376
1400000US48397040506,48397040506,"Census Tract 405.06, Rockwall County, Texas",6698,446,6519,443,179,145
1400000US48399950100,48399950100,"Census Tract 9501, Runnels County, Texas",1138,145,1065,157,73,56
1400000US48399950200,48399950200,"Census Tract 9502, Runnels County, Texas",2423,114,1370,151,1053,155
1400000US48399950500,48399950500,"Census Tract 9505, Runnels County, Texas",2123,207,1501,215,622,159
1400000US48399950600,48399950600,"Census Tract 9506, Runnels County, Texas",4789,263,3135,282,1654,164
1400000US48401950100,48401950100,"Census Tract 9501, Rusk County, Texas",5722,522,4751,507,971,382
1400000US48401950200,48401950200,"Census Tract 9502, Rusk County, Texas",3541,327,3384,304,157,205
1400000US48401950300,48401950300,"Census Tract 9503, Rusk County, Texas",6602,562,5783,472,819,453
1400000US48401950400,48401950400,"Census Tract 9504, Rusk County, Texas",5270,444,4629,385,641,272
1400000US48401950501,48401950501,"Census Tract 9505.01, Rusk County, Texas",4659,459,3879,417,780,294
1400000US48401950502,48401950502,"Census Tract 9505.02, Rusk County, Texas",4651,548,3936,558,715,238
1400000US48401950600,48401950600,"Census Tract 9506, Rusk County, Texas",2181,257,1980,279,201,164
1400000US48401950700,48401950700,"Census Tract 9507, Rusk County, Texas",5075,400,4377,394,698,181
1400000US48401950800,48401950800,"Census Tract 9508, Rusk County, Texas",3570,263,2989,257,581,222
1400000US48401950900,48401950900,"Census Tract 9509, Rusk County, Texas",3396,343,2714,377,682,330
1400000US48401951000,48401951000,"Census Tract 9510, Rusk County, Texas",2846,362,1901,363,945,319
1400000US48401951100,48401951100,"Census Tract 9511, Rusk County, Texas",3183,388,2874,335,309,201
1400000US48401951200,48401951200,"Census Tract 9512, Rusk County, Texas",2515,300,2394,288,121,93
1400000US48403950100,48403950100,"Census Tract 9501, Sabine County, Texas",2610,372,2597,374,13,19
1400000US48403950200,48403950200,"Census Tract 9502, Sabine County, Texas",3059,400,2895,398,164,55
1400000US48403950300,48403950300,"Census Tract 9503, Sabine County, Texas",4973,444,4815,446,158,58
1400000US48405950100,48405950100,"Census Tract 9501, San Augustine County, Texas",2977,475,2973,476,4,8
1400000US48405950200,48405950200,"Census Tract 9502, San Augustine County, Texas",3082,403,2799,378,283,147
1400000US48405950300,48405950300,"Census Tract 9503, San Augustine County, Texas",2839,444,2807,446,32,29
1400000US48407200101,48407200101,"Census Tract 2001.01, San Jacinto County, Texas",6710,730,6009,818,701,374
1400000US48407200102,48407200102,"Census Tract 2001.02, San Jacinto County, Texas",9950,794,8073,799,1877,397
1400000US48407200200,48407200200,"Census Tract 2002, San Jacinto County, Texas",4602,684,4412,687,190,133
1400000US48407200300,48407200300,"Census Tract 2003, San Jacinto County, Texas",5220,682,5139,686,81,72
1400000US48409010201,48409010201,"Census Tract 102.01, San Patricio County, Texas",3684,480,2384,391,1300,391
1400000US48409010202,48409010202,"Census Tract 102.02, San Patricio County, Texas",5053,535,3318,489,1735,377
1400000US48409010301,48409010301,"Census Tract 103.01, San Patricio County, Texas",4439,426,2691,373,1748,366
1400000US48409010302,48409010302,"Census Tract 103.02, San Patricio County, Texas",4633,396,2737,395,1896,353
1400000US48409010500,48409010500,"Census Tract 105, San Patricio County, Texas",1877,211,125,66,1752,209
1400000US48409010601,48409010601,"Census Tract 106.01, San Patricio County, Texas",5541,447,2918,396,2623,426
1400000US48409010602,48409010602,"Census Tract 106.02, San Patricio County, Texas",3876,355,2205,342,1671,397
1400000US48409010603,48409010603,"Census Tract 106.03, San Patricio County, Texas",2565,267,1814,288,751,301
1400000US48409010604,48409010604,"Census Tract 106.04, San Patricio County, Texas",3090,283,2339,253,751,253
1400000US48409010700,48409010700,"Census Tract 107, San Patricio County, Texas",3753,555,2196,293,1557,476
1400000US48409010800,48409010800,"Census Tract 108, San Patricio County, Texas",4954,412,856,218,4098,423
1400000US48409010900,48409010900,"Census Tract 109, San Patricio County, Texas",4330,444,1934,358,2396,399
1400000US48409011000,48409011000,"Census Tract 110, San Patricio County, Texas",6549,424,1770,405,4779,502
1400000US48409011100,48409011100,"Census Tract 111, San Patricio County, Texas",2739,321,687,214,2052,304
1400000US48409011200,48409011200,"Census Tract 112, San Patricio County, Texas",2999,407,1466,295,1533,400
1400000US48409011300,48409011300,"Census Tract 113, San Patricio County, Texas",5270,279,493,125,4777,317
1400000US48411950100,48411950100,"Census Tract 9501, San Saba County, Texas",2892,225,1787,222,1105,207
1400000US48411950200,48411950200,"Census Tract 9502, San Saba County, Texas",3145,225,2548,222,597,207
1400000US48413950300,48413950300,"Census Tract 9503, Schleicher County, Texas",3327,,1767,,1560,
1400000US48415950100,48415950100,"Census Tract 9501, Scurry County, Texas",4569,414,2291,301,2278,366
1400000US48415950200,48415950200,"Census Tract 9502, Scurry County, Texas",1185,219,892,174,293,175
1400000US48415950300,48415950300,"Census Tract 9503, Scurry County, Texas",6113,527,4458,397,1655,349
1400000US48415950600,48415950600,"Census Tract 9506, Scurry County, Texas",4988,505,3058,356,1930,376
1400000US48417950300,48417950300,"Census Tract 9503, Shackelford County, Texas",3346,,3012,,334,
1400000US48419950100,48419950100,"Census Tract 9501, Shelby County, Texas",5042,518,4103,400,939,358
1400000US48419950200,48419950200,"Census Tract 9502, Shelby County, Texas",3360,383,3240,372,120,109
1400000US48419950300,48419950300,"Census Tract 9503, Shelby County, Texas",4404,430,3565,430,839,421
1400000US48419950400,48419950400,"Census Tract 9504, Shelby County, Texas",6410,469,4619,540,1791,376
1400000US48419950500,48419950500,"Census Tract 9505, Shelby County, Texas",3080,336,2691,321,389,271
1400000US48419950600,48419950600,"Census Tract 9506, Shelby County, Texas",3306,382,3229,382,77,93
1400000US48421950200,48421950200,"Census Tract 9502, Sherman County, Texas",3040,,1803,83,1237,83
1400000US48423000100,48423000100,"Census Tract 1, Smith County, Texas",6032,761,4096,708,1936,477
1400000US48423000201,48423000201,"Census Tract 2.01, Smith County, Texas",3712,533,3255,508,457,206
1400000US48423000202,48423000202,"Census Tract 2.02, Smith County, Texas",1863,378,926,176,937,390
1400000US48423000300,48423000300,"Census Tract 3, Smith County, Texas",5898,573,1826,500,4072,541
1400000US48423000400,48423000400,"Census Tract 4, Smith County, Texas",2323,315,1164,232,1159,374
1400000US48423000500,48423000500,"Census Tract 5, Smith County, Texas",2439,414,1266,197,1173,408
1400000US48423000600,48423000600,"Census Tract 6, Smith County, Texas",2206,304,767,261,1439,333
1400000US48423000700,48423000700,"Census Tract 7, Smith County, Texas",4605,778,3693,520,912,721
1400000US48423000800,48423000800,"Census Tract 8, Smith County, Texas",5851,644,3853,405,1998,653
1400000US48423000900,48423000900,"Census Tract 9, Smith County, Texas",4568,567,3201,493,1367,299
1400000US48423001000,48423001000,"Census Tract 10, Smith County, Texas",5017,450,3731,477,1286,329
1400000US48423001101,48423001101,"Census Tract 11.01, Smith County, Texas",3955,292,3570,332,385,193
1400000US48423001102,48423001102,"Census Tract 11.02, Smith County, Texas",2644,248,2485,248,159,117
1400000US48423001200,48423001200,"Census Tract 12, Smith County, Texas",3369,471,2943,358,426,232
1400000US48423001300,48423001300,"Census Tract 13, Smith County, Texas",2209,250,1950,281,259,162
1400000US48423001401,48423001401,"Census Tract 14.01, Smith County, Texas",9130,630,8704,626,426,183
1400000US48423001403,48423001403,"Census Tract 14.03, Smith County, Texas",6696,564,6236,586,460,170
1400000US48423001404,48423001404,"Census Tract 14.04, Smith County, Texas",5128,534,4883,540,245,252
1400000US48423001500,48423001500,"Census Tract 15, Smith County, Texas",5186,491,4813,430,373,293
1400000US48423001601,48423001601,"Census Tract 16.01, Smith County, Texas",5965,578,4494,576,1471,284
1400000US48423001602,48423001602,"Census Tract 16.02, Smith County, Texas",4525,500,4066,485,459,198
1400000US48423001604,48423001604,"Census Tract 16.04, Smith County, Texas",6320,725,4376,395,1944,637
1400000US48423001700,48423001700,"Census Tract 17, Smith County, Texas",8825,830,4303,502,4522,871
1400000US48423001801,48423001801,"Census Tract 18.01, Smith County, Texas",6222,627,5040,576,1182,328
1400000US48423001802,48423001802,"Census Tract 18.02, Smith County, Texas",8170,759,6546,598,1624,595
1400000US48423001803,48423001803,"Census Tract 18.03, Smith County, Texas",5286,449,4732,451,554,212
1400000US48423001901,48423001901,"Census Tract 19.01, Smith County, Texas",5917,586,5545,587,372,209
1400000US48423001905,48423001905,"Census Tract 19.05, Smith County, Texas",8030,543,7606,539,424,215
1400000US48423001906,48423001906,"Census Tract 19.06, Smith County, Texas",5759,546,5514,545,245,108
1400000US48423001907,48423001907,"Census Tract 19.07, Smith County, Texas",6621,490,6128,581,493,332
1400000US48423001908,48423001908,"Census Tract 19.08, Smith County, Texas",9146,625,8723,541,423,202
1400000US48423002003,48423002003,"Census Tract 20.03, Smith County, Texas",3990,339,3410,341,580,232
1400000US48423002004,48423002004,"Census Tract 20.04, Smith County, Texas",2732,240,2534,251,198,117
1400000US48423002006,48423002006,"Census Tract 20.06, Smith County, Texas",3459,295,3375,298,84,90
1400000US48423002007,48423002007,"Census Tract 20.07, Smith County, Texas",7261,602,6725,593,536,297
1400000US48423002008,48423002008,"Census Tract 20.08, Smith County, Texas",5543,480,5306,490,237,152
1400000US48423002009,48423002009,"Census Tract 20.09, Smith County, Texas",7412,506,6947,417,465,390
1400000US48423002101,48423002101,"Census Tract 21.01, Smith County, Texas",3818,458,3548,453,270,182
1400000US48423002102,48423002102,"Census Tract 21.02, Smith County, Texas",5570,497,5254,513,316,196
1400000US48423002200,48423002200,"Census Tract 22, Smith County, Texas",6289,646,6155,623,134,115
1400000US48423980000,48423980000,"Census Tract 9800, Smith County, Texas",0,13,0,13,0,13
1400000US48425000100,48425000100,"Census Tract 1, Somervell County, Texas",6745,247,5645,253,1100,259
1400000US48425000200,48425000200,"Census Tract 2, Somervell County, Texas",1699,247,1199,253,500,259
1400000US48427950101,48427950101,"Census Tract 9501.01, Starr County, Texas",1073,206,39,31,1034,204
1400000US48427950104,48427950104,"Census Tract 9501.04, Starr County, Texas",4272,569,34,24,4238,567
1400000US48427950105,48427950105,"Census Tract 9501.05, Starr County, Texas",3400,545,60,47,3340,548
1400000US48427950106,48427950106,"Census Tract 9501.06, Starr County, Texas",3170,622,100,103,3070,619
1400000US48427950107,48427950107,"Census Tract 9501.07, Starr County, Texas",4185,579,0,13,4185,579
1400000US48427950108,48427950108,"Census Tract 9501.08, Starr County, Texas",3386,508,239,232,3147,564
1400000US48427950202,48427950202,"Census Tract 9502.02, Starr County, Texas",2636,412,99,72,2537,426
1400000US48427950203,48427950203,"Census Tract 9502.03, Starr County, Texas",3160,559,11,17,3149,557
1400000US48427950204,48427950204,"Census Tract 9502.04, Starr County, Texas",5622,788,97,95,5525,800
1400000US48427950401,48427950401,"Census Tract 9504.01, Starr County, Texas",6871,884,37,57,6834,884
1400000US48427950402,48427950402,"Census Tract 9504.02, Starr County, Texas",5015,561,0,18,5015,561
1400000US48427950500,48427950500,"Census Tract 9505, Starr County, Texas",4099,500,58,41,4041,503
1400000US48427950600,48427950600,"Census Tract 9506, Starr County, Texas",6502,736,127,79,6375,760
1400000US48427950701,48427950701,"Census Tract 9507.01, Starr County, Texas",4127,567,18,23,4109,571
1400000US48427950702,48427950702,"Census Tract 9507.02, Starr County, Texas",3364,499,101,102,3263,506
1400000US48429950200,48429950200,"Census Tract 9502, Stephens County, Texas",4048,306,2990,281,1058,152
1400000US48429950300,48429950300,"Census Tract 9503, Stephens County, Texas",2599,321,1933,305,666,138
1400000US48429950500,48429950500,"Census Tract 9505, Stephens County, Texas",2914,301,2636,302,278,87
1400000US48431950100,48431950100,"Census Tract 9501, Sterling County, Texas",1223,152,837,153,386,108
1400000US48433950300,48433950300,"Census Tract 9503, Stonewall County, Texas",1447,96,1278,145,169,101
1400000US48435950300,48435950300,"Census Tract 9503, Sutton County, Texas",4123,,1596,202,2527,202
1400000US48437950200,48437950200,"Census Tract 9502, Swisher County, Texas",2185,216,1517,194,668,145
1400000US48437950300,48437950300,"Census Tract 9503, Swisher County, Texas",4518,175,2465,175,2053,148
1400000US48437950400,48437950400,"Census Tract 9504, Swisher County, Texas",1113,162,680,129,433,102
1400000US48439100101,48439100101,"Census Tract 1001.01, Tarrant County, Texas",5818,554,1880,319,3938,550
1400000US48439100102,48439100102,"Census Tract 1001.02, Tarrant County, Texas",4563,618,1609,171,2954,660
1400000US48439100201,48439100201,"Census Tract 1002.01, Tarrant County, Texas",4823,577,445,197,4378,576
1400000US48439100202,48439100202,"Census Tract 1002.02, Tarrant County, Texas",5446,448,359,187,5087,510
1400000US48439100300,48439100300,"Census Tract 1003, Tarrant County, Texas",4744,447,903,198,3841,474
1400000US48439100400,48439100400,"Census Tract 1004, Tarrant County, Texas",8442,1026,563,207,7879,1001
1400000US48439100501,48439100501,"Census Tract 1005.01, Tarrant County, Texas",10088,847,3148,631,6940,955
1400000US48439100502,48439100502,"Census Tract 1005.02, Tarrant County, Texas",7654,912,1411,414,6243,934
1400000US48439100601,48439100601,"Census Tract 1006.01, Tarrant County, Texas",2028,270,1936,247,92,62
1400000US48439100602,48439100602,"Census Tract 1006.02, Tarrant County, Texas",3626,356,2315,340,1311,195
1400000US48439100700,48439100700,"Census Tract 1007, Tarrant County, Texas",4569,458,1931,300,2638,421
1400000US48439100800,48439100800,"Census Tract 1008, Tarrant County, Texas",6071,499,567,222,5504,516
1400000US48439100900,48439100900,"Census Tract 1009, Tarrant County, Texas",2190,427,115,54,2075,441
1400000US48439101201,48439101201,"Census Tract 1012.01, Tarrant County, Texas",1706,313,821,240,885,358
1400000US48439101202,48439101202,"Census Tract 1012.02, Tarrant County, Texas",4335,448,1098,283,3237,511
1400000US48439101301,48439101301,"Census Tract 1013.01, Tarrant County, Texas",4691,539,3162,394,1529,430
1400000US48439101302,48439101302,"Census Tract 1013.02, Tarrant County, Texas",2656,308,1777,271,879,211
1400000US48439101401,48439101401,"Census Tract 1014.01, Tarrant County, Texas",4581,439,3042,409,1539,428
1400000US48439101402,48439101402,"Census Tract 1014.02, Tarrant County, Texas",3534,538,1284,326,2250,571
1400000US48439101403,48439101403,"Census Tract 1014.03, Tarrant County, Texas",4538,539,2543,431,1995,408
1400000US48439101500,48439101500,"Census Tract 1015, Tarrant County, Texas",4834,677,2318,407,2516,740
1400000US48439101700,48439101700,"Census Tract 1017, Tarrant County, Texas",2685,471,2006,350,679,263
1400000US48439102000,48439102000,"Census Tract 1020, Tarrant County, Texas",1367,204,810,191,557,238
1400000US48439102100,48439102100,"Census Tract 1021, Tarrant County, Texas",4912,419,4102,453,810,302
1400000US48439102201,48439102201,"Census Tract 1022.01, Tarrant County, Texas",3451,276,2643,215,808,256
1400000US48439102202,48439102202,"Census Tract 1022.02, Tarrant County, Texas",2608,218,2535,219,73,55
1400000US48439102301,48439102301,"Census Tract 1023.01, Tarrant County, Texas",2869,334,1655,237,1214,247
1400000US48439102302,48439102302,"Census Tract 1023.02, Tarrant County, Texas",4944,436,2823,311,2121,366
1400000US48439102401,48439102401,"Census Tract 1024.01, Tarrant County, Texas",4041,347,3394,354,647,354
1400000US48439102402,48439102402,"Census Tract 1024.02, Tarrant County, Texas",4329,369,4054,353,275,130
1400000US48439102500,48439102500,"Census Tract 1025, Tarrant County, Texas",3100,480,2372,392,728,290
1400000US48439102601,48439102601,"Census Tract 1026.01, Tarrant County, Texas",3478,327,1964,324,1514,301
1400000US48439102602,48439102602,"Census Tract 1026.02, Tarrant County, Texas",3738,421,1975,257,1763,451
1400000US48439102700,48439102700,"Census Tract 1027, Tarrant County, Texas",3463,395,2774,274,689,286
1400000US48439102800,48439102800,"Census Tract 1028, Tarrant County, Texas",1430,205,1316,198,114,94
1400000US48439103500,48439103500,"Census Tract 1035, Tarrant County, Texas",5064,484,1593,264,3471,439
1400000US48439103601,48439103601,"Census Tract 1036.01, Tarrant County, Texas",2654,404,1785,412,869,314
1400000US48439103602,48439103602,"Census Tract 1036.02, Tarrant County, Texas",2210,306,1776,278,434,242
1400000US48439103701,48439103701,"Census Tract 1037.01, Tarrant County, Texas",4393,594,1431,448,2962,750
1400000US48439103702,48439103702,"Census Tract 1037.02, Tarrant County, Texas",3216,376,1491,322,1725,443
1400000US48439103800,48439103800,"Census Tract 1038, Tarrant County, Texas",3212,551,2311,477,901,239
1400000US48439104100,48439104100,"Census Tract 1041, Tarrant County, Texas",3446,370,1804,255,1642,334
1400000US48439104201,48439104201,"Census Tract 1042.01, Tarrant County, Texas",5896,696,5388,633,508,149
1400000US48439104202,48439104202,"Census Tract 1042.02, Tarrant County, Texas",3318,267,2746,272,572,168
1400000US48439104300,48439104300,"Census Tract 1043, Tarrant County, Texas",5515,607,4428,615,1087,348
1400000US48439104400,48439104400,"Census Tract 1044, Tarrant County, Texas",5918,755,2473,431,3445,743
1400000US48439104502,48439104502,"Census Tract 1045.02, Tarrant County, Texas",3352,384,577,183,2775,357
1400000US48439104503,48439104503,"Census Tract 1045.03, Tarrant County, Texas",2320,270,41,30,2279,271
1400000US48439104504,48439104504,"Census Tract 1045.04, Tarrant County, Texas",2879,394,547,92,2332,417
1400000US48439104505,48439104505,"Census Tract 1045.05, Tarrant County, Texas",3314,443,2038,437,1276,317
1400000US48439104601,48439104601,"Census Tract 1046.01, Tarrant County, Texas",3818,525,1816,429,2002,468
1400000US48439104602,48439104602,"Census Tract 1046.02, Tarrant County, Texas",4944,686,1354,414,3590,682
1400000US48439104603,48439104603,"Census Tract 1046.03, Tarrant County, Texas",3817,479,1113,299,2704,392
1400000US48439104604,48439104604,"Census Tract 1046.04, Tarrant County, Texas",2647,449,1640,241,1007,426
1400000US48439104605,48439104605,"Census Tract 1046.05, Tarrant County, Texas",3982,473,2546,331,1436,448
1400000US48439104701,48439104701,"Census Tract 1047.01, Tarrant County, Texas",4502,472,282,86,4220,468
1400000US48439104702,48439104702,"Census Tract 1047.02, Tarrant County, Texas",3608,668,285,181,3323,729
1400000US48439104802,48439104802,"Census Tract 1048.02, Tarrant County, Texas",5419,535,1761,380,3658,440
1400000US48439104803,48439104803,"Census Tract 1048.03, Tarrant County, Texas",6841,644,1399,335,5442,696
1400000US48439104804,48439104804,"Census Tract 1048.04, Tarrant County, Texas",3272,383,794,227,2478,429
1400000US48439104900,48439104900,"Census Tract 1049, Tarrant County, Texas",3238,324,1065,180,2173,392
1400000US48439105001,48439105001,"Census Tract 1050.01, Tarrant County, Texas",5957,661,905,315,5052,667
1400000US48439105006,48439105006,"Census Tract 1050.06, Tarrant County, Texas",1751,379,1146,309,605,225
1400000US48439105007,48439105007,"Census Tract 1050.07, Tarrant County, Texas",4501,429,3805,343,696,340
1400000US48439105008,48439105008,"Census Tract 1050.08, Tarrant County, Texas",7627,725,5899,756,1728,353
1400000US48439105201,48439105201,"Census Tract 1052.01, Tarrant County, Texas",5587,840,2697,535,2890,815
1400000US48439105203,48439105203,"Census Tract 1052.03, Tarrant County, Texas",2333,180,1765,153,568,199
1400000US48439105204,48439105204,"Census Tract 1052.04, Tarrant County, Texas",2900,327,1928,294,972,345
1400000US48439105205,48439105205,"Census Tract 1052.05, Tarrant County, Texas",4990,642,4369,573,621,379
1400000US48439105403,48439105403,"Census Tract 1054.03, Tarrant County, Texas",5629,468,5024,456,605,220
1400000US48439105404,48439105404,"Census Tract 1054.04, Tarrant County, Texas",3972,361,3872,395,100,74
1400000US48439105405,48439105405,"Census Tract 1054.05, Tarrant County, Texas",3597,364,3319,349,278,187
1400000US48439105406,48439105406,"Census Tract 1054.06, Tarrant County, Texas",5478,550,4922,603,556,224
1400000US48439105502,48439105502,"Census Tract 1055.02, Tarrant County, Texas",5822,649,4626,573,1196,373
1400000US48439105503,48439105503,"Census Tract 1055.03, Tarrant County, Texas",5424,485,4683,474,741,470
1400000US48439105505,48439105505,"Census Tract 1055.05, Tarrant County, Texas",4690,423,3567,453,1123,333
1400000US48439105507,48439105507,"Census Tract 1055.07, Tarrant County, Texas",6794,412,6465,391,329,167
1400000US48439105508,48439105508,"Census Tract 1055.08, Tarrant County, Texas",6350,525,5810,540,540,299
1400000US48439105510,48439105510,"Census Tract 1055.10, Tarrant County, Texas",7732,539,6146,537,1586,370
1400000US48439105511,48439105511,"Census Tract 1055.11, Tarrant County, Texas",5820,803,4184,767,1636,439
1400000US48439105512,48439105512,"Census Tract 1055.12, Tarrant County, Texas",4106,329,3516,317,590,142
1400000US48439105513,48439105513,"Census Tract 1055.13, Tarrant County, Texas",3011,288,2348,293,663,274
1400000US48439105514,48439105514,"Census Tract 1055.14, Tarrant County, Texas",2538,285,1797,306,741,269
1400000US48439105600,48439105600,"Census Tract 1056, Tarrant County, Texas",4866,365,2466,289,2400,311
1400000US48439105701,48439105701,"Census Tract 1057.01, Tarrant County, Texas",3446,353,2096,275,1350,301
1400000US48439105703,48439105703,"Census Tract 1057.03, Tarrant County, Texas",3268,292,2083,222,1185,303
1400000US48439105704,48439105704,"Census Tract 1057.04, Tarrant County, Texas",9295,1182,4997,949,4298,1067
1400000US48439105800,48439105800,"Census Tract 1058, Tarrant County, Texas",4430,421,1225,242,3205,399
1400000US48439105901,48439105901,"Census Tract 1059.01, Tarrant County, Texas",3492,383,636,316,2856,386
1400000US48439105902,48439105902,"Census Tract 1059.02, Tarrant County, Texas",6323,842,3837,737,2486,513
1400000US48439106001,48439106001,"Census Tract 1060.01, Tarrant County, Texas",7670,692,4563,665,3107,562
1400000US48439106002,48439106002,"Census Tract 1060.02, Tarrant County, Texas",3782,634,2432,556,1350,423
1400000US48439106004,48439106004,"Census Tract 1060.04, Tarrant County, Texas",5217,459,3764,452,1453,311
1400000US48439106101,48439106101,"Census Tract 1061.01, Tarrant County, Texas",1505,240,852,250,653,162
1400000US48439106102,48439106102,"Census Tract 1061.02, Tarrant County, Texas",3448,519,2014,385,1434,395
1400000US48439106201,48439106201,"Census Tract 1062.01, Tarrant County, Texas",3296,436,3104,453,192,161
1400000US48439106202,48439106202,"Census Tract 1062.02, Tarrant County, Texas",4503,609,3626,487,877,370
1400000US48439106300,48439106300,"Census Tract 1063, Tarrant County, Texas",3084,460,2161,337,923,354
1400000US48439106400,48439106400,"Census Tract 1064, Tarrant County, Texas",2590,404,1697,309,893,262
1400000US48439106502,48439106502,"Census Tract 1065.02, Tarrant County, Texas",2686,306,2088,296,598,262
1400000US48439106503,48439106503,"Census Tract 1065.03, Tarrant County, Texas",5238,408,4274,431,964,415
1400000US48439106507,48439106507,"Census Tract 1065.07, Tarrant County, Texas",1724,204,1625,225,99,74
1400000US48439106509,48439106509,"Census Tract 1065.09, Tarrant County, Texas",4364,312,3664,300,700,239
1400000US48439106510,48439106510,"Census Tract 1065.10, Tarrant County, Texas",8417,367,7319,372,1098,287
1400000US48439106511,48439106511,"Census Tract 1065.11, Tarrant County, Texas",6835,706,5486,677,1349,411
1400000US48439106512,48439106512,"Census Tract 1065.12, Tarrant County, Texas",4539,463,3842,342,697,357
1400000US48439106513,48439106513,"Census Tract 1065.13, Tarrant County, Texas",3063,309,2804,387,259,230
1400000US48439106514,48439106514,"Census Tract 1065.14, Tarrant County, Texas",4878,535,3913,452,965,434
1400000US48439106515,48439106515,"Census Tract 1065.15, Tarrant County, Texas",3782,486,3247,436,535,217
1400000US48439106516,48439106516,"Census Tract 1065.16, Tarrant County, Texas",4844,652,3383,518,1461,529
1400000US48439106517,48439106517,"Census Tract 1065.17, Tarrant County, Texas",7880,625,6452,593,1428,447
1400000US48439106518,48439106518,"Census Tract 1065.18, Tarrant County, Texas",3136,369,2367,349,769,266
1400000US48439106600,48439106600,"Census Tract 1066, Tarrant County, Texas",2128,261,1309,255,819,289
1400000US48439106700,48439106700,"Census Tract 1067, Tarrant County, Texas",2412,181,1633,135,779,161
1400000US48439110101,48439110101,"Census Tract 1101.01, Tarrant County, Texas",6993,628,4991,527,2002,676
1400000US48439110102,48439110102,"Census Tract 1101.02, Tarrant County, Texas",4200,421,2402,296,1798,486
1400000US48439110202,48439110202,"Census Tract 1102.02, Tarrant County, Texas",4173,395,1950,265,2223,458
1400000US48439110203,48439110203,"Census Tract 1102.03, Tarrant County, Texas",7814,710,5636,559,2178,536
1400000US48439110204,48439110204,"Census Tract 1102.04, Tarrant County, Texas",6185,484,3799,368,2386,461
1400000US48439110301,48439110301,"Census Tract 1103.01, Tarrant County, Texas",4121,531,1863,253,2258,544
1400000US48439110302,48439110302,"Census Tract 1103.02, Tarrant County, Texas",5617,576,2449,520,3168,585
1400000US48439110401,48439110401,"Census Tract 1104.01, Tarrant County, Texas",4627,134,3658,302,969,256
1400000US48439110402,48439110402,"Census Tract 1104.02, Tarrant County, Texas",4680,41,2555,322,2125,320
1400000US48439110500,48439110500,"Census Tract 1105, Tarrant County, Texas",7606,97,3833,461,3773,461
1400000US48439110600,48439110600,"Census Tract 1106, Tarrant County, Texas",2465,32,1876,107,589,113
1400000US48439110701,48439110701,"Census Tract 1107.01, Tarrant County, Texas",6997,433,5174,447,1823,368
1400000US48439110703,48439110703,"Census Tract 1107.03, Tarrant County, Texas",4846,391,3454,314,1392,383
1400000US48439110704,48439110704,"Census Tract 1107.04, Tarrant County, Texas",4365,392,3137,450,1228,339
1400000US48439110805,48439110805,"Census Tract 1108.05, Tarrant County, Texas",5868,396,4747,397,1121,291
1400000US48439110806,48439110806,"Census Tract 1108.06, Tarrant County, Texas",4645,441,3791,408,854,311
1400000US48439110807,48439110807,"Census Tract 1108.07, Tarrant County, Texas",6043,591,4829,583,1214,493
1400000US48439110808,48439110808,"Census Tract 1108.08, Tarrant County, Texas",1827,282,1660,275,167,138
1400000US48439110809,48439110809,"Census Tract 1108.09, Tarrant County, Texas",2005,197,1740,265,265,169
1400000US48439110901,48439110901,"Census Tract 1109.01, Tarrant County, Texas",4358,256,3935,273,423,275
1400000US48439110903,48439110903,"Census Tract 1109.03, Tarrant County, Texas",1595,183,1498,180,97,51
1400000US48439110905,48439110905,"Census Tract 1109.05, Tarrant County, Texas",4601,342,4117,358,484,160
1400000US48439110906,48439110906,"Census Tract 1109.06, Tarrant County, Texas",4399,304,4039,347,360,118
1400000US48439110907,48439110907,"Census Tract 1109.07, Tarrant County, Texas",2859,158,2715,179,144,118
1400000US48439111003,48439111003,"Census Tract 1110.03, Tarrant County, Texas",2815,25,1964,258,851,261
1400000US48439111005,48439111005,"Census Tract 1110.05, Tarrant County, Texas",9119,655,6126,939,2993,803
1400000US48439111008,48439111008,"Census Tract 1110.08, Tarrant County, Texas",6318,565,4894,527,1424,372
1400000US48439111010,48439111010,"Census Tract 1110.10, Tarrant County, Texas",2921,263,2557,278,364,197
1400000US48439111011,48439111011,"Census Tract 1110.11, Tarrant County, Texas",8908,711,6741,751,2167,382
1400000US48439111012,48439111012,"Census Tract 1110.12, Tarrant County, Texas",8335,756,6795,700,1540,418
1400000US48439111013,48439111013,"Census Tract 1110.13, Tarrant County, Texas",8004,684,6523,646,1481,420
1400000US48439111015,48439111015,"Census Tract 1110.15, Tarrant County, Texas",2413,241,2210,245,203,141
1400000US48439111016,48439111016,"Census Tract 1110.16, Tarrant County, Texas",9108,447,7893,536,1215,456
1400000US48439111017,48439111017,"Census Tract 1110.17, Tarrant County, Texas",10866,647,9520,785,1346,486
1400000US48439111018,48439111018,"Census Tract 1110.18, Tarrant County, Texas",2153,257,2052,237,101,95
1400000US48439111102,48439111102,"Census Tract 1111.02, Tarrant County, Texas",5304,460,3405,363,1899,354
1400000US48439111103,48439111103,"Census Tract 1111.03, Tarrant County, Texas",3304,379,1610,352,1694,476
1400000US48439111104,48439111104,"Census Tract 1111.04, Tarrant County, Texas",2272,351,1742,265,530,317
1400000US48439111202,48439111202,"Census Tract 1112.02, Tarrant County, Texas",6104,46,3603,377,2501,372
1400000US48439111203,48439111203,"Census Tract 1112.03, Tarrant County, Texas",5489,363,4703,418,786,244
1400000US48439111204,48439111204,"Census Tract 1112.04, Tarrant County, Texas",5376,598,4374,405,1002,585
1400000US48439111301,48439111301,"Census Tract 1113.01, Tarrant County, Texas",9016,822,7681,739,1335,429
1400000US48439111304,48439111304,"Census Tract 1113.04, Tarrant County, Texas",7154,383,6430,464,724,235
1400000US48439111306,48439111306,"Census Tract 1113.06, Tarrant County, Texas",5107,376,3751,332,1356,276
1400000US48439111307,48439111307,"Census Tract 1113.07, Tarrant County, Texas",2903,295,2378,310,525,264
1400000US48439111308,48439111308,"Census Tract 1113.08, Tarrant County, Texas",1493,186,1280,134,213,213
1400000US48439111309,48439111309,"Census Tract 1113.09, Tarrant County, Texas",4300,397,2919,386,1381,278
1400000US48439111310,48439111310,"Census Tract 1113.10, Tarrant County, Texas",7711,366,5813,478,1898,408
1400000US48439111311,48439111311,"Census Tract 1113.11, Tarrant County, Texas",6533,413,5904,544,629,356
1400000US48439111312,48439111312,"Census Tract 1113.12, Tarrant County, Texas",3183,206,2893,297,290,224
1400000US48439111313,48439111313,"Census Tract 1113.13, Tarrant County, Texas",5219,422,4748,534,471,364
1400000US48439111314,48439111314,"Census Tract 1113.14, Tarrant County, Texas",4497,287,4098,343,399,132
1400000US48439111402,48439111402,"Census Tract 1114.02, Tarrant County, Texas",6209,363,5454,435,755,256
1400000US48439111404,48439111404,"Census Tract 1114.04, Tarrant County, Texas",8289,508,7795,520,494,248
1400000US48439111405,48439111405,"Census Tract 1114.05, Tarrant County, Texas",2066,311,1823,310,243,143
1400000US48439111406,48439111406,"Census Tract 1114.06, Tarrant County, Texas",3375,314,2903,317,472,114
1400000US48439111407,48439111407,"Census Tract 1114.07, Tarrant County, Texas",3378,213,3104,231,274,113
1400000US48439111408,48439111408,"Census Tract 1114.08, Tarrant County, Texas",2436,441,2044,323,392,354
1400000US48439111409,48439111409,"Census Tract 1114.09, Tarrant County, Texas",4589,300,4067,329,522,201
1400000US48439111505,48439111505,"Census Tract 1115.05, Tarrant County, Texas",3982,280,3354,302,628,142
1400000US48439111506,48439111506,"Census Tract 1115.06, Tarrant County, Texas",6046,380,5686,345,360,148
1400000US48439111513,48439111513,"Census Tract 1115.13, Tarrant County, Texas",4292,337,3073,286,1219,360
1400000US48439111514,48439111514,"Census Tract 1115.14, Tarrant County, Texas",6369,455,4122,427,2247,425
1400000US48439111516,48439111516,"Census Tract 1115.16, Tarrant County, Texas",5947,537,4583,576,1364,324
1400000US48439111521,48439111521,"Census Tract 1115.21, Tarrant County, Texas",8087,563,4907,487,3180,623
1400000US48439111522,48439111522,"Census Tract 1115.22, Tarrant County, Texas",7774,544,3577,531,4197,690
1400000US48439111523,48439111523,"Census Tract 1115.23, Tarrant County, Texas",9216,644,6492,890,2724,686
1400000US48439111524,48439111524,"Census Tract 1115.24, Tarrant County, Texas",7646,833,4562,647,3084,677
1400000US48439111525,48439111525,"Census Tract 1115.25, Tarrant County, Texas",6258,545,4059,476,2199,424
1400000US48439111526,48439111526,"Census Tract 1115.26, Tarrant County, Texas",4326,358,3296,352,1030,318
1400000US48439111529,48439111529,"Census Tract 1115.29, Tarrant County, Texas",4037,291,3566,314,471,142
1400000US48439111530,48439111530,"Census Tract 1115.30, Tarrant County, Texas",5918,401,5428,387,490,105
1400000US48439111531,48439111531,"Census Tract 1115.31, Tarrant County, Texas",4502,281,4151,344,351,162
1400000US48439111532,48439111532,"Census Tract 1115.32, Tarrant County, Texas",7434,524,6385,390,1049,526
1400000US48439111533,48439111533,"Census Tract 1115.33, Tarrant County, Texas",5032,349,4356,363,676,212
1400000US48439111534,48439111534,"Census Tract 1115.34, Tarrant County, Texas",5984,481,5108,440,876,287
1400000US48439111536,48439111536,"Census Tract 1115.36, Tarrant County, Texas",3528,439,2658,391,870,346
1400000US48439111537,48439111537,"Census Tract 1115.37, Tarrant County, Texas",7055,519,5448,429,1607,582
1400000US48439111538,48439111538,"Census Tract 1115.38, Tarrant County, Texas",5939,593,4107,662,1832,669
1400000US48439111539,48439111539,"Census Tract 1115.39, Tarrant County, Texas",8825,674,7040,655,1785,584
1400000US48439111540,48439111540,"Census Tract 1115.40, Tarrant County, Texas",6150,605,4812,616,1338,274
1400000US48439111541,48439111541,"Census Tract 1115.41, Tarrant County, Texas",4025,339,3131,342,894,227
1400000US48439111542,48439111542,"Census Tract 1115.42, Tarrant County, Texas",6036,598,4044,571,1992,336
1400000US48439111543,48439111543,"Census Tract 1115.43, Tarrant County, Texas",7046,540,5128,473,1918,431
1400000US48439111544,48439111544,"Census Tract 1115.44, Tarrant County, Texas",7337,727,5515,654,1822,365
1400000US48439111545,48439111545,"Census Tract 1115.45, Tarrant County, Texas",2618,219,2573,224,45,37
1400000US48439111546,48439111546,"Census Tract 1115.46, Tarrant County, Texas",6505,643,5008,463,1497,627
1400000US48439111547,48439111547,"Census Tract 1115.47, Tarrant County, Texas",16538,1080,12529,1228,4009,825
1400000US48439111548,48439111548,"Census Tract 1115.48, Tarrant County, Texas",7510,534,6558,653,952,489
1400000US48439111549,48439111549,"Census Tract 1115.49, Tarrant County, Texas",6584,589,5310,674,1274,492
1400000US48439111550,48439111550,"Census Tract 1115.50, Tarrant County, Texas",13639,969,10008,859,3631,817
1400000US48439111551,48439111551,"Census Tract 1115.51, Tarrant County, Texas",6843,531,6145,515,698,212
1400000US48439111552,48439111552,"Census Tract 1115.52, Tarrant County, Texas",3476,332,3108,300,368,124
1400000US48439111553,48439111553,"Census Tract 1115.53, Tarrant County, Texas",3424,436,2753,435,671,253
1400000US48439113001,48439113001,"Census Tract 1130.01, Tarrant County, Texas",3702,489,2787,297,915,424
1400000US48439113002,48439113002,"Census Tract 1130.02, Tarrant County, Texas",6270,601,3529,623,2741,580
1400000US48439113102,48439113102,"Census Tract 1131.02, Tarrant County, Texas",5307,513,4743,516,564,219
1400000US48439113104,48439113104,"Census Tract 1131.04, Tarrant County, Texas",3326,439,2725,348,601,296
1400000US48439113107,48439113107,"Census Tract 1131.07, Tarrant County, Texas",2428,202,2297,218,131,91
1400000US48439113108,48439113108,"Census Tract 1131.08, Tarrant County, Texas",4599,249,4345,247,254,154
1400000US48439113109,48439113109,"Census Tract 1131.09, Tarrant County, Texas",4018,351,3009,302,1009,350
1400000US48439113110,48439113110,"Census Tract 1131.10, Tarrant County, Texas",4520,510,3294,343,1226,457
1400000US48439113111,48439113111,"Census Tract 1131.11, Tarrant County, Texas",4141,606,2113,437,2028,599
1400000US48439113112,48439113112,"Census Tract 1131.12, Tarrant County, Texas",3010,494,2161,400,849,372
1400000US48439113113,48439113113,"Census Tract 1131.13, Tarrant County, Texas",3630,459,3187,448,443,247
1400000US48439113114,48439113114,"Census Tract 1131.14, Tarrant County, Texas",3849,620,3403,693,446,259
1400000US48439113115,48439113115,"Census Tract 1131.15, Tarrant County, Texas",3672,426,2210,407,1462,435
1400000US48439113116,48439113116,"Census Tract 1131.16, Tarrant County, Texas",4090,453,3440,471,650,273
1400000US48439113206,48439113206,"Census Tract 1132.06, Tarrant County, Texas",5868,759,4140,615,1728,746
1400000US48439113207,48439113207,"Census Tract 1132.07, Tarrant County, Texas",4214,228,3804,241,410,179
1400000US48439113210,48439113210,"Census Tract 1132.10, Tarrant County, Texas",7195,354,6477,392,718,245
1400000US48439113212,48439113212,"Census Tract 1132.12, Tarrant County, Texas",4122,399,3491,314,631,334
1400000US48439113213,48439113213,"Census Tract 1132.13, Tarrant County, Texas",3195,306,2680,270,515,270
1400000US48439113214,48439113214,"Census Tract 1132.14, Tarrant County, Texas",4422,301,3758,292,664,149
1400000US48439113215,48439113215,"Census Tract 1132.15, Tarrant County, Texas",4822,374,4035,294,787,349
1400000US48439113216,48439113216,"Census Tract 1132.16, Tarrant County, Texas",5292,413,4577,500,715,325
1400000US48439113217,48439113217,"Census Tract 1132.17, Tarrant County, Texas",4473,474,3748,379,725,379
1400000US48439113218,48439113218,"Census Tract 1132.18, Tarrant County, Texas",2438,159,2291,186,147,116
1400000US48439113220,48439113220,"Census Tract 1132.20, Tarrant County, Texas",5968,726,3614,505,2354,751
1400000US48439113221,48439113221,"Census Tract 1132.21, Tarrant County, Texas",4506,386,4178,383,328,239
1400000US48439113301,48439113301,"Census Tract 1133.01, Tarrant County, Texas",4020,249,3648,253,372,154
1400000US48439113302,48439113302,"Census Tract 1133.02, Tarrant County, Texas",4186,249,3333,308,853,213
1400000US48439113403,48439113403,"Census Tract 1134.03, Tarrant County, Texas",2496,268,2027,245,469,202
1400000US48439113404,48439113404,"Census Tract 1134.04, Tarrant County, Texas",5368,669,4229,600,1139,467
1400000US48439113405,48439113405,"Census Tract 1134.05, Tarrant County, Texas",5887,413,4977,429,910,366
1400000US48439113407,48439113407,"Census Tract 1134.07, Tarrant County, Texas",5979,622,2745,407,3234,643
1400000US48439113408,48439113408,"Census Tract 1134.08, Tarrant County, Texas",5362,317,4217,345,1145,345
1400000US48439113509,48439113509,"Census Tract 1135.09, Tarrant County, Texas",4658,438,3392,365,1266,414
1400000US48439113510,48439113510,"Census Tract 1135.10, Tarrant County, Texas",4185,390,3580,457,605,285
1400000US48439113511,48439113511,"Census Tract 1135.11, Tarrant County, Texas",3994,349,3310,386,684,263
1400000US48439113512,48439113512,"Census Tract 1135.12, Tarrant County, Texas",5796,522,5151,501,645,247
1400000US48439113513,48439113513,"Census Tract 1135.13, Tarrant County, Texas",5687,468,4358,399,1329,423
1400000US48439113514,48439113514,"Census Tract 1135.14, Tarrant County, Texas",5032,556,3390,467,1642,380
1400000US48439113516,48439113516,"Census Tract 1135.16, Tarrant County, Texas",3909,416,3236,333,673,450
1400000US48439113517,48439113517,"Census Tract 1135.17, Tarrant County, Texas",3672,329,2869,320,803,291
1400000US48439113518,48439113518,"Census Tract 1135.18, Tarrant County, Texas",5233,487,4406,499,827,221
1400000US48439113519,48439113519,"Census Tract 1135.19, Tarrant County, Texas",5801,421,5346,477,455,154
1400000US48439113520,48439113520,"Census Tract 1135.20, Tarrant County, Texas",4938,366,4190,353,748,261
1400000US48439113607,48439113607,"Census Tract 1136.07, Tarrant County, Texas",4610,361,3594,331,1016,331
1400000US48439113610,48439113610,"Census Tract 1136.10, Tarrant County, Texas",10855,550,10020,609,835,409
1400000US48439113611,48439113611,"Census Tract 1136.11, Tarrant County, Texas",4442,298,4169,345,273,151
1400000US48439113612,48439113612,"Census Tract 1136.12, Tarrant County, Texas",4342,212,4185,239,157,88
1400000US48439113613,48439113613,"Census Tract 1136.13, Tarrant County, Texas",3896,237,3772,234,124,78
1400000US48439113618,48439113618,"Census Tract 1136.18, Tarrant County, Texas",6032,355,5398,344,634,192
1400000US48439113619,48439113619,"Census Tract 1136.19, Tarrant County, Texas",4778,683,3448,512,1330,654
1400000US48439113622,48439113622,"Census Tract 1136.22, Tarrant County, Texas",5964,310,5495,363,469,207
1400000US48439113623,48439113623,"Census Tract 1136.23, Tarrant County, Texas",3774,264,3192,312,582,293
1400000US48439113624,48439113624,"Census Tract 1136.24, Tarrant County, Texas",4088,199,3574,220,514,168
1400000US48439113625,48439113625,"Census Tract 1136.25, Tarrant County, Texas",3231,190,3062,211,169,131
1400000US48439113626,48439113626,"Census Tract 1136.26, Tarrant County, Texas",4008,239,3720,252,288,151
1400000US48439113627,48439113627,"Census Tract 1136.27, Tarrant County, Texas",5382,418,4780,420,602,230
1400000US48439113628,48439113628,"Census Tract 1136.28, Tarrant County, Texas",4417,313,3720,315,697,229
1400000US48439113629,48439113629,"Census Tract 1136.29, Tarrant County, Texas",4155,312,3835,335,320,156
1400000US48439113630,48439113630,"Census Tract 1136.30, Tarrant County, Texas",3707,547,3409,558,298,183
1400000US48439113631,48439113631,"Census Tract 1136.31, Tarrant County, Texas",6621,619,3989,527,2632,775
1400000US48439113632,48439113632,"Census Tract 1136.32, Tarrant County, Texas",5163,261,4827,311,336,152
1400000US48439113633,48439113633,"Census Tract 1136.33, Tarrant County, Texas",4243,314,3931,324,312,149
1400000US48439113634,48439113634,"Census Tract 1136.34, Tarrant County, Texas",4833,346,4420,360,413,220
1400000US48439113703,48439113703,"Census Tract 1137.03, Tarrant County, Texas",9591,700,7233,540,2358,715
1400000US48439113705,48439113705,"Census Tract 1137.05, Tarrant County, Texas",5801,543,4573,601,1228,582
1400000US48439113707,48439113707,"Census Tract 1137.07, Tarrant County, Texas",4987,408,4635,419,352,147
1400000US48439113709,48439113709,"Census Tract 1137.09, Tarrant County, Texas",4768,255,4250,285,518,150
1400000US48439113710,48439113710,"Census Tract 1137.10, Tarrant County, Texas",3950,354,2660,380,1290,506
1400000US48439113711,48439113711,"Census Tract 1137.11, Tarrant County, Texas",3612,282,3300,293,312,113
1400000US48439113803,48439113803,"Census Tract 1138.03, Tarrant County, Texas",5487,342,4579,320,908,259
1400000US48439113808,48439113808,"Census Tract 1138.08, Tarrant County, Texas",6523,345,5342,421,1181,389
1400000US48439113809,48439113809,"Census Tract 1138.09, Tarrant County, Texas",5000,341,3756,347,1244,323
1400000US48439113810,48439113810,"Census Tract 1138.10, Tarrant County, Texas",4666,364,3298,450,1368,383
1400000US48439113811,48439113811,"Census Tract 1138.11, Tarrant County, Texas",3632,326,2887,291,745,306
1400000US48439113812,48439113812,"Census Tract 1138.12, Tarrant County, Texas",5967,520,5493,508,474,191
1400000US48439113813,48439113813,"Census Tract 1138.13, Tarrant County, Texas",5155,308,4724,317,431,194
1400000US48439113814,48439113814,"Census Tract 1138.14, Tarrant County, Texas",4282,338,3944,343,338,128
1400000US48439113815,48439113815,"Census Tract 1138.15, Tarrant County, Texas",5627,305,5361,331,266,137
1400000US48439113816,48439113816,"Census Tract 1138.16, Tarrant County, Texas",5095,261,4913,271,182,106
1400000US48439113906,48439113906,"Census Tract 1139.06, Tarrant County, Texas",6238,358,5680,385,558,237
1400000US48439113907,48439113907,"Census Tract 1139.07, Tarrant County, Texas",6341,346,6088,342,253,105
1400000US48439113908,48439113908,"Census Tract 1139.08, Tarrant County, Texas",5419,281,5226,325,193,136
1400000US48439113909,48439113909,"Census Tract 1139.09, Tarrant County, Texas",6710,289,6486,314,224,134
1400000US48439113910,48439113910,"Census Tract 1139.10, Tarrant County, Texas",7849,434,7568,438,281,162
1400000US48439113911,48439113911,"Census Tract 1139.11, Tarrant County, Texas",6967,384,6236,459,731,230
1400000US48439113912,48439113912,"Census Tract 1139.12, Tarrant County, Texas",5989,309,5622,329,367,147
1400000US48439113916,48439113916,"Census Tract 1139.16, Tarrant County, Texas",4267,495,3223,431,1044,434
1400000US48439113917,48439113917,"Census Tract 1139.17, Tarrant County, Texas",6201,711,4946,635,1255,404
1400000US48439113918,48439113918,"Census Tract 1139.18, Tarrant County, Texas",5154,638,4430,651,724,137
1400000US48439113919,48439113919,"Census Tract 1139.19, Tarrant County, Texas",7613,437,6651,481,962,187
1400000US48439113920,48439113920,"Census Tract 1139.20, Tarrant County, Texas",5258,326,4621,368,637,292
1400000US48439113921,48439113921,"Census Tract 1139.21, Tarrant County, Texas",18947,1271,16521,1194,2426,902
1400000US48439113922,48439113922,"Census Tract 1139.22, Tarrant County, Texas",18301,1006,15131,1082,3170,668
1400000US48439113923,48439113923,"Census Tract 1139.23, Tarrant County, Texas",3017,554,2491,552,526,98
1400000US48439113924,48439113924,"Census Tract 1139.24, Tarrant County, Texas",5058,344,3806,362,1252,249
1400000US48439113925,48439113925,"Census Tract 1139.25, Tarrant County, Texas",4112,479,3351,629,761,302
1400000US48439113926,48439113926,"Census Tract 1139.26, Tarrant County, Texas",12394,886,9713,891,2681,463
1400000US48439113927,48439113927,"Census Tract 1139.27, Tarrant County, Texas",11725,954,10502,940,1223,424
1400000US48439113928,48439113928,"Census Tract 1139.28, Tarrant County, Texas",8264,432,6727,371,1537,387
1400000US48439113929,48439113929,"Census Tract 1139.29, Tarrant County, Texas",8900,626,7866,604,1034,313
1400000US48439114003,48439114003,"Census Tract 1140.03, Tarrant County, Texas",7856,361,5210,357,2646,318
1400000US48439114005,48439114005,"Census Tract 1140.05, Tarrant County, Texas",6895,425,5529,508,1366,492
1400000US48439114006,48439114006,"Census Tract 1140.06, Tarrant County, Texas",6901,432,5344,417,1557,299
1400000US48439114007,48439114007,"Census Tract 1140.07, Tarrant County, Texas",12875,1175,9376,888,3499,777
1400000US48439114008,48439114008,"Census Tract 1140.08, Tarrant County, Texas",11717,889,8143,895,3574,585
1400000US48439114102,48439114102,"Census Tract 1141.02, Tarrant County, Texas",7523,593,7100,597,423,152
1400000US48439114103,48439114103,"Census Tract 1141.03, Tarrant County, Texas",19740,1004,16536,1280,3204,570
1400000US48439114104,48439114104,"Census Tract 1141.04, Tarrant County, Texas",6711,777,6070,775,641,368
1400000US48439114203,48439114203,"Census Tract 1142.03, Tarrant County, Texas",5128,447,4723,420,405,127
1400000US48439114204,48439114204,"Census Tract 1142.04, Tarrant County, Texas",6237,400,5558,374,679,392
1400000US48439114205,48439114205,"Census Tract 1142.05, Tarrant County, Texas",3191,385,2775,265,416,274
1400000US48439114206,48439114206,"Census Tract 1142.06, Tarrant County, Texas",4610,704,3908,712,702,391
1400000US48439114207,48439114207,"Census Tract 1142.07, Tarrant County, Texas",5843,423,4922,615,921,376
1400000US48439121601,48439121601,"Census Tract 1216.01, Tarrant County, Texas",7343,542,5839,588,1504,549
1400000US48439121604,48439121604,"Census Tract 1216.04, Tarrant County, Texas",5049,553,3697,495,1352,350
1400000US48439121605,48439121605,"Census Tract 1216.05, Tarrant County, Texas",2932,219,2467,222,465,201
1400000US48439121606,48439121606,"Census Tract 1216.06, Tarrant County, Texas",3402,188,3149,211,253,151
1400000US48439121608,48439121608,"Census Tract 1216.08, Tarrant County, Texas",5277,239,4886,256,391,108
1400000US48439121609,48439121609,"Census Tract 1216.09, Tarrant County, Texas",6245,494,5737,473,508,249
1400000US48439121610,48439121610,"Census Tract 1216.10, Tarrant County, Texas",2260,181,1964,200,296,195
1400000US48439121611,48439121611,"Census Tract 1216.11, Tarrant County, Texas",4808,352,4207,367,601,166
1400000US48439121702,48439121702,"Census Tract 1217.02, Tarrant County, Texas",1796,254,1177,224,619,123
1400000US48439121703,48439121703,"Census Tract 1217.03, Tarrant County, Texas",5686,548,2373,271,3313,514
1400000US48439121704,48439121704,"Census Tract 1217.04, Tarrant County, Texas",3512,565,1303,294,2209,578
1400000US48439121903,48439121903,"Census Tract 1219.03, Tarrant County, Texas",5983,756,1688,400,4295,739
1400000US48439121904,48439121904,"Census Tract 1219.04, Tarrant County, Texas",4994,669,2514,635,2480,783
1400000US48439121905,48439121905,"Census Tract 1219.05, Tarrant County, Texas",5795,735,3191,553,2604,651
1400000US48439121906,48439121906,"Census Tract 1219.06, Tarrant County, Texas",3781,562,1300,239,2481,520
1400000US48439122001,48439122001,"Census Tract 1220.01, Tarrant County, Texas",4217,485,1915,379,2302,491
1400000US48439122002,48439122002,"Census Tract 1220.02, Tarrant County, Texas",4364,660,1176,270,3188,654
1400000US48439122100,48439122100,"Census Tract 1221, Tarrant County, Texas",5756,1079,2672,465,3084,1114
1400000US48439122200,48439122200,"Census Tract 1222, Tarrant County, Texas",2005,353,811,169,1194,388
1400000US48439122300,48439122300,"Census Tract 1223, Tarrant County, Texas",3968,480,3145,487,823,267
1400000US48439122400,48439122400,"Census Tract 1224, Tarrant County, Texas",5706,523,3993,388,1713,491
1400000US48439122500,48439122500,"Census Tract 1225, Tarrant County, Texas",4337,435,3820,468,517,253
1400000US48439122600,48439122600,"Census Tract 1226, Tarrant County, Texas",3929,227,3684,246,245,119
1400000US48439122700,48439122700,"Census Tract 1227, Tarrant County, Texas",4871,610,4288,543,583,239
1400000US48439122801,48439122801,"Census Tract 1228.01, Tarrant County, Texas",3603,604,1855,431,1748,623
1400000US48439122802,48439122802,"Census Tract 1228.02, Tarrant County, Texas",3954,592,2051,400,1903,468
1400000US48439122900,48439122900,"Census Tract 1229, Tarrant County, Texas",7130,844,2475,843,4655,772
1400000US48439123000,48439123000,"Census Tract 1230, Tarrant County, Texas",6063,670,4335,453,1728,655
1400000US48439123100,48439123100,"Census Tract 1231, Tarrant County, Texas",2252,311,1499,226,753,225
1400000US48439123200,48439123200,"Census Tract 1232, Tarrant County, Texas",2228,251,1393,204,835,190
1400000US48439123300,48439123300,"Census Tract 1233, Tarrant County, Texas",4283,241,3779,231,504,114
1400000US48439123400,48439123400,"Census Tract 1234, Tarrant County, Texas",2338,316,1343,217,995,306
1400000US48439123500,48439123500,"Census Tract 1235, Tarrant County, Texas",2330,358,1433,301,897,233
1400000US48439123600,48439123600,"Census Tract 1236, Tarrant County, Texas",2574,358,1149,207,1425,405
1400000US48439980000,48439980000,"Census Tract 9800, Tarrant County, Texas",0,13,0,13,0,13
1400000US48441010100,48441010100,"Census Tract 101, Taylor County, Texas",6778,680,5993,605,785,320
1400000US48441010200,48441010200,"Census Tract 102, Taylor County, Texas",2721,394,1817,325,904,293
1400000US48441010300,48441010300,"Census Tract 103, Taylor County, Texas",2172,279,1524,255,648,210
1400000US48441010400,48441010400,"Census Tract 104, Taylor County, Texas",2022,230,581,135,1441,203
1400000US48441010500,48441010500,"Census Tract 105, Taylor County, Texas",3276,403,2022,294,1254,354
1400000US48441010600,48441010600,"Census Tract 106, Taylor County, Texas",4098,330,2843,248,1255,307
1400000US48441010700,48441010700,"Census Tract 107, Taylor County, Texas",3467,438,1458,399,2009,439
1400000US48441010800,48441010800,"Census Tract 108, Taylor County, Texas",1981,283,1080,296,901,262
1400000US48441010900,48441010900,"Census Tract 109, Taylor County, Texas",6122,627,5333,575,789,298
1400000US48441011000,48441011000,"Census Tract 110, Taylor County, Texas",1236,297,826,162,410,289
1400000US48441011200,48441011200,"Census Tract 112, Taylor County, Texas",2754,421,1817,329,937,404
1400000US48441011300,48441011300,"Census Tract 113, Taylor County, Texas",3411,387,2339,342,1072,226
1400000US48441011400,48441011400,"Census Tract 114, Taylor County, Texas",4200,541,3439,473,761,326
1400000US48441011500,48441011500,"Census Tract 115, Taylor County, Texas",3251,405,2554,348,697,163
1400000US48441011600,48441011600,"Census Tract 116, Taylor County, Texas",3018,348,2250,299,768,282
1400000US48441011700,48441011700,"Census Tract 117, Taylor County, Texas",2341,299,1654,293,687,169
1400000US48441011900,48441011900,"Census Tract 119, Taylor County, Texas",2114,310,992,252,1122,260
1400000US48441012000,48441012000,"Census Tract 120, Taylor County, Texas",2099,158,1983,196,116,106
1400000US48441012100,48441012100,"Census Tract 121, Taylor County, Texas",528,312,412,271,116,61
1400000US48441012200,48441012200,"Census Tract 122, Taylor County, Texas",2461,229,1797,154,664,140
1400000US48441012300,48441012300,"Census Tract 123, Taylor County, Texas",3960,383,2844,390,1116,322
1400000US48441012400,48441012400,"Census Tract 124, Taylor County, Texas",2503,314,1964,301,539,206
1400000US48441012500,48441012500,"Census Tract 125, Taylor County, Texas",2967,322,2419,318,548,252
1400000US48441012600,48441012600,"Census Tract 126, Taylor County, Texas",2922,234,2769,208,153,132
1400000US48441012700,48441012700,"Census Tract 127, Taylor County, Texas",7123,438,6694,443,429,135
1400000US48441012801,48441012801,"Census Tract 128.01, Taylor County, Texas",3570,406,2926,414,644,300
1400000US48441012802,48441012802,"Census Tract 128.02, Taylor County, Texas",4578,505,3928,536,650,259
1400000US48441012900,48441012900,"Census Tract 129, Taylor County, Texas",2057,212,1366,258,691,200
1400000US48441013000,48441013000,"Census Tract 130, Taylor County, Texas",843,177,744,161,99,76
1400000US48441013100,48441013100,"Census Tract 131, Taylor County, Texas",6075,647,3842,521,2233,681
1400000US48441013200,48441013200,"Census Tract 132, Taylor County, Texas",1872,196,1578,213,294,138
1400000US48441013300,48441013300,"Census Tract 133, Taylor County, Texas",2625,313,2203,325,422,91
1400000US48441013401,48441013401,"Census Tract 134.01, Taylor County, Texas",3543,250,2678,344,865,318
1400000US48441013402,48441013402,"Census Tract 134.02, Taylor County, Texas",6749,515,5993,569,756,290
1400000US48441013404,48441013404,"Census Tract 134.04, Taylor County, Texas",7514,682,6449,610,1065,335
1400000US48441013500,48441013500,"Census Tract 135, Taylor County, Texas",7436,539,7030,539,406,138
1400000US48441013600,48441013600,"Census Tract 136, Taylor County, Texas",5038,514,4134,482,904,304
1400000US48441980000,48441980000,"Census Tract 9800, Taylor County, Texas",0,13,0,13,0,13
1400000US48443950100,48443950100,"Census Tract 9501, Terrell County, Texas",1001,204,385,113,616,174
1400000US48445950100,48445950100,"Census Tract 9501, Terry County, Texas",2623,180,1779,253,844,190
1400000US48445950300,48445950300,"Census Tract 9503, Terry County, Texas",2498,328,1005,248,1493,269
1400000US48445950400,48445950400,"Census Tract 9504, Terry County, Texas",7440,355,3550,301,3890,292
1400000US48447950300,48447950300,"Census Tract 9503, Throckmorton County, Texas",1626,136,1524,131,102,48
1400000US48449950100,48449950100,"Census Tract 9501, Titus County, Texas",2384,294,1971,223,413,193
1400000US48449950200,48449950200,"Census Tract 9502, Titus County, Texas",2778,300,1792,272,986,233
1400000US48449950300,48449950300,"Census Tract 9503, Titus County, Texas",8398,675,5297,440,3101,560
1400000US48449950400,48449950400,"Census Tract 9504, Titus County, Texas",5637,485,4562,381,1075,420
1400000US48449950500,48449950500,"Census Tract 9505, Titus County, Texas",2763,314,1046,294,1717,277
1400000US48449950600,48449950600,"Census Tract 9506, Titus County, Texas",4386,399,1824,240,2562,356
1400000US48449950700,48449950700,"Census Tract 9507, Titus County, Texas",1473,201,713,162,760,162
1400000US48449950800,48449950800,"Census Tract 9508, Titus County, Texas",4226,410,2188,339,2038,446
1400000US48451000100,48451000100,"Census Tract 1, Tom Green County, Texas",2387,253,1599,236,788,242
1400000US48451000200,48451000200,"Census Tract 2, Tom Green County, Texas",4201,524,1928,320,2273,473
1400000US48451000300,48451000300,"Census Tract 3, Tom Green County, Texas",5641,584,3137,442,2504,472
1400000US48451000400,48451000400,"Census Tract 4, Tom Green County, Texas",5993,598,1565,324,4428,629
1400000US48451000700,48451000700,"Census Tract 7, Tom Green County, Texas",4560,428,1357,198,3203,437
1400000US48451000801,48451000801,"Census Tract 8.01, Tom Green County, Texas",4145,506,2376,330,1769,443
1400000US48451000802,48451000802,"Census Tract 8.02, Tom Green County, Texas",4254,398,1820,349,2434,379
1400000US48451000900,48451000900,"Census Tract 9, Tom Green County, Texas",2657,468,840,153,1817,474
1400000US48451001000,48451001000,"Census Tract 10, Tom Green County, Texas",5176,463,4063,456,1113,361
1400000US48451001101,48451001101,"Census Tract 11.01, Tom Green County, Texas",4999,452,3457,416,1542,367
1400000US48451001102,48451001102,"Census Tract 11.02, Tom Green County, Texas",4808,366,2561,317,2247,334
1400000US48451001200,48451001200,"Census Tract 12, Tom Green County, Texas",7531,521,3600,516,3931,597
1400000US48451001301,48451001301,"Census Tract 13.01, Tom Green County, Texas",7104,697,5663,631,1441,248
1400000US48451001303,48451001303,"Census Tract 13.03, Tom Green County, Texas",3939,313,3042,254,897,262
1400000US48451001304,48451001304,"Census Tract 13.04, Tom Green County, Texas",2928,362,2385,366,543,225
1400000US48451001400,48451001400,"Census Tract 14, Tom Green County, Texas",4540,653,2360,479,2180,482
1400000US48451001500,48451001500,"Census Tract 15, Tom Green County, Texas",2954,570,2511,476,443,219
1400000US48451001600,48451001600,"Census Tract 16, Tom Green County, Texas",4701,402,3907,400,794,229
1400000US48451001702,48451001702,"Census Tract 17.02, Tom Green County, Texas",2969,359,2402,351,567,155
1400000US48451001704,48451001704,"Census Tract 17.04, Tom Green County, Texas",7951,557,6752,624,1199,387
1400000US48451001706,48451001706,"Census Tract 17.06, Tom Green County, Texas",3622,400,2879,333,743,316
1400000US48451001707,48451001707,"Census Tract 17.07, Tom Green County, Texas",5080,326,4363,329,717,312
1400000US48451001708,48451001708,"Census Tract 17.08, Tom Green County, Texas",5689,469,5028,542,661,350
1400000US48451001800,48451001800,"Census Tract 18, Tom Green County, Texas",2605,329,1210,220,1395,275
1400000US48451980000,48451980000,"Census Tract 9800, Tom Green County, Texas",0,13,0,13,0,13
1400000US48453000101,48453000101,"Census Tract 1.01, Travis County, Texas",3678,358,3320,340,358,169
1400000US48453000102,48453000102,"Census Tract 1.02, Travis County, Texas",2452,135,2333,155,119,86
1400000US48453000203,48453000203,"Census Tract 2.03, Travis County, Texas",1541,221,1334,198,207,116
1400000US48453000204,48453000204,"Census Tract 2.04, Travis County, Texas",2975,246,2779,258,196,99
1400000US48453000205,48453000205,"Census Tract 2.05, Travis County, Texas",3379,525,2975,467,404,179
1400000US48453000206,48453000206,"Census Tract 2.06, Travis County, Texas",3216,283,2862,363,354,215
1400000US48453000302,48453000302,"Census Tract 3.02, Travis County, Texas",5374,568,4597,522,777,423
1400000US48453000304,48453000304,"Census Tract 3.04, Travis County, Texas",3208,440,2725,474,483,285
1400000US48453000305,48453000305,"Census Tract 3.05, Travis County, Texas",3279,311,2935,372,344,146
1400000US48453000306,48453000306,"Census Tract 3.06, Travis County, Texas",2223,292,1495,247,728,297
1400000US48453000307,48453000307,"Census Tract 3.07, Travis County, Texas",1726,243,1253,163,473,247
1400000US48453000401,48453000401,"Census Tract 4.01, Travis County, Texas",3213,248,2714,273,499,143
1400000US48453000402,48453000402,"Census Tract 4.02, Travis County, Texas",2706,309,2239,318,467,193
1400000US48453000500,48453000500,"Census Tract 5, Travis County, Texas",4666,502,3980,502,686,200
1400000US48453000601,48453000601,"Census Tract 6.01, Travis County, Texas",9310,956,7280,780,2030,405
1400000US48453000603,48453000603,"Census Tract 6.03, Travis County, Texas",7715,797,6384,774,1331,255
1400000US48453000604,48453000604,"Census Tract 6.04, Travis County, Texas",5468,663,4937,635,531,168
1400000US48453000700,48453000700,"Census Tract 7, Travis County, Texas",1241,164,1034,178,207,112
1400000US48453000801,48453000801,"Census Tract 8.01, Travis County, Texas",1496,236,405,139,1091,225
1400000US48453000802,48453000802,"Census Tract 8.02, Travis County, Texas",3397,421,1911,385,1486,483
1400000US48453000803,48453000803,"Census Tract 8.03, Travis County, Texas",2162,238,1628,201,534,192
1400000US48453000804,48453000804,"Census Tract 8.04, Travis County, Texas",2397,284,1305,196,1092,257
1400000US48453000901,48453000901,"Census Tract 9.01, Travis County, Texas",1984,185,1168,151,816,130
1400000US48453000902,48453000902,"Census Tract 9.02, Travis County, Texas",5328,602,1292,334,4036,676
1400000US48453001000,48453001000,"Census Tract 10, Travis County, Texas",3577,370,1215,249,2362,352
1400000US48453001100,48453001100,"Census Tract 11, Travis County, Texas",4302,531,3759,547,543,217
1400000US48453001200,48453001200,"Census Tract 12, Travis County, Texas",4232,436,3776,325,456,244
1400000US48453001303,48453001303,"Census Tract 13.03, Travis County, Texas",2503,232,2232,227,271,132
1400000US48453001304,48453001304,"Census Tract 13.04, Travis County, Texas",3681,197,3155,207,526,167
1400000US48453001305,48453001305,"Census Tract 13.05, Travis County, Texas",5599,529,3467,345,2132,507
1400000US48453001307,48453001307,"Census Tract 13.07, Travis County, Texas",3578,335,2461,314,1117,313
1400000US48453001308,48453001308,"Census Tract 13.08, Travis County, Texas",2789,385,1472,243,1317,377
1400000US48453001401,48453001401,"Census Tract 14.01, Travis County, Texas",2984,300,2718,287,266,126
1400000US48453001402,48453001402,"Census Tract 14.02, Travis County, Texas",2721,264,2118,243,603,265
1400000US48453001403,48453001403,"Census Tract 14.03, Travis County, Texas",1309,182,844,137,465,170
1400000US48453001501,48453001501,"Census Tract 15.01, Travis County, Texas",4688,270,4020,342,668,204
1400000US48453001503,48453001503,"Census Tract 15.03, Travis County, Texas",3858,322,2675,275,1183,288
1400000US48453001504,48453001504,"Census Tract 15.04, Travis County, Texas",4808,364,4094,343,714,222
1400000US48453001505,48453001505,"Census Tract 15.05, Travis County, Texas",4454,230,3471,279,983,244
1400000US48453001602,48453001602,"Census Tract 16.02, Travis County, Texas",3110,339,2697,357,413,200
1400000US48453001603,48453001603,"Census Tract 16.03, Travis County, Texas",4579,309,4351,351,228,135
1400000US48453001604,48453001604,"Census Tract 16.04, Travis County, Texas",3876,209,3682,216,194,110
1400000US48453001605,48453001605,"Census Tract 16.05, Travis County, Texas",3652,415,3179,334,473,340
1400000US48453001606,48453001606,"Census Tract 16.06, Travis County, Texas",434,401,350,332,84,95
1400000US48453001705,48453001705,"Census Tract 17.05, Travis County, Texas",4487,253,4114,269,373,212
1400000US48453001706,48453001706,"Census Tract 17.06, Travis County, Texas",3564,199,3268,224,296,94
1400000US48453001707,48453001707,"Census Tract 17.07, Travis County, Texas",4715,337,4162,388,553,210
1400000US48453001712,48453001712,"Census Tract 17.12, Travis County, Texas",3942,305,2678,299,1264,328
1400000US48453001713,48453001713,"Census Tract 17.13, Travis County, Texas",3839,278,3001,250,838,223
1400000US48453001714,48453001714,"Census Tract 17.14, Travis County, Texas",11774,662,10144,567,1630,482
1400000US48453001716,48453001716,"Census Tract 17.16, Travis County, Texas",4783,330,4172,326,611,232
1400000US48453001718,48453001718,"Census Tract 17.18, Travis County, Texas",5447,328,5085,341,362,177
1400000US48453001719,48453001719,"Census Tract 17.19, Travis County, Texas",3745,263,3320,252,425,166
1400000US48453001722,48453001722,"Census Tract 17.22, Travis County, Texas",3943,295,3443,288,500,157
1400000US48453001728,48453001728,"Census Tract 17.28, Travis County, Texas",6797,446,5015,402,1782,416
1400000US48453001729,48453001729,"Census Tract 17.29, Travis County, Texas",4728,361,3333,416,1395,299
1400000US48453001733,48453001733,"Census Tract 17.33, Travis County, Texas",3580,342,3060,331,520,321
1400000US48453001737,48453001737,"Census Tract 17.37, Travis County, Texas",10401,354,8664,423,1737,422
1400000US48453001738,48453001738,"Census Tract 17.38, Travis County, Texas",6685,447,5597,469,1088,276
1400000US48453001740,48453001740,"Census Tract 17.40, Travis County, Texas",4370,322,3238,360,1132,264
1400000US48453001741,48453001741,"Census Tract 17.41, Travis County, Texas",3725,432,2938,356,787,356
1400000US48453001742,48453001742,"Census Tract 17.42, Travis County, Texas",5977,676,3911,468,2066,706
1400000US48453001745,48453001745,"Census Tract 17.45, Travis County, Texas",2540,294,2291,349,249,138
1400000US48453001746,48453001746,"Census Tract 17.46, Travis County, Texas",4061,300,2785,250,1276,358
1400000US48453001747,48453001747,"Census Tract 17.47, Travis County, Texas",5376,326,3451,260,1925,285
1400000US48453001748,48453001748,"Census Tract 17.48, Travis County, Texas",5545,451,3921,380,1624,324
1400000US48453001749,48453001749,"Census Tract 17.49, Travis County, Texas",5710,541,4841,511,869,333
1400000US48453001750,48453001750,"Census Tract 17.50, Travis County, Texas",4919,392,3626,314,1293,396
1400000US48453001751,48453001751,"Census Tract 17.51, Travis County, Texas",1946,221,1830,220,116,74
1400000US48453001752,48453001752,"Census Tract 17.52, Travis County, Texas",3834,416,3304,394,530,195
1400000US48453001753,48453001753,"Census Tract 17.53, Travis County, Texas",1131,100,887,92,244,73
1400000US48453001754,48453001754,"Census Tract 17.54, Travis County, Texas",4542,391,3566,462,976,311
1400000US48453001755,48453001755,"Census Tract 17.55, Travis County, Texas",5833,258,5548,254,285,155
1400000US48453001756,48453001756,"Census Tract 17.56, Travis County, Texas",4025,317,3754,302,271,156
1400000US48453001757,48453001757,"Census Tract 17.57, Travis County, Texas",1901,144,1779,158,122,82
1400000US48453001760,48453001760,"Census Tract 17.60, Travis County, Texas",15069,1057,13745,1078,1324,341
1400000US48453001761,48453001761,"Census Tract 17.61, Travis County, Texas",6822,375,6388,371,434,210
1400000US48453001764,48453001764,"Census Tract 17.64, Travis County, Texas",5591,481,5080,455,511,200
1400000US48453001765,48453001765,"Census Tract 17.65, Travis County, Texas",13069,758,11438,764,1631,518
1400000US48453001766,48453001766,"Census Tract 17.66, Travis County, Texas",7465,679,6207,643,1258,387
1400000US48453001768,48453001768,"Census Tract 17.68, Travis County, Texas",5547,442,5073,431,474,211
1400000US48453001769,48453001769,"Census Tract 17.69, Travis County, Texas",5262,330,4214,434,1048,388
1400000US48453001770,48453001770,"Census Tract 17.70, Travis County, Texas",11505,500,9908,589,1597,507
1400000US48453001771,48453001771,"Census Tract 17.71, Travis County, Texas",3993,333,3655,383,338,191
1400000US48453001772,48453001772,"Census Tract 17.72, Travis County, Texas",2821,350,1806,296,1015,313
1400000US48453001773,48453001773,"Census Tract 17.73, Travis County, Texas",5811,335,5284,359,527,220
1400000US48453001774,48453001774,"Census Tract 17.74, Travis County, Texas",7953,556,5873,491,2080,450
1400000US48453001775,48453001775,"Census Tract 17.75, Travis County, Texas",4944,346,4240,339,704,181
1400000US48453001776,48453001776,"Census Tract 17.76, Travis County, Texas",2468,300,1970,224,498,208
1400000US48453001777,48453001777,"Census Tract 17.77, Travis County, Texas",5504,502,3940,510,1564,284
1400000US48453001778,48453001778,"Census Tract 17.78, Travis County, Texas",3727,339,3403,344,324,155
1400000US48453001779,48453001779,"Census Tract 17.79, Travis County, Texas",5883,136,5129,511,754,512
1400000US48453001780,48453001780,"Census Tract 17.80, Travis County, Texas",4195,405,3809,403,386,140
1400000US48453001781,48453001781,"Census Tract 17.81, Travis County, Texas",2388,174,2174,205,214,131
1400000US48453001782,48453001782,"Census Tract 17.82, Travis County, Texas",5367,386,4548,285,819,396
1400000US48453001783,48453001783,"Census Tract 17.83, Travis County, Texas",5493,406,5033,422,460,258
1400000US48453001784,48453001784,"Census Tract 17.84, Travis County, Texas",5624,344,5159,433,465,290
1400000US48453001785,48453001785,"Census Tract 17.85, Travis County, Texas",4147,283,3238,385,909,286
1400000US48453001786,48453001786,"Census Tract 17.86, Travis County, Texas",5213,495,4644,507,569,177
1400000US48453001804,48453001804,"Census Tract 18.04, Travis County, Texas",5946,619,2637,474,3309,748
1400000US48453001805,48453001805,"Census Tract 18.05, Travis County, Texas",4669,445,1783,283,2886,463
1400000US48453001806,48453001806,"Census Tract 18.06, Travis County, Texas",6210,869,1910,439,4300,780
1400000US48453001811,48453001811,"Census Tract 18.11, Travis County, Texas",3272,606,1096,295,2176,673
1400000US48453001812,48453001812,"Census Tract 18.12, Travis County, Texas",7332,697,2276,434,5056,768
1400000US48453001813,48453001813,"Census Tract 18.13, Travis County, Texas",6570,700,1712,383,4858,737
1400000US48453001817,48453001817,"Census Tract 18.17, Travis County, Texas",3654,316,3156,259,498,269
1400000US48453001818,48453001818,"Census Tract 18.18, Travis County, Texas",5580,881,2853,436,2727,885
1400000US48453001819,48453001819,"Census Tract 18.19, Travis County, Texas",4903,537,1453,263,3450,527
1400000US48453001820,48453001820,"Census Tract 18.20, Travis County, Texas",7263,727,2486,401,4777,785
1400000US48453001821,48453001821,"Census Tract 18.21, Travis County, Texas",5782,524,2788,418,2994,571
1400000US48453001822,48453001822,"Census Tract 18.22, Travis County, Texas",7121,663,2509,453,4612,739
1400000US48453001823,48453001823,"Census Tract 18.23, Travis County, Texas",6743,609,1533,343,5210,688
1400000US48453001824,48453001824,"Census Tract 18.24, Travis County, Texas",1794,222,1338,162,456,234
1400000US48453001826,48453001826,"Census Tract 18.26, Travis County, Texas",2142,271,1596,264,546,285
1400000US48453001828,48453001828,"Census Tract 18.28, Travis County, Texas",3701,218,3093,305,608,227
1400000US48453001829,48453001829,"Census Tract 18.29, Travis County, Texas",2703,219,2191,233,512,149
1400000US48453001832,48453001832,"Census Tract 18.32, Travis County, Texas",2990,468,2091,348,899,422
1400000US48453001833,48453001833,"Census Tract 18.33, Travis County, Texas",8036,743,3293,499,4743,818
1400000US48453001834,48453001834,"Census Tract 18.34, Travis County, Texas",8084,545,5632,615,2452,631
1400000US48453001835,48453001835,"Census Tract 18.35, Travis County, Texas",5278,542,2103,415,3175,420
1400000US48453001839,48453001839,"Census Tract 18.39, Travis County, Texas",6283,623,4872,463,1411,398
1400000US48453001840,48453001840,"Census Tract 18.40, Travis County, Texas",8848,828,5035,819,3813,602
1400000US48453001841,48453001841,"Census Tract 18.41, Travis County, Texas",16551,979,10586,983,5965,1095
1400000US48453001842,48453001842,"Census Tract 18.42, Travis County, Texas",7860,728,3920,600,3940,799
1400000US48453001843,48453001843,"Census Tract 18.43, Travis County, Texas",2232,141,1431,152,801,162
1400000US48453001844,48453001844,"Census Tract 18.44, Travis County, Texas",3577,289,2505,307,1072,324
1400000US48453001845,48453001845,"Census Tract 18.45, Travis County, Texas",3220,382,2250,238,970,340
1400000US48453001846,48453001846,"Census Tract 18.46, Travis County, Texas",2433,281,2040,313,393,167
1400000US48453001847,48453001847,"Census Tract 18.47, Travis County, Texas",7138,613,5349,552,1789,412
1400000US48453001848,48453001848,"Census Tract 18.48, Travis County, Texas",4787,416,3566,364,1221,277
1400000US48453001849,48453001849,"Census Tract 18.49, Travis County, Texas",5639,568,4684,604,955,313
1400000US48453001850,48453001850,"Census Tract 18.50, Travis County, Texas",4284,414,2930,388,1354,483
1400000US48453001851,48453001851,"Census Tract 18.51, Travis County, Texas",8812,796,6824,648,1988,593
1400000US48453001853,48453001853,"Census Tract 18.53, Travis County, Texas",2985,230,2387,240,598,256
1400000US48453001854,48453001854,"Census Tract 18.54, Travis County, Texas",4387,482,2553,447,1834,369
1400000US48453001855,48453001855,"Census Tract 18.55, Travis County, Texas",14195,707,10812,960,3383,657
1400000US48453001856,48453001856,"Census Tract 18.56, Travis County, Texas",5901,539,3712,501,2189,498
1400000US48453001857,48453001857,"Census Tract 18.57, Travis County, Texas",5417,632,3656,576,1761,435
1400000US48453001858,48453001858,"Census Tract 18.58, Travis County, Texas",15083,975,12254,955,2829,630
1400000US48453001859,48453001859,"Census Tract 18.59, Travis County, Texas",1238,212,1019,275,219,210
1400000US48453001860,48453001860,"Census Tract 18.60, Travis County, Texas",4014,432,2437,474,1577,391
1400000US48453001861,48453001861,"Census Tract 18.61, Travis County, Texas",4536,601,3131,631,1405,266
1400000US48453001862,48453001862,"Census Tract 18.62, Travis County, Texas",5685,577,4441,570,1244,364
1400000US48453001863,48453001863,"Census Tract 18.63, Travis County, Texas",4075,365,2507,305,1568,449
1400000US48453001864,48453001864,"Census Tract 18.64, Travis County, Texas",2932,331,2160,365,772,288
1400000US48453001901,48453001901,"Census Tract 19.01, Travis County, Texas",5249,253,4571,328,678,233
1400000US48453001908,48453001908,"Census Tract 19.08, Travis County, Texas",8255,809,6199,652,2056,746
1400000US48453001910,48453001910,"Census Tract 19.10, Travis County, Texas",4281,306,3893,311,388,120
1400000US48453001911,48453001911,"Census Tract 19.11, Travis County, Texas",3009,212,2426,271,583,217
1400000US48453001912,48453001912,"Census Tract 19.12, Travis County, Texas",3919,393,3701,381,218,120
1400000US48453001913,48453001913,"Census Tract 19.13, Travis County, Texas",4910,340,4712,359,198,165
1400000US48453001914,48453001914,"Census Tract 19.14, Travis County, Texas",6150,408,5495,424,655,217
1400000US48453001915,48453001915,"Census Tract 19.15, Travis County, Texas",2052,363,1449,326,603,410
1400000US48453001916,48453001916,"Census Tract 19.16, Travis County, Texas",3387,311,3159,361,228,160
1400000US48453001917,48453001917,"Census Tract 19.17, Travis County, Texas",4623,209,4348,237,275,158
1400000US48453001918,48453001918,"Census Tract 19.18, Travis County, Texas",2350,176,2064,281,286,224
1400000US48453001919,48453001919,"Census Tract 19.19, Travis County, Texas",3827,213,3655,213,172,112
1400000US48453002002,48453002002,"Census Tract 20.02, Travis County, Texas",2781,303,1958,252,823,222
1400000US48453002003,48453002003,"Census Tract 20.03, Travis County, Texas",3621,486,1653,237,1968,451
1400000US48453002004,48453002004,"Census Tract 20.04, Travis County, Texas",2014,216,1474,204,540,199
1400000US48453002005,48453002005,"Census Tract 20.05, Travis County, Texas",4771,645,2365,372,2406,654
1400000US48453002104,48453002104,"Census Tract 21.04, Travis County, Texas",3108,306,1949,336,1159,363
1400000US48453002105,48453002105,"Census Tract 21.05, Travis County, Texas",5334,591,1990,423,3344,699
1400000US48453002106,48453002106,"Census Tract 21.06, Travis County, Texas",3343,552,2073,531,1270,389
1400000US48453002107,48453002107,"Census Tract 21.07, Travis County, Texas",4348,445,2464,340,1884,385
1400000US48453002108,48453002108,"Census Tract 21.08, Travis County, Texas",4277,658,2117,368,2160,614
1400000US48453002109,48453002109,"Census Tract 21.09, Travis County, Texas",3423,430,2537,371,886,339
1400000US48453002110,48453002110,"Census Tract 21.10, Travis County, Texas",4411,501,1769,357,2642,593
1400000US48453002111,48453002111,"Census Tract 21.11, Travis County, Texas",4290,485,1486,266,2804,462
1400000US48453002112,48453002112,"Census Tract 21.12, Travis County, Texas",5101,519,2730,471,2371,458
1400000US48453002113,48453002113,"Census Tract 21.13, Travis County, Texas",3574,421,2182,308,1392,337
1400000US48453002201,48453002201,"Census Tract 22.01, Travis County, Texas",1718,242,963,246,755,219
1400000US48453002202,48453002202,"Census Tract 22.02, Travis County, Texas",9298,1096,3477,824,5821,1305
1400000US48453002207,48453002207,"Census Tract 22.07, Travis County, Texas",8123,786,3834,795,4289,976
1400000US48453002208,48453002208,"Census Tract 22.08, Travis County, Texas",7081,795,2653,535,4428,728
1400000US48453002209,48453002209,"Census Tract 22.09, Travis County, Texas",7255,1006,4299,701,2956,923
1400000US48453002210,48453002210,"Census Tract 22.10, Travis County, Texas",3185,533,1475,249,1710,521
1400000US48453002211,48453002211,"Census Tract 22.11, Travis County, Texas",2051,376,711,218,1340,385
1400000US48453002212,48453002212,"Census Tract 22.12, Travis County, Texas",655,94,254,140,401,158
1400000US48453002304,48453002304,"Census Tract 23.04, Travis County, Texas",4015,812,1052,234,2963,875
1400000US48453002307,48453002307,"Census Tract 23.07, Travis County, Texas",5556,815,2529,353,3027,917
1400000US48453002308,48453002308,"Census Tract 23.08, Travis County, Texas",5820,647,3331,437,2489,647
1400000US48453002310,48453002310,"Census Tract 23.10, Travis County, Texas",2879,440,585,155,2294,428
1400000US48453002312,48453002312,"Census Tract 23.12, Travis County, Texas",6346,688,1254,367,5092,669
1400000US48453002313,48453002313,"Census Tract 23.13, Travis County, Texas",4652,503,2204,281,2448,477
1400000US48453002314,48453002314,"Census Tract 23.14, Travis County, Texas",4781,599,2257,397,2524,577
1400000US48453002315,48453002315,"Census Tract 23.15, Travis County, Texas",3265,334,942,195,2323,336
1400000US48453002316,48453002316,"Census Tract 23.16, Travis County, Texas",5766,687,1340,277,4426,753
1400000US48453002317,48453002317,"Census Tract 23.17, Travis County, Texas",4971,706,2907,625,2064,427
1400000US48453002318,48453002318,"Census Tract 23.18, Travis County, Texas",7541,793,3039,536,4502,807
1400000US48453002319,48453002319,"Census Tract 23.19, Travis County, Texas",960,152,444,92,516,146
1400000US48453002402,48453002402,"Census Tract 24.02, Travis County, Texas",6380,663,3319,352,3061,675
1400000US48453002403,48453002403,"Census Tract 24.03, Travis County, Texas",2533,448,1366,298,1167,402
1400000US48453002407,48453002407,"Census Tract 24.07, Travis County, Texas",4890,432,3160,390,1730,356
1400000US48453002409,48453002409,"Census Tract 24.09, Travis County, Texas",3191,214,1289,209,1902,224
1400000US48453002410,48453002410,"Census Tract 24.10, Travis County, Texas",3862,311,1917,240,1945,277
1400000US48453002411,48453002411,"Census Tract 24.11, Travis County, Texas",6143,511,1082,292,5061,522
1400000US48453002412,48453002412,"Census Tract 24.12, Travis County, Texas",5822,433,687,181,5135,486
1400000US48453002413,48453002413,"Census Tract 24.13, Travis County, Texas",4828,478,859,272,3969,543
1400000US48453002419,48453002419,"Census Tract 24.19, Travis County, Texas",4071,322,1575,220,2496,384
1400000US48453002421,48453002421,"Census Tract 24.21, Travis County, Texas",6903,618,4409,458,2494,629
1400000US48453002422,48453002422,"Census Tract 24.22, Travis County, Texas",5249,573,2435,366,2814,572
1400000US48453002423,48453002423,"Census Tract 24.23, Travis County, Texas",6019,734,2807,431,3212,799
1400000US48453002424,48453002424,"Census Tract 24.24, Travis County, Texas",3455,404,1775,241,1680,401
1400000US48453002425,48453002425,"Census Tract 24.25, Travis County, Texas",2747,319,1169,246,1578,279
1400000US48453002426,48453002426,"Census Tract 24.26, Travis County, Texas",7066,598,2242,477,4824,632
1400000US48453002427,48453002427,"Census Tract 24.27, Travis County, Texas",7788,721,1271,275,6517,766
1400000US48453002428,48453002428,"Census Tract 24.28, Travis County, Texas",6112,662,3743,529,2369,760
1400000US48453002429,48453002429,"Census Tract 24.29, Travis County, Texas",670,93,493,68,177,94
1400000US48453002430,48453002430,"Census Tract 24.30, Travis County, Texas",3397,508,983,246,2414,507
1400000US48453002431,48453002431,"Census Tract 24.31, Travis County, Texas",6960,601,1947,313,5013,656
1400000US48453002432,48453002432,"Census Tract 24.32, Travis County, Texas",2023,398,705,255,1318,347
1400000US48453002433,48453002433,"Census Tract 24.33, Travis County, Texas",5586,604,2680,597,2906,604
1400000US48453002434,48453002434,"Census Tract 24.34, Travis County, Texas",1739,286,962,218,777,237
1400000US48453002435,48453002435,"Census Tract 24.35, Travis County, Texas",6705,720,2479,573,4226,657
1400000US48453002436,48453002436,"Census Tract 24.36, Travis County, Texas",2250,347,831,223,1419,333
1400000US48453002500,48453002500,"Census Tract 25, Travis County, Texas",5450,334,4718,301,732,250
1400000US48453980000,48453980000,"Census Tract 9800, Travis County, Texas",198,151,120,83,78,77
1400000US48455950100,48455950100,"Census Tract 9501, Trinity County, Texas",3486,546,3383,546,103,87
1400000US48455950200,48455950200,"Census Tract 9502, Trinity County, Texas",3604,612,3137,622,467,162
1400000US48455950300,48455950300,"Census Tract 9503, Trinity County, Texas",2099,465,2019,486,80,101
1400000US48455950400,48455950400,"Census Tract 9504, Trinity County, Texas",3322,640,2983,608,339,219
1400000US48455950500,48455950500,"Census Tract 9505, Trinity County, Texas",1955,312,1788,296,167,120
1400000US48457950100,48457950100,"Census Tract 9501, Tyler County, Texas",2917,332,2839,324,78,90
1400000US48457950200,48457950200,"Census Tract 9502, Tyler County, Texas",8237,637,7377,572,860,269
1400000US48457950300,48457950300,"Census Tract 9503, Tyler County, Texas",2717,321,2627,328,90,72
1400000US48457950400,48457950400,"Census Tract 9504, Tyler County, Texas",4522,530,4339,513,183,206
1400000US48457950500,48457950500,"Census Tract 9505, Tyler County, Texas",3245,493,2975,401,270,273
1400000US48459950100,48459950100,"Census Tract 9501, Upshur County, Texas",7417,478,6934,507,483,244
1400000US48459950200,48459950200,"Census Tract 9502, Upshur County, Texas",3516,306,3423,295,93,81
1400000US48459950300,48459950300,"Census Tract 9503, Upshur County, Texas",7999,576,7729,630,270,176
1400000US48459950400,48459950400,"Census Tract 9504, Upshur County, Texas",4591,155,3718,300,873,289
1400000US48459950500,48459950500,"Census Tract 9505, Upshur County, Texas",6091,540,5835,535,256,157
1400000US48459950600,48459950600,"Census Tract 9506, Upshur County, Texas",4299,315,4202,311,97,80
1400000US48459950700,48459950700,"Census Tract 9507, Upshur County, Texas",5473,439,4945,398,528,238
1400000US48461950100,48461950100,"Census Tract 9501, Upton County, Texas",1185,134,920,129,265,91
1400000US48461950200,48461950200,"Census Tract 9502, Upton County, Texas",2115,134,853,137,1262,149
1400000US48463950100,48463950100,"Census Tract 9501, Uvalde County, Texas",2680,427,1295,254,1385,360
1400000US48463950200,48463950200,"Census Tract 9502, Uvalde County, Texas",8065,689,3259,442,4806,689
1400000US48463950300,48463950300,"Census Tract 9503, Uvalde County, Texas",5919,601,1574,279,4345,599
1400000US48463950400,48463950400,"Census Tract 9504, Uvalde County, Texas",3421,363,1107,201,2314,337
1400000US48463950500,48463950500,"Census Tract 9505, Uvalde County, Texas",6349,562,848,283,5501,629
1400000US48465950201,48465950201,"Census Tract 9502.01, Val Verde County, Texas",8357,559,3223,342,5134,526
1400000US48465950301,48465950301,"Census Tract 9503.01, Val Verde County, Texas",4726,398,881,257,3845,395
1400000US48465950302,48465950302,"Census Tract 9503.02, Val Verde County, Texas",4507,711,284,186,4223,695
1400000US48465950400,48465950400,"Census Tract 9504, Val Verde County, Texas",3353,392,511,179,2842,385
1400000US48465950500,48465950500,"Census Tract 9505, Val Verde County, Texas",7355,737,1863,323,5492,675
1400000US48465950601,48465950601,"Census Tract 9506.01, Val Verde County, Texas",4075,544,204,146,3871,533
1400000US48465950602,48465950602,"Census Tract 9506.02, Val Verde County, Texas",4832,671,58,46,4774,676
1400000US48465950700,48465950700,"Census Tract 9507, Val Verde County, Texas",6586,572,909,217,5677,588
1400000US48465950800,48465950800,"Census Tract 9508, Val Verde County, Texas",4787,760,1656,281,3131,785
1400000US48465980000,48465980000,"Census Tract 9800, Val Verde County, Texas",0,13,0,13,0,13
1400000US48467950100,48467950100,"Census Tract 9501, Van Zandt County, Texas",4816,396,4594,408,222,132
1400000US48467950200,48467950200,"Census Tract 9502, Van Zandt County, Texas",3141,178,2523,215,618,183
1400000US48467950300,48467950300,"Census Tract 9503, Van Zandt County, Texas",4342,357,4010,358,332,163
1400000US48467950400,48467950400,"Census Tract 9504, Van Zandt County, Texas",5084,530,4619,504,465,247
1400000US48467950500,48467950500,"Census Tract 9505, Van Zandt County, Texas",4457,241,4186,381,271,271
1400000US48467950600,48467950600,"Census Tract 9506, Van Zandt County, Texas",7459,769,7093,739,366,203
1400000US48467950700,48467950700,"Census Tract 9507, Van Zandt County, Texas",3949,283,3449,349,500,250
1400000US48467950800,48467950800,"Census Tract 9508, Van Zandt County, Texas",5317,417,4564,468,753,315
1400000US48467950900,48467950900,"Census Tract 9509, Van Zandt County, Texas",7337,615,6734,626,603,222
1400000US48467951000,48467951000,"Census Tract 9510, Van Zandt County, Texas",6605,709,5858,577,747,456
1400000US48469000100,48469000100,"Census Tract 1, Victoria County, Texas",2507,475,843,269,1664,415
1400000US48469000201,48469000201,"Census Tract 2.01, Victoria County, Texas",3068,327,916,210,2152,334
1400000US48469000202,48469000202,"Census Tract 2.02, Victoria County, Texas",4904,472,1491,301,3413,508
1400000US48469000301,48469000301,"Census Tract 3.01, Victoria County, Texas",1756,349,479,156,1277,320
1400000US48469000302,48469000302,"Census Tract 3.02, Victoria County, Texas",2203,373,548,188,1655,412
1400000US48469000400,48469000400,"Census Tract 4, Victoria County, Texas",1832,269,1064,207,768,277
1400000US48469000501,48469000501,"Census Tract 5.01, Victoria County, Texas",3732,331,1922,273,1810,316
1400000US48469000502,48469000502,"Census Tract 5.02, Victoria County, Texas",3944,409,1903,342,2041,399
1400000US48469000601,48469000601,"Census Tract 6.01, Victoria County, Texas",2998,489,888,266,2110,583
1400000US48469000602,48469000602,"Census Tract 6.02, Victoria County, Texas",4390,494,2056,411,2334,402
1400000US48469000700,48469000700,"Census Tract 7, Victoria County, Texas",3450,391,1530,210,1920,397
1400000US48469000800,48469000800,"Census Tract 8, Victoria County, Texas",1673,270,1149,188,524,255
1400000US48469001300,48469001300,"Census Tract 13, Victoria County, Texas",1947,266,1350,203,597,245
1400000US48469001400,48469001400,"Census Tract 14, Victoria County, Texas",8399,503,5620,513,2779,496
1400000US48469001501,48469001501,"Census Tract 15.01, Victoria County, Texas",3256,219,2427,257,829,194
1400000US48469001503,48469001503,"Census Tract 15.03, Victoria County, Texas",2192,310,2088,321,104,70
1400000US48469001504,48469001504,"Census Tract 15.04, Victoria County, Texas",6529,338,5012,375,1517,255
1400000US48469001601,48469001601,"Census Tract 16.01, Victoria County, Texas",5923,728,4341,639,1582,652
1400000US48469001604,48469001604,"Census Tract 16.04, Victoria County, Texas",6783,535,3753,429,3030,590
1400000US48469001605,48469001605,"Census Tract 16.05, Victoria County, Texas",3422,356,2210,350,1212,351
1400000US48469001606,48469001606,"Census Tract 16.06, Victoria County, Texas",7928,651,5856,558,2072,520
1400000US48469001700,48469001700,"Census Tract 17, Victoria County, Texas",4352,503,1419,306,2933,479
1400000US48469980000,48469980000,"Census Tract 9800, Victoria County, Texas",0,13,0,13,0,13
1400000US48471790101,48471790101,"Census Tract 7901.01, Walker County, Texas",6884,443,5730,427,1154,154
1400000US48471790102,48471790102,"Census Tract 7901.02, Walker County, Texas",4029,502,2968,452,1061,431
1400000US48471790103,48471790103,"Census Tract 7901.03, Walker County, Texas",5552,654,4921,596,631,284
1400000US48471790200,48471790200,"Census Tract 7902, Walker County, Texas",7231,865,5919,736,1312,676
1400000US48471790300,48471790300,"Census Tract 7903, Walker County, Texas",7880,776,7637,769,243,120
1400000US48471790400,48471790400,"Census Tract 7904, Walker County, Texas",10718,1607,8363,1201,2355,742
1400000US48471790500,48471790500,"Census Tract 7905, Walker County, Texas",9567,1544,8228,1099,1339,553
1400000US48471790600,48471790600,"Census Tract 7906, Walker County, Texas",4318,707,2717,517,1601,392
1400000US48471790700,48471790700,"Census Tract 7907, Walker County, Texas",6005,760,4900,633,1105,356
1400000US48471790800,48471790800,"Census Tract 7908, Walker County, Texas",5263,531,4713,456,550,219
1400000US48473680100,48473680100,"Census Tract 6801, Waller County, Texas",2437,285,1842,233,595,290
1400000US48473680200,48473680200,"Census Tract 6802, Waller County, Texas",9932,771,4665,620,5267,690
1400000US48473680300,48473680300,"Census Tract 6803, Waller County, Texas",11817,1182,9112,1134,2705,550
1400000US48473680400,48473680400,"Census Tract 6804, Waller County, Texas",1973,992,1854,991,119,66
1400000US48473680500,48473680500,"Census Tract 6805, Waller County, Texas",8756,624,6704,623,2052,374
1400000US48473680600,48473680600,"Census Tract 6806, Waller County, Texas",7979,645,6315,452,1664,543
1400000US48475950100,48475950100,"Census Tract 9501, Ward County, Texas",4211,153,2480,245,1731,199
1400000US48475950200,48475950200,"Census Tract 9502, Ward County, Texas",4040,253,2045,217,1995,233
1400000US48475950300,48475950300,"Census Tract 9503, Ward County, Texas",2454,212,1024,203,1430,248
1400000US48477170100,48477170100,"Census Tract 1701, Washington County, Texas",3277,491,2682,458,595,277
1400000US48477170200,48477170200,"Census Tract 1702, Washington County, Texas",5887,659,5055,581,832,310
1400000US48477170300,48477170300,"Census Tract 1703, Washington County, Texas",6643,580,5516,467,1127,437
1400000US48477170400,48477170400,"Census Tract 1704, Washington County, Texas",6428,464,5397,469,1031,295
1400000US48477170500,48477170500,"Census Tract 1705, Washington County, Texas",6584,580,6066,557,518,251
1400000US48477170600,48477170600,"Census Tract 1706, Washington County, Texas",4809,592,4326,582,483,365
1400000US48479000101,48479000101,"Census Tract 1.01, Webb County, Texas",4739,529,131,77,4608,540
1400000US48479000105,48479000105,"Census Tract 1.05, Webb County, Texas",2477,401,9,15,2468,402
1400000US48479000106,48479000106,"Census Tract 1.06, Webb County, Texas",4454,766,7,9,4447,766
1400000US48479000107,48479000107,"Census Tract 1.07, Webb County, Texas",3674,659,58,78,3616,650
1400000US48479000108,48479000108,"Census Tract 1.08, Webb County, Texas",4101,608,1,3,4100,608
1400000US48479000109,48479000109,"Census Tract 1.09, Webb County, Texas",2104,415,76,57,2028,395
1400000US48479000200,48479000200,"Census Tract 2, Webb County, Texas",3684,476,83,52,3601,479
1400000US48479000300,48479000300,"Census Tract 3, Webb County, Texas",2667,378,43,40,2624,366
1400000US48479000601,48479000601,"Census Tract 6.01, Webb County, Texas",3016,694,18,21,2998,687
1400000US48479000602,48479000602,"Census Tract 6.02, Webb County, Texas",2752,367,8,9,2744,366
1400000US48479000700,48479000700,"Census Tract 7, Webb County, Texas",2869,316,54,84,2815,297
1400000US48479000800,48479000800,"Census Tract 8, Webb County, Texas",2256,378,27,38,2229,366
1400000US48479000901,48479000901,"Census Tract 9.01, Webb County, Texas",4190,651,45,36,4145,658
1400000US48479000903,48479000903,"Census Tract 9.03, Webb County, Texas",3243,535,6,11,3237,536
1400000US48479000904,48479000904,"Census Tract 9.04, Webb County, Texas",3154,392,78,65,3076,378
1400000US48479001001,48479001001,"Census Tract 10.01, Webb County, Texas",5124,571,161,109,4963,580
1400000US48479001003,48479001003,"Census Tract 10.03, Webb County, Texas",2581,294,42,37,2539,303
1400000US48479001004,48479001004,"Census Tract 10.04, Webb County, Texas",1614,300,24,29,1590,303
1400000US48479001101,48479001101,"Census Tract 11.01, Webb County, Texas",3821,422,190,84,3631,434
1400000US48479001103,48479001103,"Census Tract 11.03, Webb County, Texas",1477,247,8,14,1469,246
1400000US48479001104,48479001104,"Census Tract 11.04, Webb County, Texas",3193,298,259,230,2934,311
1400000US48479001105,48479001105,"Census Tract 11.05, Webb County, Texas",2887,312,60,55,2827,302
1400000US48479001201,48479001201,"Census Tract 12.01, Webb County, Texas",2780,368,6,9,2774,369
1400000US48479001202,48479001202,"Census Tract 12.02, Webb County, Texas",3290,404,86,69,3204,413
1400000US48479001300,48479001300,"Census Tract 13, Webb County, Texas",3881,446,100,69,3781,447
1400000US48479001401,48479001401,"Census Tract 14.01, Webb County, Texas",4195,649,103,81,4092,655
1400000US48479001402,48479001402,"Census Tract 14.02, Webb County, Texas",3275,641,14,23,3261,639
1400000US48479001501,48479001501,"Census Tract 15.01, Webb County, Texas",2940,273,131,174,2809,292
1400000US48479001502,48479001502,"Census Tract 15.02, Webb County, Texas",4619,457,118,88,4501,466
1400000US48479001601,48479001601,"Census Tract 16.01, Webb County, Texas",3934,518,222,117,3712,522
1400000US48479001602,48479001602,"Census Tract 16.02, Webb County, Texas",4392,419,597,169,3795,430
1400000US48479001706,48479001706,"Census Tract 17.06, Webb County, Texas",5454,583,74,62,5380,576
1400000US48479001709,48479001709,"Census Tract 17.09, Webb County, Texas",6360,747,1009,248,5351,693
1400000US48479001710,48479001710,"Census Tract 17.10, Webb County, Texas",1324,439,73,70,1251,443
1400000US48479001711,48479001711,"Census Tract 17.11, Webb County, Texas",5427,426,531,248,4896,432
1400000US48479001712,48479001712,"Census Tract 17.12, Webb County, Texas",7119,804,534,297,6585,820
1400000US48479001713,48479001713,"Census Tract 17.13, Webb County, Texas",12846,726,1128,320,11718,719
1400000US48479001714,48479001714,"Census Tract 17.14, Webb County, Texas",3496,626,286,177,3210,590
1400000US48479001715,48479001715,"Census Tract 17.15, Webb County, Texas",6700,429,296,192,6404,446
1400000US48479001716,48479001716,"Census Tract 17.16, Webb County, Texas",5977,450,216,186,5761,459
1400000US48479001717,48479001717,"Census Tract 17.17, Webb County, Texas",3513,568,146,92,3367,568
1400000US48479001718,48479001718,"Census Tract 17.18, Webb County, Texas",2230,230,242,158,1988,246
1400000US48479001719,48479001719,"Census Tract 17.19, Webb County, Texas",3293,287,200,100,3093,300
1400000US48479001720,48479001720,"Census Tract 17.20, Webb County, Texas",5328,620,814,436,4514,475
1400000US48479001721,48479001721,"Census Tract 17.21, Webb County, Texas",2669,171,301,204,2368,277
1400000US48479001722,48479001722,"Census Tract 17.22, Webb County, Texas",6225,522,616,229,5609,489
1400000US48479001806,48479001806,"Census Tract 18.06, Webb County, Texas",4839,725,57,88,4782,697
1400000US48479001807,48479001807,"Census Tract 18.07, Webb County, Texas",7430,821,104,123,7326,806
1400000US48479001808,48479001808,"Census Tract 18.08, Webb County, Texas",6937,783,21,34,6916,785
1400000US48479001809,48479001809,"Census Tract 18.09, Webb County, Texas",5978,777,107,96,5871,758
1400000US48479001810,48479001810,"Census Tract 18.10, Webb County, Texas",4870,538,279,175,4591,536
1400000US48479001811,48479001811,"Census Tract 18.11, Webb County, Texas",4356,300,38,47,4318,300
1400000US48479001812,48479001812,"Census Tract 18.12, Webb County, Texas",8092,532,162,122,7930,577
1400000US48479001813,48479001813,"Census Tract 18.13, Webb County, Texas",963,304,82,66,881,289
1400000US48479001814,48479001814,"Census Tract 18.14, Webb County, Texas",7093,897,499,454,6594,794
1400000US48479001815,48479001815,"Census Tract 18.15, Webb County, Texas",1919,469,40,50,1879,469
1400000US48479001816,48479001816,"Census Tract 18.16, Webb County, Texas",3920,815,70,68,3850,809
1400000US48479001817,48479001817,"Census Tract 18.17, Webb County, Texas",5831,470,110,93,5721,479
1400000US48479001818,48479001818,"Census Tract 18.18, Webb County, Texas",3310,26,8,9,3302,26
1400000US48479001900,48479001900,"Census Tract 19, Webb County, Texas",3438,403,217,81,3221,416
1400000US48479980000,48479980000,"Census Tract 9800, Webb County, Texas",0,13,0,13,0,13
1400000US48481740100,48481740100,"Census Tract 7401, Wharton County, Texas",5458,580,4620,559,838,354
1400000US48481740200,48481740200,"Census Tract 7402, Wharton County, Texas",1421,227,904,199,517,177
1400000US48481740300,48481740300,"Census Tract 7403, Wharton County, Texas",2003,353,1449,284,554,302
1400000US48481740400,48481740400,"Census Tract 7404, Wharton County, Texas",6359,590,3812,515,2547,500
1400000US48481740500,48481740500,"Census Tract 7405, Wharton County, Texas",3059,514,1967,314,1092,510
1400000US48481740600,48481740600,"Census Tract 7406, Wharton County, Texas",3722,475,2301,374,1421,413
1400000US48481740700,48481740700,"Census Tract 7407, Wharton County, Texas",1972,365,1136,357,836,141
1400000US48481740800,48481740800,"Census Tract 7408, Wharton County, Texas",3500,487,1232,240,2268,460
1400000US48481740900,48481740900,"Census Tract 7409, Wharton County, Texas",6523,564,4675,417,1848,395
1400000US48481741000,48481741000,"Census Tract 7410, Wharton County, Texas",4720,581,1777,284,2943,592
1400000US48481741100,48481741100,"Census Tract 7411, Wharton County, Texas",2416,355,1837,320,579,224
1400000US48483950100,48483950100,"Census Tract 9501, Wheeler County, Texas",3086,203,2089,144,997,160
1400000US48483950300,48483950300,"Census Tract 9503, Wheeler County, Texas",2328,203,1986,144,342,160
1400000US48485010100,48485010100,"Census Tract 101, Wichita County, Texas",1329,182,866,139,463,191
1400000US48485010200,48485010200,"Census Tract 102, Wichita County, Texas",1148,163,765,177,383,170
1400000US48485010400,48485010400,"Census Tract 104, Wichita County, Texas",2312,278,1820,299,492,187
1400000US48485010600,48485010600,"Census Tract 106, Wichita County, Texas",2544,305,1800,264,744,236
1400000US48485010700,48485010700,"Census Tract 107, Wichita County, Texas",2622,459,1678,338,944,257
1400000US48485010800,48485010800,"Census Tract 108, Wichita County, Texas",2671,313,1576,302,1095,244
1400000US48485010900,48485010900,"Census Tract 109, Wichita County, Texas",1635,252,1497,226,138,71
1400000US48485011000,48485011000,"Census Tract 110, Wichita County, Texas",2560,294,1795,356,765,299
1400000US48485011100,48485011100,"Census Tract 111, Wichita County, Texas",1243,187,368,96,875,204
1400000US48485011200,48485011200,"Census Tract 112, Wichita County, Texas",1900,188,1699,181,201,86
1400000US48485011300,48485011300,"Census Tract 113, Wichita County, Texas",1331,282,1203,249,128,90
1400000US48485011400,48485011400,"Census Tract 114, Wichita County, Texas",2760,407,1227,250,1533,466
1400000US48485011500,48485011500,"Census Tract 115, Wichita County, Texas",2387,202,1921,198,466,136
1400000US48485011600,48485011600,"Census Tract 116, Wichita County, Texas",4358,373,3238,396,1120,346
1400000US48485011700,48485011700,"Census Tract 117, Wichita County, Texas",2530,285,2249,290,281,186
1400000US48485011800,48485011800,"Census Tract 118, Wichita County, Texas",1727,160,1544,193,183,138
1400000US48485011900,48485011900,"Census Tract 119, Wichita County, Texas",4063,382,3513,370,550,235
1400000US48485012000,48485012000,"Census Tract 120, Wichita County, Texas",6861,519,6416,498,445,163
1400000US48485012100,48485012100,"Census Tract 121, Wichita County, Texas",2948,308,2479,290,469,179
1400000US48485012200,48485012200,"Census Tract 122, Wichita County, Texas",6233,601,5184,573,1049,343
1400000US48485012300,48485012300,"Census Tract 123, Wichita County, Texas",7547,541,6716,530,831,264
1400000US48485012400,48485012400,"Census Tract 124, Wichita County, Texas",7502,428,6734,388,768,218
1400000US48485012600,48485012600,"Census Tract 126, Wichita County, Texas",4106,285,3627,279,479,231
1400000US48485012700,48485012700,"Census Tract 127, Wichita County, Texas",2737,378,1849,356,888,403
1400000US48485012800,48485012800,"Census Tract 128, Wichita County, Texas",4229,312,3493,277,736,222
1400000US48485012900,48485012900,"Census Tract 129, Wichita County, Texas",2522,296,2306,285,216,171
1400000US48485013000,48485013000,"Census Tract 130, Wichita County, Texas",2510,258,2051,310,459,216
1400000US48485013100,48485013100,"Census Tract 131, Wichita County, Texas",8846,741,6647,527,2199,455
1400000US48485013200,48485013200,"Census Tract 132, Wichita County, Texas",6302,478,5605,459,697,280
1400000US48485013300,48485013300,"Census Tract 133, Wichita County, Texas",1525,492,1416,475,109,160
1400000US48485013401,48485013401,"Census Tract 134.01, Wichita County, Texas",5418,645,4629,583,789,251
1400000US48485013501,48485013501,"Census Tract 135.01, Wichita County, Texas",5695,337,5171,412,524,293
1400000US48485013502,48485013502,"Census Tract 135.02, Wichita County, Texas",4914,353,4650,333,264,144
1400000US48485013600,48485013600,"Census Tract 136, Wichita County, Texas",5741,233,5574,237,167,101
1400000US48485013700,48485013700,"Census Tract 137, Wichita County, Texas",2811,36,2506,228,305,223
1400000US48485013800,48485013800,"Census Tract 138, Wichita County, Texas",3452,303,3372,295,80,48
1400000US48485980000,48485980000,"Census Tract 9800, Wichita County, Texas",0,13,0,13,0,13
1400000US48487950300,48487950300,"Census Tract 9503, Wilbarger County, Texas",2069,223,1699,212,370,176
1400000US48487950500,48487950500,"Census Tract 9505, Wilbarger County, Texas",3039,277,2469,272,570,164
1400000US48487950600,48487950600,"Census Tract 9506, Wilbarger County, Texas",5680,419,4456,360,1224,279
1400000US48487950700,48487950700,"Census Tract 9507, Wilbarger County, Texas",2663,242,1313,268,1350,278
1400000US48489950300,48489950300,"Census Tract 9503, Willacy County, Texas",6239,612,553,168,5686,608
1400000US48489950400,48489950400,"Census Tract 9504, Willacy County, Texas",7781,641,1156,238,6625,628
1400000US48489950500,48489950500,"Census Tract 9505, Willacy County, Texas",3160,180,252,155,2908,187
1400000US48489950600,48489950600,"Census Tract 9506, Willacy County, Texas",2389,350,319,170,2070,359
1400000US48489950700,48489950700,"Census Tract 9507, Willacy County, Texas",2414,365,524,167,1890,348
1400000US48489990000,48489990000,"Census Tract 9900, Willacy County, Texas",0,13,0,13,0,13
1400000US48491020105,48491020105,"Census Tract 201.05, Williamson County, Texas",3810,463,3451,470,359,371
1400000US48491020106,48491020106,"Census Tract 201.06, Williamson County, Texas",3210,314,3000,316,210,124
1400000US48491020107,48491020107,"Census Tract 201.07, Williamson County, Texas",4527,320,4471,324,56,51
1400000US48491020108,48491020108,"Census Tract 201.08, Williamson County, Texas",2778,239,2696,254,82,82
1400000US48491020109,48491020109,"Census Tract 201.09, Williamson County, Texas",2643,340,2485,362,158,92
1400000US48491020110,48491020110,"Census Tract 201.10, Williamson County, Texas",3619,285,3184,289,435,192
1400000US48491020111,48491020111,"Census Tract 201.11, Williamson County, Texas",2807,279,2338,393,469,223
1400000US48491020112,48491020112,"Census Tract 201.12, Williamson County, Texas",3063,272,2814,293,249,197
1400000US48491020113,48491020113,"Census Tract 201.13, Williamson County, Texas",2754,431,1921,445,833,189
1400000US48491020114,48491020114,"Census Tract 201.14, Williamson County, Texas",5200,878,3326,415,1874,929
1400000US48491020115,48491020115,"Census Tract 201.15, Williamson County, Texas",2335,224,2125,231,210,148
1400000US48491020201,48491020201,"Census Tract 202.01, Williamson County, Texas",1431,310,1206,265,225,149
1400000US48491020202,48491020202,"Census Tract 202.02, Williamson County, Texas",5097,470,4472,505,625,277
1400000US48491020203,48491020203,"Census Tract 202.03, Williamson County, Texas",2766,241,2710,239,56,57
1400000US48491020204,48491020204,"Census Tract 202.04, Williamson County, Texas",3943,538,3389,517,554,206
1400000US48491020301,48491020301,"Census Tract 203.01, Williamson County, Texas",6004,531,5100,540,904,197
1400000US48491020302,48491020302,"Census Tract 203.02, Williamson County, Texas",2786,403,2196,350,590,276
1400000US48491020310,48491020310,"Census Tract 203.10, Williamson County, Texas",2488,248,2190,242,298,180
1400000US48491020311,48491020311,"Census Tract 203.11, Williamson County, Texas",2975,270,2128,258,847,230
1400000US48491020312,48491020312,"Census Tract 203.12, Williamson County, Texas",7197,565,4140,593,3057,673
1400000US48491020313,48491020313,"Census Tract 203.13, Williamson County, Texas",8507,545,6891,556,1616,466
1400000US48491020314,48491020314,"Census Tract 203.14, Williamson County, Texas",5521,354,3458,590,2063,593
1400000US48491020315,48491020315,"Census Tract 203.15, Williamson County, Texas",4081,425,3532,333,549,313
1400000US48491020316,48491020316,"Census Tract 203.16, Williamson County, Texas",3259,441,2760,432,499,204
1400000US48491020317,48491020317,"Census Tract 203.17, Williamson County, Texas",3130,385,2603,414,527,307
1400000US48491020318,48491020318,"Census Tract 203.18, Williamson County, Texas",8460,558,7473,588,987,385
1400000US48491020319,48491020319,"Census Tract 203.19, Williamson County, Texas",5357,397,4821,518,536,260
1400000US48491020320,48491020320,"Census Tract 203.20, Williamson County, Texas",7623,581,6410,597,1213,271
1400000US48491020321,48491020321,"Census Tract 203.21, Williamson County, Texas",1636,284,1063,308,573,204
1400000US48491020322,48491020322,"Census Tract 203.22, Williamson County, Texas",8649,506,7370,490,1279,366
1400000US48491020323,48491020323,"Census Tract 203.23, Williamson County, Texas",3008,262,2440,299,568,290
1400000US48491020324,48491020324,"Census Tract 203.24, Williamson County, Texas",6017,421,4928,482,1089,302
1400000US48491020325,48491020325,"Census Tract 203.25, Williamson County, Texas",3402,448,2198,671,1204,479
1400000US48491020326,48491020326,"Census Tract 203.26, Williamson County, Texas",6004,350,5330,354,674,306
1400000US48491020327,48491020327,"Census Tract 203.27, Williamson County, Texas",2447,360,2011,384,436,215
1400000US48491020328,48491020328,"Census Tract 203.28, Williamson County, Texas",6797,592,5294,558,1503,638
1400000US48491020403,48491020403,"Census Tract 204.03, Williamson County, Texas",1879,255,1555,230,324,188
1400000US48491020404,48491020404,"Census Tract 204.04, Williamson County, Texas",3523,256,2992,240,531,195
1400000US48491020405,48491020405,"Census Tract 204.05, Williamson County, Texas",5797,557,4253,462,1544,510
1400000US48491020406,48491020406,"Census Tract 204.06, Williamson County, Texas",6478,552,5189,533,1289,335
1400000US48491020408,48491020408,"Census Tract 204.08, Williamson County, Texas",4756,524,3978,565,778,374
1400000US48491020409,48491020409,"Census Tract 204.09, Williamson County, Texas",3873,345,3196,331,677,224
1400000US48491020410,48491020410,"Census Tract 204.10, Williamson County, Texas",5943,484,4822,448,1121,372
1400000US48491020411,48491020411,"Census Tract 204.11, Williamson County, Texas",5954,377,5160,427,794,283
1400000US48491020503,48491020503,"Census Tract 205.03, Williamson County, Texas",4488,354,4041,289,447,184
1400000US48491020504,48491020504,"Census Tract 205.04, Williamson County, Texas",8597,772,4694,507,3903,797
1400000US48491020505,48491020505,"Census Tract 205.05, Williamson County, Texas",2830,243,2545,305,285,213
1400000US48491020506,48491020506,"Census Tract 205.06, Williamson County, Texas",8938,806,7595,696,1343,348
1400000US48491020507,48491020507,"Census Tract 205.07, Williamson County, Texas",3249,483,2643,475,606,293
1400000US48491020508,48491020508,"Census Tract 205.08, Williamson County, Texas",4594,464,3779,436,815,362
1400000US48491020509,48491020509,"Census Tract 205.09, Williamson County, Texas",6917,477,6340,448,577,219
1400000US48491020510,48491020510,"Census Tract 205.10, Williamson County, Texas",10012,584,9053,592,959,457
1400000US48491020602,48491020602,"Census Tract 206.02, Williamson County, Texas",4864,394,3064,398,1800,510
1400000US48491020603,48491020603,"Census Tract 206.03, Williamson County, Texas",8892,657,7962,680,930,308
1400000US48491020604,48491020604,"Census Tract 206.04, Williamson County, Texas",5308,649,4422,601,886,203
1400000US48491020605,48491020605,"Census Tract 206.05, Williamson County, Texas",7123,463,6019,466,1104,443
1400000US48491020701,48491020701,"Census Tract 207.01, Williamson County, Texas",2512,454,1262,247,1250,466
1400000US48491020703,48491020703,"Census Tract 207.03, Williamson County, Texas",11499,909,7358,770,4141,1070
1400000US48491020704,48491020704,"Census Tract 207.04, Williamson County, Texas",5747,515,2670,362,3077,514
1400000US48491020706,48491020706,"Census Tract 207.06, Williamson County, Texas",3347,442,2635,409,712,277
1400000US48491020707,48491020707,"Census Tract 207.07, Williamson County, Texas",4567,544,2922,435,1645,477
1400000US48491020708,48491020708,"Census Tract 207.08, Williamson County, Texas",6457,671,5611,634,846,403
1400000US48491020803,48491020803,"Census Tract 208.03, Williamson County, Texas",3971,542,2497,449,1474,513
1400000US48491020804,48491020804,"Census Tract 208.04, Williamson County, Texas",8027,459,7015,540,1012,378
1400000US48491020805,48491020805,"Census Tract 208.05, Williamson County, Texas",7139,627,5043,458,2096,615
1400000US48491020806,48491020806,"Census Tract 208.06, Williamson County, Texas",2191,436,1475,395,716,180
1400000US48491020807,48491020807,"Census Tract 208.07, Williamson County, Texas",6550,466,4181,483,2369,438
1400000US48491020808,48491020808,"Census Tract 208.08, Williamson County, Texas",1542,320,1210,252,332,307
1400000US48491020809,48491020809,"Census Tract 208.09, Williamson County, Texas",5697,472,4563,498,1134,374
1400000US48491020900,48491020900,"Census Tract 209, Williamson County, Texas",4171,396,3549,362,622,154
1400000US48491021000,48491021000,"Census Tract 210, Williamson County, Texas",3314,389,1350,234,1964,333
1400000US48491021100,48491021100,"Census Tract 211, Williamson County, Texas",2986,471,1481,483,1505,373
1400000US48491021201,48491021201,"Census Tract 212.01, Williamson County, Texas",2809,288,2003,272,806,252
1400000US48491021202,48491021202,"Census Tract 212.02, Williamson County, Texas",3071,300,2413,315,658,336
1400000US48491021203,48491021203,"Census Tract 212.03, Williamson County, Texas",2871,316,2209,391,662,311
1400000US48491021300,48491021300,"Census Tract 213, Williamson County, Texas",3674,361,2689,340,985,199
1400000US48491021401,48491021401,"Census Tract 214.01, Williamson County, Texas",9971,757,5895,743,4076,936
1400000US48491021402,48491021402,"Census Tract 214.02, Williamson County, Texas",4243,535,2212,250,2031,482
1400000US48491021403,48491021403,"Census Tract 214.03, Williamson County, Texas",3568,367,1760,296,1808,370
1400000US48491021502,48491021502,"Census Tract 215.02, Williamson County, Texas",4898,519,2240,357,2658,502
1400000US48491021503,48491021503,"Census Tract 215.03, Williamson County, Texas",4451,563,2987,465,1464,435
1400000US48491021504,48491021504,"Census Tract 215.04, Williamson County, Texas",4967,787,3824,718,1143,506
1400000US48491021505,48491021505,"Census Tract 215.05, Williamson County, Texas",7139,580,4286,545,2853,605
1400000US48491021506,48491021506,"Census Tract 215.06, Williamson County, Texas",2283,430,1538,285,745,386
1400000US48491021507,48491021507,"Census Tract 215.07, Williamson County, Texas",8406,957,5885,797,2521,632
1400000US48491021508,48491021508,"Census Tract 215.08, Williamson County, Texas",6930,1130,5742,1141,1188,592
1400000US48491021601,48491021601,"Census Tract 216.01, Williamson County, Texas",3034,432,2151,334,883,347
1400000US48491021602,48491021602,"Census Tract 216.02, Williamson County, Texas",3219,510,2169,394,1050,463
1400000US48491021603,48491021603,"Census Tract 216.03, Williamson County, Texas",1699,195,1437,205,262,148
1400000US48493000102,48493000102,"Census Tract 1.02, Wilson County, Texas",3407,420,2728,396,679,285
1400000US48493000103,48493000103,"Census Tract 1.03, Wilson County, Texas",2753,330,1952,317,801,293
1400000US48493000104,48493000104,"Census Tract 1.04, Wilson County, Texas",4353,501,3417,439,936,289
1400000US48493000201,48493000201,"Census Tract 2.01, Wilson County, Texas",2688,332,1214,250,1474,281
1400000US48493000202,48493000202,"Census Tract 2.02, Wilson County, Texas",1847,322,1227,250,620,221
1400000US48493000300,48493000300,"Census Tract 3, Wilson County, Texas",5224,351,1822,259,3402,382
1400000US48493000402,48493000402,"Census Tract 4.02, Wilson County, Texas",2622,357,1446,254,1176,355
1400000US48493000403,48493000403,"Census Tract 4.03, Wilson County, Texas",6812,502,3910,370,2902,455
1400000US48493000404,48493000404,"Census Tract 4.04, Wilson County, Texas",5874,292,3962,308,1912,332
1400000US48493000500,48493000500,"Census Tract 5, Wilson County, Texas",3794,385,2916,318,878,218
1400000US48493000600,48493000600,"Census Tract 6, Wilson County, Texas",3625,344,1847,298,1778,341
1400000US48495950200,48495950200,"Census Tract 9502, Winkler County, Texas",2006,270,960,159,1046,264
1400000US48495950300,48495950300,"Census Tract 9503, Winkler County, Texas",3635,260,1413,187,2222,275
1400000US48495950400,48495950400,"Census Tract 9504, Winkler County, Texas",1496,206,910,142,586,168
1400000US48497150101,48497150101,"Census Tract 1501.01, Wise County, Texas",3258,399,2625,333,633,349
1400000US48497150102,48497150102,"Census Tract 1501.02, Wise County, Texas",6450,699,5596,674,854,428
1400000US48497150200,48497150200,"Census Tract 1502, Wise County, Texas",6194,286,4033,436,2161,442
1400000US48497150300,48497150300,"Census Tract 1503, Wise County, Texas",3260,282,3072,310,188,109
1400000US48497150401,48497150401,"Census Tract 1504.01, Wise County, Texas",5826,538,5080,523,746,279
1400000US48497150402,48497150402,"Census Tract 1504.02, Wise County, Texas",5079,489,4719,423,360,172
1400000US48497150403,48497150403,"Census Tract 1504.03, Wise County, Texas",3461,400,3375,405,86,71
1400000US48497150500,48497150500,"Census Tract 1505, Wise County, Texas",6050,316,3727,426,2323,371
1400000US48497150601,48497150601,"Census Tract 1506.01, Wise County, Texas",8528,593,8082,603,446,164
1400000US48497150602,48497150602,"Census Tract 1506.02, Wise County, Texas",6331,588,4939,529,1392,390
1400000US48497150603,48497150603,"Census Tract 1506.03, Wise County, Texas",4914,532,4024,443,890,365
1400000US48499950100,48499950100,"Census Tract 9501, Wood County, Texas",4210,407,3904,412,306,215
1400000US48499950200,48499950200,"Census Tract 9502, Wood County, Texas",3260,189,2889,191,371,114
1400000US48499950301,48499950301,"Census Tract 9503.01, Wood County, Texas",3633,469,3496,465,137,112
1400000US48499950302,48499950302,"Census Tract 9503.02, Wood County, Texas",5202,498,4754,471,448,250
1400000US48499950400,48499950400,"Census Tract 9504, Wood County, Texas",4605,442,4343,431,262,143
1400000US48499950500,48499950500,"Census Tract 9505, Wood County, Texas",2528,232,2204,205,324,124
1400000US48499950601,48499950601,"Census Tract 9506.01, Wood County, Texas",4309,436,4127,465,182,90
1400000US48499950602,48499950602,"Census Tract 9506.02, Wood County, Texas",4288,493,4221,484,67,55
1400000US48499950700,48499950700,"Census Tract 9507, Wood County, Texas",5023,465,4571,427,452,203
1400000US48499950800,48499950800,"Census Tract 9508, Wood County, Texas",4869,280,3881,354,988,289
1400000US48501950100,48501950100,"Census Tract 9501, Yoakum County, Texas",2343,236,1174,189,1169,235
1400000US48501950200,48501950200,"Census Tract 9502, Yoakum County, Texas",5575,236,2076,188,3499,235
1400000US48503950200,48503950200,"Census Tract 9502, Young County, Texas",4245,194,3538,294,707,210
1400000US48503950400,48503950400,"Census Tract 9504, Young County, Texas",5861,267,5654,280,207,110
1400000US48503950500,48503950500,"Census Tract 9505, Young County, Texas",2733,311,2044,284,689,185
1400000US48503950600,48503950600,"Census Tract 9506, Young County, Texas",5529,313,4143,345,1386,236
1400000US48505950301,48505950301,"Census Tract 9503.01, Zapata County, Texas",4470,787,15,20,4455,791
1400000US48505950302,48505950302,"Census Tract 9503.02, Zapata County, Texas",4311,698,345,99,3966,715
1400000US48505950400,48505950400,"Census Tract 9504, Zapata County, Texas",5233,700,602,98,4631,705
1400000US48507950100,48507950100,"Census Tract 9501, Zavala County, Texas",1108,299,65,50,1043,297
1400000US48507950200,48507950200,"Census Tract 9502, Zavala County, Texas",1957,363,426,64,1531,349
1400000US48507950301,48507950301,"Census Tract 9503.01, Zavala County, Texas",2283,363,139,74,2144,375
1400000US48507950302,48507950302,"Census Tract 9503.02, Zavala County, Texas",6405,558,156,72,6249,561