GEOid,GEOid2,GEO.display-label,HD01_VD01,HD02_VD01,HD01_VD02,HD02_VD02,HD01_VD03,HD02_VD03
1400000US48001950100,48001950100,"Census Tract 9501, Anderson County, Texas",5216,685,5078,671,138,96
1400000US48001950401,48001950401,"Census Tract 9504.01, Anderson County, Texas",8089,660,5991,532,2098,285
1400000US48001950402,48001950402,"Census Tract 9504.02, Anderson County, Texas",3755,977,3108,853,647,252
1400000US48001950500,48001950500,"Census Tract 9505, Anderson County, Texas",4576,770,3113,627,1463,392
1400000US48001950600,48001950600,"Census Tract 9506, Anderson County, Texas",6114,650,4579,619,1535,429
1400000US48001950700,48001950700,"Census Tract 9507, Anderson County, Texas",3266,408,2517,417,749,235
1400000US48001950800,48001950800,"Census Tract 9508, Anderson County, Texas",4395,506,4065,524,330,252
1400000US48001950901,48001950901,"Census Tract 9509.01, Anderson County, Texas",5268,727,4574,703,694,313
1400000US48001950902,48001950902,"Census Tract 9509.02, Anderson County, Texas",5185,573,4590,544,595,332
1400000US48001951000,48001951000,"Census Tract 9510, Anderson County, Texas",6839,658,6516,647,323,154
1400000US48001951100,48001951100,"Census Tract 9511, Anderson County, Texas",5313,670,5102,665,211,150
1400000US48003950100,48003950100,"Census Tract 9501, Andrews County, Texas",1684,179,1010,178,674,201
1400000US48003950200,48003950200,"Census Tract 9502, Andrews County, Texas",6289,433,3628,343,2661,398
1400000US48003950300,48003950300,"Census Tract 9503, Andrews County, Texas",3754,405,1589,273,2165,370
1400000US48003950400,48003950400,"Census Tract 9504, Andrews County, Texas",2321,224,1188,249,1133,295
1400000US48005000101,48005000101,"Census Tract 1.01, Angelina County, Texas",5992,777,5162,631,830,531
1400000US48005000102,48005000102,"Census Tract 1.02, Angelina County, Texas",5153,632,4546,625,607,411
1400000US48005000200,48005000200,"Census Tract 2, Angelina County, Texas",6751,632,5141,588,1610,500
1400000US48005000301,48005000301,"Census Tract 3.01, Angelina County, Texas",5495,658,4539,603,956,390
1400000US48005000302,48005000302,"Census Tract 3.02, Angelina County, Texas",4176,485,3758,460,418,244
1400000US48005000400,48005000400,"Census Tract 4, Angelina County, Texas",5554,503,4174,418,1380,372
1400000US48005000500,48005000500,"Census Tract 5, Angelina County, Texas",4035,585,3075,437,960,485
1400000US48005000600,48005000600,"Census Tract 6, Angelina County, Texas",6536,755,4092,612,2444,501
1400000US48005000700,48005000700,"Census Tract 7, Angelina County, Texas",3275,443,1656,282,1619,435
1400000US48005000800,48005000800,"Census Tract 8, Angelina County, Texas",6021,658,4952,520,1069,481
1400000US48005000901,48005000901,"Census Tract 9.01, Angelina County, Texas",6504,495,5913,551,591,312
1400000US48005000902,48005000902,"Census Tract 9.02, Angelina County, Texas",3101,420,2839,374,262,193
1400000US48005001001,48005001001,"Census Tract 10.01, Angelina County, Texas",5135,444,2964,379,2171,349
1400000US48005001002,48005001002,"Census Tract 10.02, Angelina County, Texas",3703,553,2755,506,948,422
1400000US48005001100,48005001100,"Census Tract 11, Angelina County, Texas",5911,641,5800,618,111,98
1400000US48005001200,48005001200,"Census Tract 12, Angelina County, Texas",2703,365,2688,364,15,18
1400000US48005001300,48005001300,"Census Tract 13, Angelina County, Texas",5209,622,5188,625,21,33
1400000US48007950100,48007950100,"Census Tract 9501, Aransas County, Texas",5950,529,4992,446,958,311
1400000US48007950200,48007950200,"Census Tract 9502, Aransas County, Texas",1356,181,1256,155,100,108
1400000US48007950300,48007950300,"Census Tract 9503, Aransas County, Texas",6837,556,5280,533,1557,347
1400000US48007950400,48007950400,"Census Tract 9504, Aransas County, Texas",3757,563,2247,516,1510,280
1400000US48007950500,48007950500,"Census Tract 9505, Aransas County, Texas",5347,542,3854,420,1493,378
1400000US48007990000,48007990000,"Census Tract 9900, Aransas County, Texas",0,127,0,127,0,127
1400000US48009020100,48009020100,"Census Tract 201, Archer County, Texas",2866,265,2736,255,130,132
1400000US48009020200,48009020200,"Census Tract 202, Archer County, Texas",2690,218,2573,213,117,70
1400000US48009020300,48009020300,"Census Tract 203, Archer County, Texas",3499,262,3125,239,374,119
1400000US48011950100,48011950100,"Census Tract 9501, Armstrong County, Texas",1958,121,1778,116,180,39
1400000US48013960100,48013960100,"Census Tract 9601, Atascosa County, Texas",6252,657,3068,491,3184,610
1400000US48013960201,48013960201,"Census Tract 9602.01, Atascosa County, Texas",6162,644,2420,372,3742,622
1400000US48013960202,48013960202,"Census Tract 9602.02, Atascosa County, Texas",10179,879,3353,565,6826,826
1400000US48013960300,48013960300,"Census Tract 9603, Atascosa County, Texas",3582,191,470,235,3112,229
1400000US48013960401,48013960401,"Census Tract 9604.01, Atascosa County, Texas",2183,459,314,122,1869,466
1400000US48013960402,48013960402,"Census Tract 9604.02, Atascosa County, Texas",7942,548,3976,485,3966,490
1400000US48013960500,48013960500,"Census Tract 9605, Atascosa County, Texas",1935,269,416,117,1519,273
1400000US48013960600,48013960600,"Census Tract 9606, Atascosa County, Texas",5814,509,3139,513,2675,426
1400000US48015760100,48015760100,"Census Tract 7601, Austin County, Texas",1987,315,1312,221,675,286
1400000US48015760200,48015760200,"Census Tract 7602, Austin County, Texas",6592,566,4468,450,2124,510
1400000US48015760300,48015760300,"Census Tract 7603, Austin County, Texas",6613,689,5046,564,1567,516
1400000US48015760400,48015760400,"Census Tract 7604, Austin County, Texas",3245,428,3020,417,225,195
1400000US48015760501,48015760501,"Census Tract 7605.01, Austin County, Texas",4144,503,3869,483,275,150
1400000US48015760502,48015760502,"Census Tract 7605.02, Austin County, Texas",5202,434,3992,501,1210,446
1400000US48017950100,48017950100,"Census Tract 9501, Bailey County, Texas",7027,,3929,404,3098,404
1400000US48019000101,48019000101,"Census Tract 1.01, Bandera County, Texas",3546,423,3152,420,394,213
1400000US48019000102,48019000102,"Census Tract 1.02, Bandera County, Texas",4811,590,3738,540,1073,532
1400000US48019000200,48019000200,"Census Tract 2, Bandera County, Texas",2504,315,2294,317,210,107
1400000US48019000300,48019000300,"Census Tract 3, Bandera County, Texas",7348,656,6260,572,1088,389
1400000US48019000400,48019000400,"Census Tract 4, Bandera County, Texas",2056,334,1583,249,473,286
1400000US48021950100,48021950100,"Census Tract 9501, Bastrop County, Texas",9577,925,5808,535,3769,907
1400000US48021950200,48021950200,"Census Tract 9502, Bastrop County, Texas",7816,309,4418,510,3398,489
1400000US48021950300,48021950300,"Census Tract 9503, Bastrop County, Texas",11889,931,9547,770,2342,564
1400000US48021950400,48021950400,"Census Tract 9504, Bastrop County, Texas",7927,685,6588,546,1339,534
1400000US48021950501,48021950501,"Census Tract 9505.01, Bastrop County, Texas",7151,544,4521,431,2630,548
1400000US48021950502,48021950502,"Census Tract 9505.02, Bastrop County, Texas",5948,655,5357,668,591,253
1400000US48021950600,48021950600,"Census Tract 9506, Bastrop County, Texas",4375,500,3720,504,655,369
1400000US48021950700,48021950700,"Census Tract 9507, Bastrop County, Texas",4511,352,3635,397,876,312
1400000US48021950801,48021950801,"Census Tract 9508.01, Bastrop County, Texas",6152,847,2155,381,3997,817
1400000US48021950802,48021950802,"Census Tract 9508.02, Bastrop County, Texas",6943,799,4069,708,2874,690
1400000US48023950300,48023950300,"Census Tract 9503, Baylor County, Texas",3795,,3278,161,517,161
1400000US48025950100,48025950100,"Census Tract 9501, Bee County, Texas",2194,334,1292,254,902,237
1400000US48025950201,48025950201,"Census Tract 9502.01, Bee County, Texas",6163,757,2825,373,3338,579
1400000US48025950202,48025950202,"Census Tract 9502.02, Bee County, Texas",6023,747,2972,584,3051,583
1400000US48025950300,48025950300,"Census Tract 9503, Bee County, Texas",3782,497,1538,352,2244,384
1400000US48025950400,48025950400,"Census Tract 9504, Bee County, Texas",1402,307,556,233,846,189
1400000US48025950500,48025950500,"Census Tract 9505, Bee County, Texas",10249,782,4248,479,6001,642
1400000US48025950600,48025950600,"Census Tract 9506, Bee County, Texas",2083,555,693,252,1390,470
1400000US48027020100,48027020100,"Census Tract 201, Bell County, Texas",6869,594,5891,582,978,314
1400000US48027020201,48027020201,"Census Tract 202.01, Bell County, Texas",5278,451,4913,477,365,177
1400000US48027020202,48027020202,"Census Tract 202.02, Bell County, Texas",5420,431,4649,395,771,199
1400000US48027020300,48027020300,"Census Tract 203, Bell County, Texas",7084,625,5852,572,1232,375
1400000US48027020401,48027020401,"Census Tract 204.01, Bell County, Texas",3023,421,2482,414,541,205
1400000US48027020402,48027020402,"Census Tract 204.02, Bell County, Texas",2571,367,2048,343,523,213
1400000US48027020500,48027020500,"Census Tract 205, Bell County, Texas",4008,413,2889,436,1119,271
1400000US48027020600,48027020600,"Census Tract 206, Bell County, Texas",2730,378,2220,305,510,285
1400000US48027020701,48027020701,"Census Tract 207.01, Bell County, Texas",1152,203,847,174,305,115
1400000US48027020702,48027020702,"Census Tract 207.02, Bell County, Texas",1931,389,964,266,967,311
1400000US48027020800,48027020800,"Census Tract 208, Bell County, Texas",3001,611,2211,563,790,383
1400000US48027020900,48027020900,"Census Tract 209, Bell County, Texas",1899,400,1364,299,535,290
1400000US48027021000,48027021000,"Census Tract 210, Bell County, Texas",4226,652,2738,563,1488,397
1400000US48027021100,48027021100,"Census Tract 211, Bell County, Texas",5687,837,4464,745,1223,478
1400000US48027021201,48027021201,"Census Tract 212.01, Bell County, Texas",2965,532,2385,485,580,204
1400000US48027021202,48027021202,"Census Tract 212.02, Bell County, Texas",4504,504,3574,369,930,337
1400000US48027021203,48027021203,"Census Tract 212.03, Bell County, Texas",4267,393,3704,392,563,129
1400000US48027021301,48027021301,"Census Tract 213.01, Bell County, Texas",5763,612,4545,440,1218,494
1400000US48027021302,48027021302,"Census Tract 213.02, Bell County, Texas",2963,320,2874,306,89,59
1400000US48027021303,48027021303,"Census Tract 213.03, Bell County, Texas",5636,673,4281,628,1355,371
1400000US48027021400,48027021400,"Census Tract 214, Bell County, Texas",3612,359,3067,350,545,241
1400000US48027021500,48027021500,"Census Tract 215, Bell County, Texas",5239,667,3575,552,1664,390
1400000US48027021601,48027021601,"Census Tract 216.01, Bell County, Texas",5859,1029,3944,713,1915,601
1400000US48027021602,48027021602,"Census Tract 216.02, Bell County, Texas",2839,499,2473,487,366,149
1400000US48027021700,48027021700,"Census Tract 217, Bell County, Texas",6578,653,5996,665,582,254
1400000US48027021800,48027021800,"Census Tract 218, Bell County, Texas",6550,548,5069,432,1481,527
1400000US48027021901,48027021901,"Census Tract 219.01, Bell County, Texas",3315,349,2815,338,500,158
1400000US48027021903,48027021903,"Census Tract 219.03, Bell County, Texas",8498,735,7294,663,1204,394
1400000US48027021904,48027021904,"Census Tract 219.04, Bell County, Texas",7943,746,6523,712,1420,567
1400000US48027022000,48027022000,"Census Tract 220, Bell County, Texas",8306,860,6777,854,1529,379
1400000US48027022101,48027022101,"Census Tract 221.01, Bell County, Texas",3930,376,3374,360,556,225
1400000US48027022103,48027022103,"Census Tract 221.03, Bell County, Texas",5590,475,4423,496,1167,353
1400000US48027022104,48027022104,"Census Tract 221.04, Bell County, Texas",4320,463,3387,461,933,335
1400000US48027022105,48027022105,"Census Tract 221.05, Bell County, Texas",1844,274,1430,246,414,223
1400000US48027022200,48027022200,"Census Tract 222, Bell County, Texas",3365,448,2497,402,868,312
1400000US48027022300,48027022300,"Census Tract 223, Bell County, Texas",3751,552,2985,438,766,325
1400000US48027022401,48027022401,"Census Tract 224.01, Bell County, Texas",5169,685,3811,594,1358,323
1400000US48027022402,48027022402,"Census Tract 224.02, Bell County, Texas",1648,294,921,327,727,215
1400000US48027022403,48027022403,"Census Tract 224.03, Bell County, Texas",4138,553,3589,580,549,268
1400000US48027022404,48027022404,"Census Tract 224.04, Bell County, Texas",6966,671,5064,597,1902,551
1400000US48027022405,48027022405,"Census Tract 224.05, Bell County, Texas",1824,520,994,291,830,572
1400000US48027022501,48027022501,"Census Tract 225.01, Bell County, Texas",4233,490,2740,494,1493,541
1400000US48027022502,48027022502,"Census Tract 225.02, Bell County, Texas",8478,748,6707,724,1771,559
1400000US48027022600,48027022600,"Census Tract 226, Bell County, Texas",4990,678,3436,525,1554,543
1400000US48027022801,48027022801,"Census Tract 228.01, Bell County, Texas",2874,459,2148,443,726,350
1400000US48027022900,48027022900,"Census Tract 229, Bell County, Texas",3574,469,2845,405,729,252
1400000US48027023000,48027023000,"Census Tract 230, Bell County, Texas",5579,583,4212,470,1367,528
1400000US48027023103,48027023103,"Census Tract 231.03, Bell County, Texas",4296,393,3561,407,735,250
1400000US48027023104,48027023104,"Census Tract 231.04, Bell County, Texas",3895,590,3068,465,827,392
1400000US48027023105,48027023105,"Census Tract 231.05, Bell County, Texas",4625,752,3952,682,673,357
1400000US48027023106,48027023106,"Census Tract 231.06, Bell County, Texas",8869,829,6882,840,1987,545
1400000US48027023107,48027023107,"Census Tract 231.07, Bell County, Texas",7267,742,5668,852,1599,505
1400000US48027023108,48027023108,"Census Tract 231.08, Bell County, Texas",14748,1078,11294,1072,3454,739
1400000US48027023201,48027023201,"Census Tract 232.01, Bell County, Texas",2383,200,1897,278,486,238
1400000US48027023202,48027023202,"Census Tract 232.02, Bell County, Texas",9117,859,7097,886,2020,502
1400000US48027023203,48027023203,"Census Tract 232.03, Bell County, Texas",2820,364,2190,367,630,373
1400000US48027023204,48027023204,"Census Tract 232.04, Bell County, Texas",4374,785,3598,616,776,333
1400000US48027023300,48027023300,"Census Tract 233, Bell County, Texas",5841,590,5112,564,729,237
1400000US48027023402,48027023402,"Census Tract 234.02, Bell County, Texas",3590,381,2923,347,667,198
1400000US48027023403,48027023403,"Census Tract 234.03, Bell County, Texas",4775,384,4442,395,333,131
1400000US48027023404,48027023404,"Census Tract 234.04, Bell County, Texas",2889,429,2459,405,430,138
1400000US48027023500,48027023500,"Census Tract 235, Bell County, Texas",2510,397,1749,348,761,276
1400000US48027980001,48027980001,"Census Tract 9800.01, Bell County, Texas",701,333,474,249,227,183
1400000US48027980002,48027980002,"Census Tract 9800.02, Bell County, Texas",0,127,0,127,0,127
1400000US48027980003,48027980003,"Census Tract 9800.03, Bell County, Texas",0,127,0,127,0,127
1400000US48029110100,48029110100,"Census Tract 1101, Bexar County, Texas",2554,354,928,196,1626,294
1400000US48029110300,48029110300,"Census Tract 1103, Bexar County, Texas",2959,367,701,246,2258,367
1400000US48029110500,48029110500,"Census Tract 1105, Bexar County, Texas",2227,216,115,87,2112,239
1400000US48029110600,48029110600,"Census Tract 1106, Bexar County, Texas",10010,1049,1986,335,8024,993
1400000US48029110700,48029110700,"Census Tract 1107, Bexar County, Texas",1449,270,168,86,1281,263
1400000US48029110800,48029110800,"Census Tract 1108, Bexar County, Texas",1624,450,542,217,1082,348
1400000US48029110900,48029110900,"Census Tract 1109, Bexar County, Texas",335,129,133,82,202,127
1400000US48029111000,48029111000,"Census Tract 1110, Bexar County, Texas",1890,357,331,131,1559,325
1400000US48029120100,48029120100,"Census Tract 1201, Bexar County, Texas",7136,1051,6298,1012,838,167
1400000US48029120300,48029120300,"Census Tract 1203, Bexar County, Texas",7020,40,5729,270,1291,272
1400000US48029120400,48029120400,"Census Tract 1204, Bexar County, Texas",5784,224,4935,276,849,258
1400000US48029120501,48029120501,"Census Tract 1205.01, Bexar County, Texas",8151,641,4322,568,3829,670
1400000US48029120502,48029120502,"Census Tract 1205.02, Bexar County, Texas",4932,428,2112,361,2820,342
1400000US48029120600,48029120600,"Census Tract 1206, Bexar County, Texas",5642,595,3645,398,1997,526
1400000US48029120701,48029120701,"Census Tract 1207.01, Bexar County, Texas",5179,573,2318,288,2861,630
1400000US48029120702,48029120702,"Census Tract 1207.02, Bexar County, Texas",4580,485,3730,328,850,361
1400000US48029120800,48029120800,"Census Tract 1208, Bexar County, Texas",6908,434,5348,482,1560,420
1400000US48029120901,48029120901,"Census Tract 1209.01, Bexar County, Texas",2413,333,1256,173,1157,326
1400000US48029120902,48029120902,"Census Tract 1209.02, Bexar County, Texas",6224,764,3646,511,2578,754
1400000US48029121000,48029121000,"Census Tract 1210, Bexar County, Texas",7670,697,3928,499,3742,791
1400000US48029121108,48029121108,"Census Tract 1211.08, Bexar County, Texas",7389,500,5057,536,2332,389
1400000US48029121110,48029121110,"Census Tract 1211.10, Bexar County, Texas",5021,345,2978,311,2043,285
1400000US48029121111,48029121111,"Census Tract 1211.11, Bexar County, Texas",5991,550,3665,535,2326,414
1400000US48029121112,48029121112,"Census Tract 1211.12, Bexar County, Texas",3676,291,2656,288,1020,260
1400000US48029121115,48029121115,"Census Tract 1211.15, Bexar County, Texas",5094,267,4106,364,988,269
1400000US48029121116,48029121116,"Census Tract 1211.16, Bexar County, Texas",4965,473,3590,361,1375,403
1400000US48029121117,48029121117,"Census Tract 1211.17, Bexar County, Texas",4555,376,3095,432,1460,260
1400000US48029121118,48029121118,"Census Tract 1211.18, Bexar County, Texas",5718,402,3612,372,2106,509
1400000US48029121119,48029121119,"Census Tract 1211.19, Bexar County, Texas",5836,406,3362,368,2474,427
1400000US48029121120,48029121120,"Census Tract 1211.20, Bexar County, Texas",5110,478,3044,385,2066,437
1400000US48029121121,48029121121,"Census Tract 1211.21, Bexar County, Texas",2978,174,2381,192,597,159
1400000US48029121122,48029121122,"Census Tract 1211.22, Bexar County, Texas",5157,457,3360,355,1797,304
1400000US48029121203,48029121203,"Census Tract 1212.03, Bexar County, Texas",3296,403,1298,201,1998,409
1400000US48029121204,48029121204,"Census Tract 1212.04, Bexar County, Texas",7217,582,4652,523,2565,459
1400000US48029121205,48029121205,"Census Tract 1212.05, Bexar County, Texas",3294,452,1360,345,1934,392
1400000US48029121206,48029121206,"Census Tract 1212.06, Bexar County, Texas",7240,565,3550,634,3690,561
1400000US48029121300,48029121300,"Census Tract 1213, Bexar County, Texas",6120,490,4248,475,1872,507
1400000US48029121402,48029121402,"Census Tract 1214.02, Bexar County, Texas",5139,574,2114,472,3025,350
1400000US48029121403,48029121403,"Census Tract 1214.03, Bexar County, Texas",4941,437,2981,427,1960,325
1400000US48029121404,48029121404,"Census Tract 1214.04, Bexar County, Texas",4976,541,2327,315,2649,467
1400000US48029121501,48029121501,"Census Tract 1215.01, Bexar County, Texas",7214,442,4691,429,2523,331
1400000US48029121504,48029121504,"Census Tract 1215.04, Bexar County, Texas",5597,761,4021,691,1576,364
1400000US48029121505,48029121505,"Census Tract 1215.05, Bexar County, Texas",4768,408,2616,442,2152,381
1400000US48029121506,48029121506,"Census Tract 1215.06, Bexar County, Texas",5746,565,2879,417,2867,644
1400000US48029121507,48029121507,"Census Tract 1215.07, Bexar County, Texas",5202,624,3092,389,2110,625
1400000US48029121508,48029121508,"Census Tract 1215.08, Bexar County, Texas",5426,777,3229,740,2197,463
1400000US48029121601,48029121601,"Census Tract 1216.01, Bexar County, Texas",5138,450,3182,519,1956,436
1400000US48029121604,48029121604,"Census Tract 1216.04, Bexar County, Texas",6644,616,4313,527,2331,517
1400000US48029121605,48029121605,"Census Tract 1216.05, Bexar County, Texas",2207,210,1392,232,815,202
1400000US48029121606,48029121606,"Census Tract 1216.06, Bexar County, Texas",4731,328,3239,371,1492,326
1400000US48029121701,48029121701,"Census Tract 1217.01, Bexar County, Texas",3733,476,2652,382,1081,335
1400000US48029121702,48029121702,"Census Tract 1217.02, Bexar County, Texas",6540,518,4844,463,1696,436
1400000US48029121802,48029121802,"Census Tract 1218.02, Bexar County, Texas",7378,621,4036,511,3342,549
1400000US48029121803,48029121803,"Census Tract 1218.03, Bexar County, Texas",4750,481,2223,446,2527,375
1400000US48029121804,48029121804,"Census Tract 1218.04, Bexar County, Texas",6617,591,3249,519,3368,676
1400000US48029121808,48029121808,"Census Tract 1218.08, Bexar County, Texas",3154,325,1689,282,1465,292
1400000US48029121809,48029121809,"Census Tract 1218.09, Bexar County, Texas",4578,375,3291,432,1287,422
1400000US48029121810,48029121810,"Census Tract 1218.10, Bexar County, Texas",4706,324,2861,280,1845,376
1400000US48029121811,48029121811,"Census Tract 1218.11, Bexar County, Texas",4541,254,2341,251,2200,273
1400000US48029121812,48029121812,"Census Tract 1218.12, Bexar County, Texas",6026,569,3404,423,2622,555
1400000US48029121813,48029121813,"Census Tract 1218.13, Bexar County, Texas",2260,331,1433,205,827,358
1400000US48029121903,48029121903,"Census Tract 1219.03, Bexar County, Texas",4948,279,3778,239,1170,238
1400000US48029121904,48029121904,"Census Tract 1219.04, Bexar County, Texas",3626,331,2695,299,931,242
1400000US48029121905,48029121905,"Census Tract 1219.05, Bexar County, Texas",4407,366,3199,387,1208,259
1400000US48029121906,48029121906,"Census Tract 1219.06, Bexar County, Texas",5036,611,3286,462,1750,381
1400000US48029121907,48029121907,"Census Tract 1219.07, Bexar County, Texas",7395,610,4629,476,2766,453
1400000US48029121908,48029121908,"Census Tract 1219.08, Bexar County, Texas",2018,249,1515,257,503,181
1400000US48029121909,48029121909,"Census Tract 1219.09, Bexar County, Texas",3460,408,1597,348,1863,410
1400000US48029121910,48029121910,"Census Tract 1219.10, Bexar County, Texas",3988,211,2673,265,1315,206
1400000US48029130200,48029130200,"Census Tract 1302, Bexar County, Texas",1777,316,833,293,944,265
1400000US48029130300,48029130300,"Census Tract 1303, Bexar County, Texas",3072,487,818,302,2254,434
1400000US48029130401,48029130401,"Census Tract 1304.01, Bexar County, Texas",4057,529,618,189,3439,535
1400000US48029130402,48029130402,"Census Tract 1304.02, Bexar County, Texas",2994,550,1242,433,1752,505
1400000US48029130500,48029130500,"Census Tract 1305, Bexar County, Texas",3602,438,1287,255,2315,459
1400000US48029130600,48029130600,"Census Tract 1306, Bexar County, Texas",4819,607,1793,326,3026,650
1400000US48029130700,48029130700,"Census Tract 1307, Bexar County, Texas",2348,367,407,215,1941,330
1400000US48029130800,48029130800,"Census Tract 1308, Bexar County, Texas",5239,662,3581,475,1658,581
1400000US48029130900,48029130900,"Census Tract 1309, Bexar County, Texas",4256,501,2074,389,2182,556
1400000US48029131000,48029131000,"Census Tract 1310, Bexar County, Texas",4405,443,2864,438,1541,280
1400000US48029131100,48029131100,"Census Tract 1311, Bexar County, Texas",2130,415,1280,378,850,202
1400000US48029131200,48029131200,"Census Tract 1312, Bexar County, Texas",2679,340,1365,249,1314,295
1400000US48029131300,48029131300,"Census Tract 1313, Bexar County, Texas",6200,1112,3394,631,2806,1026
1400000US48029131401,48029131401,"Census Tract 1314.01, Bexar County, Texas",5902,598,2872,516,3030,412
1400000US48029131402,48029131402,"Census Tract 1314.02, Bexar County, Texas",2437,369,1146,249,1291,373
1400000US48029131503,48029131503,"Census Tract 1315.03, Bexar County, Texas",3318,327,2232,412,1086,334
1400000US48029131504,48029131504,"Census Tract 1315.04, Bexar County, Texas",4260,429,2196,359,2064,427
1400000US48029131505,48029131505,"Census Tract 1315.05, Bexar County, Texas",3315,332,1587,322,1728,239
1400000US48029131506,48029131506,"Census Tract 1315.06, Bexar County, Texas",3305,355,1376,290,1929,415
1400000US48029131507,48029131507,"Census Tract 1315.07, Bexar County, Texas",6753,671,2660,458,4093,801
1400000US48029131601,48029131601,"Census Tract 1316.01, Bexar County, Texas",1603,265,1126,209,477,200
1400000US48029131606,48029131606,"Census Tract 1316.06, Bexar County, Texas",4305,391,2927,340,1378,293
1400000US48029131608,48029131608,"Census Tract 1316.08, Bexar County, Texas",4055,548,2310,307,1745,516
1400000US48029131609,48029131609,"Census Tract 1316.09, Bexar County, Texas",7949,698,4809,614,3140,505
1400000US48029131610,48029131610,"Census Tract 1316.10, Bexar County, Texas",6265,568,4020,561,2245,458
1400000US48029131611,48029131611,"Census Tract 1316.11, Bexar County, Texas",1547,282,1053,228,494,235
1400000US48029131612,48029131612,"Census Tract 1316.12, Bexar County, Texas",1149,260,736,137,413,257
1400000US48029131613,48029131613,"Census Tract 1316.13, Bexar County, Texas",5193,401,3285,393,1908,292
1400000US48029131614,48029131614,"Census Tract 1316.14, Bexar County, Texas",3416,368,2249,300,1167,298
1400000US48029131615,48029131615,"Census Tract 1316.15, Bexar County, Texas",6164,760,3477,510,2687,623
1400000US48029131700,48029131700,"Census Tract 1317, Bexar County, Texas",1047,307,1029,302,18,20
1400000US48029131801,48029131801,"Census Tract 1318.01, Bexar County, Texas",2617,325,2055,280,562,324
1400000US48029131802,48029131802,"Census Tract 1318.02, Bexar County, Texas",6068,623,4554,669,1514,338
1400000US48029140100,48029140100,"Census Tract 1401, Bexar County, Texas",1960,317,325,164,1635,268
1400000US48029140200,48029140200,"Census Tract 1402, Bexar County, Texas",3237,390,324,132,2913,391
1400000US48029140300,48029140300,"Census Tract 1403, Bexar County, Texas",3343,424,198,78,3145,446
1400000US48029140400,48029140400,"Census Tract 1404, Bexar County, Texas",3852,414,452,201,3400,447
1400000US48029140500,48029140500,"Census Tract 1405, Bexar County, Texas",4066,388,522,165,3544,420
1400000US48029140600,48029140600,"Census Tract 1406, Bexar County, Texas",2356,357,277,108,2079,331
1400000US48029140700,48029140700,"Census Tract 1407, Bexar County, Texas",4590,420,1134,251,3456,388
1400000US48029140800,48029140800,"Census Tract 1408, Bexar County, Texas",4735,508,711,127,4024,509
1400000US48029140900,48029140900,"Census Tract 1409, Bexar County, Texas",1892,303,184,119,1708,285
1400000US48029141000,48029141000,"Census Tract 1410, Bexar County, Texas",3339,526,568,171,2771,501
1400000US48029141101,48029141101,"Census Tract 1411.01, Bexar County, Texas",5134,1028,1460,584,3674,783
1400000US48029141102,48029141102,"Census Tract 1411.02, Bexar County, Texas",3580,579,598,171,2982,624
1400000US48029141200,48029141200,"Census Tract 1412, Bexar County, Texas",6945,634,1440,245,5505,614
1400000US48029141300,48029141300,"Census Tract 1413, Bexar County, Texas",5485,575,2091,384,3394,460
1400000US48029141402,48029141402,"Census Tract 1414.02, Bexar County, Texas",3545,446,628,184,2917,413
1400000US48029141403,48029141403,"Census Tract 1414.03, Bexar County, Texas",3408,443,757,238,2651,474
1400000US48029141404,48029141404,"Census Tract 1414.04, Bexar County, Texas",4839,644,1646,283,3193,667
1400000US48029141600,48029141600,"Census Tract 1416, Bexar County, Texas",4470,476,475,188,3995,526
1400000US48029141700,48029141700,"Census Tract 1417, Bexar County, Texas",5068,634,1895,342,3173,579
1400000US48029141800,48029141800,"Census Tract 1418, Bexar County, Texas",5159,685,1868,339,3291,604
1400000US48029141900,48029141900,"Census Tract 1419, Bexar County, Texas",5592,641,3848,540,1744,568
1400000US48029150100,48029150100,"Census Tract 1501, Bexar County, Texas",5014,696,210,75,4804,709
1400000US48029150300,48029150300,"Census Tract 1503, Bexar County, Texas",4008,609,271,140,3737,609
1400000US48029150400,48029150400,"Census Tract 1504, Bexar County, Texas",4223,526,108,70,4115,522
1400000US48029150501,48029150501,"Census Tract 1505.01, Bexar County, Texas",3862,337,144,99,3718,339
1400000US48029150502,48029150502,"Census Tract 1505.02, Bexar County, Texas",3898,468,127,113,3771,526
1400000US48029150600,48029150600,"Census Tract 1506, Bexar County, Texas",4339,366,329,179,4010,376
1400000US48029150700,48029150700,"Census Tract 1507, Bexar County, Texas",5817,720,503,238,5314,738
1400000US48029150800,48029150800,"Census Tract 1508, Bexar County, Texas",3140,409,457,199,2683,413
1400000US48029150900,48029150900,"Census Tract 1509, Bexar County, Texas",6001,423,621,197,5380,482
1400000US48029151000,48029151000,"Census Tract 1510, Bexar County, Texas",3631,359,367,175,3264,390
1400000US48029151100,48029151100,"Census Tract 1511, Bexar County, Texas",7218,632,413,251,6805,663
1400000US48029151200,48029151200,"Census Tract 1512, Bexar County, Texas",9868,1286,593,219,9275,1194
1400000US48029151301,48029151301,"Census Tract 1513.01, Bexar County, Texas",5615,723,492,197,5123,737
1400000US48029151302,48029151302,"Census Tract 1513.02, Bexar County, Texas",3611,423,153,104,3458,433
1400000US48029151400,48029151400,"Census Tract 1514, Bexar County, Texas",4380,587,584,189,3796,560
1400000US48029151500,48029151500,"Census Tract 1515, Bexar County, Texas",2561,402,348,179,2213,433
1400000US48029151600,48029151600,"Census Tract 1516, Bexar County, Texas",7662,667,1310,252,6352,689
1400000US48029151700,48029151700,"Census Tract 1517, Bexar County, Texas",6345,623,670,277,5675,669
1400000US48029151900,48029151900,"Census Tract 1519, Bexar County, Texas",5083,579,174,73,4909,575
1400000US48029152000,48029152000,"Census Tract 1520, Bexar County, Texas",1030,314,153,126,877,275
1400000US48029152100,48029152100,"Census Tract 1521, Bexar County, Texas",6228,753,1958,476,4270,715
1400000US48029152201,48029152201,"Census Tract 1522.01, Bexar County, Texas",8674,1136,2568,567,6106,1073
1400000US48029152202,48029152202,"Census Tract 1522.02, Bexar County, Texas",3918,769,1261,325,2657,769
1400000US48029160100,48029160100,"Census Tract 1601, Bexar County, Texas",4936,542,143,164,4793,535
1400000US48029160200,48029160200,"Census Tract 1602, Bexar County, Texas",3286,633,179,129,3107,647
1400000US48029160300,48029160300,"Census Tract 1603, Bexar County, Texas",5582,905,334,173,5248,860
1400000US48029160400,48029160400,"Census Tract 1604, Bexar County, Texas",4582,427,163,88,4419,398
1400000US48029160501,48029160501,"Census Tract 1605.01, Bexar County, Texas",3961,531,200,255,3761,534
1400000US48029160502,48029160502,"Census Tract 1605.02, Bexar County, Texas",4279,534,66,69,4213,535
1400000US48029160600,48029160600,"Census Tract 1606, Bexar County, Texas",4449,681,57,51,4392,674
1400000US48029160701,48029160701,"Census Tract 1607.01, Bexar County, Texas",3099,425,226,125,2873,425
1400000US48029160702,48029160702,"Census Tract 1607.02, Bexar County, Texas",5887,606,405,194,5482,623
1400000US48029160901,48029160901,"Census Tract 1609.01, Bexar County, Texas",3524,625,25,32,3499,628
1400000US48029160902,48029160902,"Census Tract 1609.02, Bexar County, Texas",4731,743,222,186,4509,756
1400000US48029161000,48029161000,"Census Tract 1610, Bexar County, Texas",3571,507,49,37,3522,518
1400000US48029161100,48029161100,"Census Tract 1611, Bexar County, Texas",7816,807,293,164,7523,825
1400000US48029161200,48029161200,"Census Tract 1612, Bexar County, Texas",2898,457,297,181,2601,401
1400000US48029161302,48029161302,"Census Tract 1613.02, Bexar County, Texas",5755,561,686,151,5069,569
1400000US48029161303,48029161303,"Census Tract 1613.03, Bexar County, Texas",4002,544,221,150,3781,565
1400000US48029161304,48029161304,"Census Tract 1613.04, Bexar County, Texas",4304,579,255,118,4049,555
1400000US48029161400,48029161400,"Census Tract 1614, Bexar County, Texas",7875,1578,6906,1298,969,357
1400000US48029161501,48029161501,"Census Tract 1615.01, Bexar County, Texas",7482,698,1664,408,5818,615
1400000US48029161503,48029161503,"Census Tract 1615.03, Bexar County, Texas",3875,508,506,146,3369,504
1400000US48029161504,48029161504,"Census Tract 1615.04, Bexar County, Texas",3708,401,796,149,2912,412
1400000US48029161600,48029161600,"Census Tract 1616, Bexar County, Texas",4866,720,926,220,3940,695
1400000US48029161801,48029161801,"Census Tract 1618.01, Bexar County, Texas",3984,495,1537,289,2447,461
1400000US48029161802,48029161802,"Census Tract 1618.02, Bexar County, Texas",5140,785,1669,542,3471,727
1400000US48029161901,48029161901,"Census Tract 1619.01, Bexar County, Texas",1577,405,404,195,1173,437
1400000US48029161902,48029161902,"Census Tract 1619.02, Bexar County, Texas",7682,811,1994,383,5688,730
1400000US48029162001,48029162001,"Census Tract 1620.01, Bexar County, Texas",2528,513,579,161,1949,502
1400000US48029162003,48029162003,"Census Tract 1620.03, Bexar County, Texas",5366,590,1419,322,3947,537
1400000US48029162004,48029162004,"Census Tract 1620.04, Bexar County, Texas",3916,500,802,338,3114,462
1400000US48029170101,48029170101,"Census Tract 1701.01, Bexar County, Texas",3387,507,246,116,3141,500
1400000US48029170102,48029170102,"Census Tract 1701.02, Bexar County, Texas",3968,673,41,51,3927,681
1400000US48029170200,48029170200,"Census Tract 1702, Bexar County, Texas",5775,459,125,102,5650,456
1400000US48029170300,48029170300,"Census Tract 1703, Bexar County, Texas",5849,526,258,124,5591,508
1400000US48029170401,48029170401,"Census Tract 1704.01, Bexar County, Texas",4311,518,239,86,4072,535
1400000US48029170402,48029170402,"Census Tract 1704.02, Bexar County, Texas",4496,394,238,128,4258,434
1400000US48029170500,48029170500,"Census Tract 1705, Bexar County, Texas",4703,519,389,187,4314,581
1400000US48029170600,48029170600,"Census Tract 1706, Bexar County, Texas",4714,592,618,300,4096,522
1400000US48029170700,48029170700,"Census Tract 1707, Bexar County, Texas",4528,595,246,163,4282,609
1400000US48029170800,48029170800,"Census Tract 1708, Bexar County, Texas",1573,293,38,48,1535,304
1400000US48029170900,48029170900,"Census Tract 1709, Bexar County, Texas",5014,1356,1166,1305,3848,490
1400000US48029171000,48029171000,"Census Tract 1710, Bexar County, Texas",5196,580,163,107,5033,611
1400000US48029171100,48029171100,"Census Tract 1711, Bexar County, Texas",3198,468,371,260,2827,513
1400000US48029171200,48029171200,"Census Tract 1712, Bexar County, Texas",3734,493,61,61,3673,493
1400000US48029171301,48029171301,"Census Tract 1713.01, Bexar County, Texas",2362,543,37,33,2325,539
1400000US48029171302,48029171302,"Census Tract 1713.02, Bexar County, Texas",5944,2164,1204,700,4740,1554
1400000US48029171401,48029171401,"Census Tract 1714.01, Bexar County, Texas",3885,809,349,174,3536,855
1400000US48029171402,48029171402,"Census Tract 1714.02, Bexar County, Texas",4684,669,304,148,4380,657
1400000US48029171501,48029171501,"Census Tract 1715.01, Bexar County, Texas",1947,424,250,226,1697,407
1400000US48029171502,48029171502,"Census Tract 1715.02, Bexar County, Texas",5857,665,891,399,4966,633
1400000US48029171601,48029171601,"Census Tract 1716.01, Bexar County, Texas",3751,670,464,138,3287,663
1400000US48029171602,48029171602,"Census Tract 1716.02, Bexar County, Texas",3667,601,276,171,3391,632
1400000US48029171700,48029171700,"Census Tract 1717, Bexar County, Texas",7461,796,1669,318,5792,838
1400000US48029171801,48029171801,"Census Tract 1718.01, Bexar County, Texas",4989,362,1095,186,3894,323
1400000US48029171802,48029171802,"Census Tract 1718.02, Bexar County, Texas",6279,782,1322,537,4957,711
1400000US48029171902,48029171902,"Census Tract 1719.02, Bexar County, Texas",7172,625,1956,340,5216,601
1400000US48029171903,48029171903,"Census Tract 1719.03, Bexar County, Texas",6793,691,1189,241,5604,699
1400000US48029171912,48029171912,"Census Tract 1719.12, Bexar County, Texas",5435,361,2015,256,3420,309
1400000US48029171913,48029171913,"Census Tract 1719.13, Bexar County, Texas",4478,519,1300,260,3178,523
1400000US48029171914,48029171914,"Census Tract 1719.14, Bexar County, Texas",5373,554,1768,397,3605,531
1400000US48029171915,48029171915,"Census Tract 1719.15, Bexar County, Texas",2219,210,724,156,1495,243
1400000US48029171916,48029171916,"Census Tract 1719.16, Bexar County, Texas",6291,535,2756,512,3535,409
1400000US48029171917,48029171917,"Census Tract 1719.17, Bexar County, Texas",8017,535,3278,423,4739,477
1400000US48029171918,48029171918,"Census Tract 1719.18, Bexar County, Texas",4933,327,2123,360,2810,355
1400000US48029171919,48029171919,"Census Tract 1719.19, Bexar County, Texas",2177,422,887,274,1290,350
1400000US48029171920,48029171920,"Census Tract 1719.20, Bexar County, Texas",8855,656,2590,474,6265,622
1400000US48029171921,48029171921,"Census Tract 1719.21, Bexar County, Texas",6293,608,1703,315,4590,625
1400000US48029171922,48029171922,"Census Tract 1719.22, Bexar County, Texas",3634,473,1124,352,2510,376
1400000US48029171923,48029171923,"Census Tract 1719.23, Bexar County, Texas",6512,655,2689,401,3823,614
1400000US48029171924,48029171924,"Census Tract 1719.24, Bexar County, Texas",4032,484,2145,318,1887,435
1400000US48029171925,48029171925,"Census Tract 1719.25, Bexar County, Texas",9327,507,3816,450,5511,498
1400000US48029172002,48029172002,"Census Tract 1720.02, Bexar County, Texas",6155,553,3306,378,2849,434
1400000US48029172003,48029172003,"Census Tract 1720.03, Bexar County, Texas",6445,432,3660,553,2785,477
1400000US48029172004,48029172004,"Census Tract 1720.04, Bexar County, Texas",2498,472,1385,170,1113,468
1400000US48029172005,48029172005,"Census Tract 1720.05, Bexar County, Texas",1692,330,1016,322,676,168
1400000US48029172006,48029172006,"Census Tract 1720.06, Bexar County, Texas",5466,406,2808,366,2658,424
1400000US48029172007,48029172007,"Census Tract 1720.07, Bexar County, Texas",9024,712,4977,619,4047,407
1400000US48029180101,48029180101,"Census Tract 1801.01, Bexar County, Texas",5434,707,998,392,4436,921
1400000US48029180102,48029180102,"Census Tract 1801.02, Bexar County, Texas",1878,300,500,149,1378,291
1400000US48029180201,48029180201,"Census Tract 1802.01, Bexar County, Texas",5198,510,825,218,4373,513
1400000US48029180202,48029180202,"Census Tract 1802.02, Bexar County, Texas",5856,592,758,260,5098,662
1400000US48029180300,48029180300,"Census Tract 1803, Bexar County, Texas",3865,472,421,159,3444,464
1400000US48029180400,48029180400,"Census Tract 1804, Bexar County, Texas",3770,522,549,222,3221,520
1400000US48029180501,48029180501,"Census Tract 1805.01, Bexar County, Texas",4142,365,839,238,3303,419
1400000US48029180503,48029180503,"Census Tract 1805.03, Bexar County, Texas",4419,460,439,171,3980,493
1400000US48029180504,48029180504,"Census Tract 1805.04, Bexar County, Texas",3965,375,514,297,3451,424
1400000US48029180602,48029180602,"Census Tract 1806.02, Bexar County, Texas",3047,373,1157,214,1890,409
1400000US48029180603,48029180603,"Census Tract 1806.03, Bexar County, Texas",1434,213,642,135,792,200
1400000US48029180604,48029180604,"Census Tract 1806.04, Bexar County, Texas",6215,543,1584,339,4631,619
1400000US48029180701,48029180701,"Census Tract 1807.01, Bexar County, Texas",3823,363,1858,256,1965,362
1400000US48029180702,48029180702,"Census Tract 1807.02, Bexar County, Texas",6082,648,2283,324,3799,684
1400000US48029180800,48029180800,"Census Tract 1808, Bexar County, Texas",2447,259,813,218,1634,265
1400000US48029180901,48029180901,"Census Tract 1809.01, Bexar County, Texas",5265,483,1182,305,4083,483
1400000US48029180902,48029180902,"Census Tract 1809.02, Bexar County, Texas",7861,783,1139,299,6722,775
1400000US48029181001,48029181001,"Census Tract 1810.01, Bexar County, Texas",3344,424,1248,309,2096,282
1400000US48029181003,48029181003,"Census Tract 1810.03, Bexar County, Texas",5406,670,2796,606,2610,455
1400000US48029181004,48029181004,"Census Tract 1810.04, Bexar County, Texas",4442,562,2771,525,1671,427
1400000US48029181005,48029181005,"Census Tract 1810.05, Bexar County, Texas",3191,477,1274,327,1917,435
1400000US48029181100,48029181100,"Census Tract 1811, Bexar County, Texas",5965,412,2849,274,3116,467
1400000US48029181200,48029181200,"Census Tract 1812, Bexar County, Texas",4738,303,3032,273,1706,329
1400000US48029181301,48029181301,"Census Tract 1813.01, Bexar County, Texas",3896,493,2254,380,1642,422
1400000US48029181302,48029181302,"Census Tract 1813.02, Bexar County, Texas",6035,625,2503,414,3532,526
1400000US48029181303,48029181303,"Census Tract 1813.03, Bexar County, Texas",2487,334,1561,325,926,253
1400000US48029181402,48029181402,"Census Tract 1814.02, Bexar County, Texas",2142,273,1116,183,1026,209
1400000US48029181403,48029181403,"Census Tract 1814.03, Bexar County, Texas",5509,566,2650,459,2859,481
1400000US48029181404,48029181404,"Census Tract 1814.04, Bexar County, Texas",3907,448,3035,416,872,330
1400000US48029181503,48029181503,"Census Tract 1815.03, Bexar County, Texas",6607,541,3660,454,2947,508
1400000US48029181504,48029181504,"Census Tract 1815.04, Bexar County, Texas",5733,629,2828,486,2905,444
1400000US48029181505,48029181505,"Census Tract 1815.05, Bexar County, Texas",4501,335,2094,303,2407,344
1400000US48029181506,48029181506,"Census Tract 1815.06, Bexar County, Texas",4263,649,1799,352,2464,696
1400000US48029181601,48029181601,"Census Tract 1816.01, Bexar County, Texas",2724,265,734,143,1990,249
1400000US48029181602,48029181602,"Census Tract 1816.02, Bexar County, Texas",5605,579,1221,377,4384,597
1400000US48029181703,48029181703,"Census Tract 1817.03, Bexar County, Texas",7031,460,3937,487,3094,644
1400000US48029181704,48029181704,"Census Tract 1817.04, Bexar County, Texas",5676,559,2475,370,3201,561
1400000US48029181705,48029181705,"Census Tract 1817.05, Bexar County, Texas",3984,436,1545,300,2439,344
1400000US48029181711,48029181711,"Census Tract 1817.11, Bexar County, Texas",7844,531,4078,497,3766,506
1400000US48029181712,48029181712,"Census Tract 1817.12, Bexar County, Texas",3669,342,1519,256,2150,328
1400000US48029181713,48029181713,"Census Tract 1817.13, Bexar County, Texas",7348,608,2933,493,4415,631
1400000US48029181715,48029181715,"Census Tract 1817.15, Bexar County, Texas",7098,419,2074,395,5024,494
1400000US48029181716,48029181716,"Census Tract 1817.16, Bexar County, Texas",6994,619,2331,412,4663,558
1400000US48029181718,48029181718,"Census Tract 1817.18, Bexar County, Texas",4798,352,2629,316,2169,385
1400000US48029181720,48029181720,"Census Tract 1817.20, Bexar County, Texas",4244,359,2583,399,1661,278
1400000US48029181721,48029181721,"Census Tract 1817.21, Bexar County, Texas",3822,293,1860,304,1962,362
1400000US48029181722,48029181722,"Census Tract 1817.22, Bexar County, Texas",4693,492,2165,310,2528,499
1400000US48029181723,48029181723,"Census Tract 1817.23, Bexar County, Texas",4728,295,1979,281,2749,276
1400000US48029181724,48029181724,"Census Tract 1817.24, Bexar County, Texas",3500,513,1574,224,1926,461
1400000US48029181725,48029181725,"Census Tract 1817.25, Bexar County, Texas",5359,551,1945,417,3414,562
1400000US48029181726,48029181726,"Census Tract 1817.26, Bexar County, Texas",8443,457,3979,339,4464,434
1400000US48029181727,48029181727,"Census Tract 1817.27, Bexar County, Texas",3123,441,950,337,2173,552
1400000US48029181728,48029181728,"Census Tract 1817.28, Bexar County, Texas",9560,678,3016,469,6544,714
1400000US48029181729,48029181729,"Census Tract 1817.29, Bexar County, Texas",2412,391,1280,260,1132,236
1400000US48029181730,48029181730,"Census Tract 1817.30, Bexar County, Texas",4696,485,1738,311,2958,584
1400000US48029181731,48029181731,"Census Tract 1817.31, Bexar County, Texas",6535,479,2977,429,3558,570
1400000US48029181808,48029181808,"Census Tract 1818.08, Bexar County, Texas",1528,296,725,144,803,289
1400000US48029181809,48029181809,"Census Tract 1818.09, Bexar County, Texas",6285,441,2261,365,4024,600
1400000US48029181811,48029181811,"Census Tract 1818.11, Bexar County, Texas",4119,274,2220,232,1899,261
1400000US48029181813,48029181813,"Census Tract 1818.13, Bexar County, Texas",5397,493,2908,406,2489,462
1400000US48029181814,48029181814,"Census Tract 1818.14, Bexar County, Texas",2155,212,1412,224,743,169
1400000US48029181815,48029181815,"Census Tract 1818.15, Bexar County, Texas",2987,249,1881,284,1106,336
1400000US48029181816,48029181816,"Census Tract 1818.16, Bexar County, Texas",3967,299,2204,336,1763,361
1400000US48029181817,48029181817,"Census Tract 1818.17, Bexar County, Texas",2924,289,1259,337,1665,425
1400000US48029181818,48029181818,"Census Tract 1818.18, Bexar County, Texas",4557,514,2473,542,2084,343
1400000US48029181819,48029181819,"Census Tract 1818.19, Bexar County, Texas",4919,420,2682,394,2237,405
1400000US48029181820,48029181820,"Census Tract 1818.20, Bexar County, Texas",4181,634,2796,561,1385,359
1400000US48029181821,48029181821,"Census Tract 1818.21, Bexar County, Texas",2856,269,1546,293,1310,326
1400000US48029181822,48029181822,"Census Tract 1818.22, Bexar County, Texas",4981,401,2822,378,2159,418
1400000US48029181823,48029181823,"Census Tract 1818.23, Bexar County, Texas",2411,417,1404,249,1007,384
1400000US48029181824,48029181824,"Census Tract 1818.24, Bexar County, Texas",4194,381,2227,320,1967,266
1400000US48029181825,48029181825,"Census Tract 1818.25, Bexar County, Texas",2784,366,1645,230,1139,437
1400000US48029181826,48029181826,"Census Tract 1818.26, Bexar County, Texas",6360,527,3509,425,2851,557
1400000US48029181901,48029181901,"Census Tract 1819.01, Bexar County, Texas",2965,494,1944,419,1021,508
1400000US48029181902,48029181902,"Census Tract 1819.02, Bexar County, Texas",5390,381,3922,378,1468,297
1400000US48029182001,48029182001,"Census Tract 1820.01, Bexar County, Texas",4397,405,2808,365,1589,295
1400000US48029182002,48029182002,"Census Tract 1820.02, Bexar County, Texas",8133,410,5424,377,2709,439
1400000US48029182003,48029182003,"Census Tract 1820.03, Bexar County, Texas",2607,344,1758,258,849,295
1400000US48029182101,48029182101,"Census Tract 1821.01, Bexar County, Texas",5859,307,5251,276,608,159
1400000US48029182102,48029182102,"Census Tract 1821.02, Bexar County, Texas",6103,509,4463,408,1640,431
1400000US48029182103,48029182103,"Census Tract 1821.03, Bexar County, Texas",2140,289,1319,189,821,219
1400000US48029182105,48029182105,"Census Tract 1821.05, Bexar County, Texas",1782,298,1147,171,635,208
1400000US48029182106,48029182106,"Census Tract 1821.06, Bexar County, Texas",5393,407,3543,430,1850,291
1400000US48029190100,48029190100,"Census Tract 1901, Bexar County, Texas",3716,465,582,154,3134,473
1400000US48029190200,48029190200,"Census Tract 1902, Bexar County, Texas",3863,414,1456,230,2407,383
1400000US48029190400,48029190400,"Census Tract 1904, Bexar County, Texas",4854,524,4037,463,817,183
1400000US48029190501,48029190501,"Census Tract 1905.01, Bexar County, Texas",2306,384,535,155,1771,368
1400000US48029190503,48029190503,"Census Tract 1905.03, Bexar County, Texas",3030,448,557,188,2473,496
1400000US48029190504,48029190504,"Census Tract 1905.04, Bexar County, Texas",2484,516,339,181,2145,500
1400000US48029190601,48029190601,"Census Tract 1906.01, Bexar County, Texas",3519,443,191,112,3328,454
1400000US48029190603,48029190603,"Census Tract 1906.03, Bexar County, Texas",3205,393,399,247,2806,490
1400000US48029190604,48029190604,"Census Tract 1906.04, Bexar County, Texas",4591,608,492,327,4099,638
1400000US48029190700,48029190700,"Census Tract 1907, Bexar County, Texas",2781,344,1075,260,1706,247
1400000US48029190800,48029190800,"Census Tract 1908, Bexar County, Texas",2247,158,1975,166,272,92
1400000US48029190901,48029190901,"Census Tract 1909.01, Bexar County, Texas",4133,602,1432,344,2701,504
1400000US48029190902,48029190902,"Census Tract 1909.02, Bexar County, Texas",3867,319,1316,231,2551,301
1400000US48029191003,48029191003,"Census Tract 1910.03, Bexar County, Texas",7143,909,2455,775,4688,735
1400000US48029191004,48029191004,"Census Tract 1910.04, Bexar County, Texas",4027,541,558,177,3469,534
1400000US48029191005,48029191005,"Census Tract 1910.05, Bexar County, Texas",1914,324,73,58,1841,317
1400000US48029191006,48029191006,"Census Tract 1910.06, Bexar County, Texas",6139,760,826,439,5313,720
1400000US48029191101,48029191101,"Census Tract 1911.01, Bexar County, Texas",1571,155,1018,159,553,232
1400000US48029191102,48029191102,"Census Tract 1911.02, Bexar County, Texas",2551,160,1685,226,866,223
1400000US48029191201,48029191201,"Census Tract 1912.01, Bexar County, Texas",3469,451,2052,398,1417,370
1400000US48029191202,48029191202,"Census Tract 1912.02, Bexar County, Texas",5806,547,2654,387,3152,599
1400000US48029191303,48029191303,"Census Tract 1913.03, Bexar County, Texas",1623,236,1138,221,485,186
1400000US48029191304,48029191304,"Census Tract 1913.04, Bexar County, Texas",2672,454,738,264,1934,487
1400000US48029191405,48029191405,"Census Tract 1914.05, Bexar County, Texas",7589,478,5167,420,2422,507
1400000US48029191406,48029191406,"Census Tract 1914.06, Bexar County, Texas",6482,458,4875,435,1607,373
1400000US48029191408,48029191408,"Census Tract 1914.08, Bexar County, Texas",3205,408,1594,339,1611,434
1400000US48029191409,48029191409,"Census Tract 1914.09, Bexar County, Texas",5755,508,2820,493,2935,446
1400000US48029191410,48029191410,"Census Tract 1914.10, Bexar County, Texas",5130,577,2757,358,2373,562
1400000US48029191411,48029191411,"Census Tract 1914.11, Bexar County, Texas",4090,541,2620,531,1470,295
1400000US48029191412,48029191412,"Census Tract 1914.12, Bexar County, Texas",2163,187,1572,234,591,285
1400000US48029191413,48029191413,"Census Tract 1914.13, Bexar County, Texas",6492,610,4250,523,2242,500
1400000US48029191503,48029191503,"Census Tract 1915.03, Bexar County, Texas",5046,322,3742,419,1304,317
1400000US48029191504,48029191504,"Census Tract 1915.04, Bexar County, Texas",2158,118,1674,151,484,129
1400000US48029191505,48029191505,"Census Tract 1915.05, Bexar County, Texas",2146,218,1631,240,515,159
1400000US48029191506,48029191506,"Census Tract 1915.06, Bexar County, Texas",4020,380,2499,342,1521,361
1400000US48029191701,48029191701,"Census Tract 1917.01, Bexar County, Texas",1548,206,1337,193,211,134
1400000US48029191702,48029191702,"Census Tract 1917.02, Bexar County, Texas",7060,645,5842,605,1218,274
1400000US48029191804,48029191804,"Census Tract 1918.04, Bexar County, Texas",5531,487,4365,476,1166,254
1400000US48029191806,48029191806,"Census Tract 1918.06, Bexar County, Texas",8026,480,6108,485,1918,444
1400000US48029191807,48029191807,"Census Tract 1918.07, Bexar County, Texas",3380,451,2590,340,790,377
1400000US48029191808,48029191808,"Census Tract 1918.08, Bexar County, Texas",3408,442,2644,392,764,175
1400000US48029191809,48029191809,"Census Tract 1918.09, Bexar County, Texas",4678,713,3513,560,1165,582
1400000US48029191810,48029191810,"Census Tract 1918.10, Bexar County, Texas",4465,537,2817,427,1648,429
1400000US48029191811,48029191811,"Census Tract 1918.11, Bexar County, Texas",3672,734,2436,508,1236,561
1400000US48029191812,48029191812,"Census Tract 1918.12, Bexar County, Texas",3636,231,2529,236,1107,203
1400000US48029191813,48029191813,"Census Tract 1918.13, Bexar County, Texas",6453,480,4573,442,1880,396
1400000US48029191814,48029191814,"Census Tract 1918.14, Bexar County, Texas",3898,458,2722,388,1176,425
1400000US48029191815,48029191815,"Census Tract 1918.15, Bexar County, Texas",5557,442,3587,463,1970,434
1400000US48029191816,48029191816,"Census Tract 1918.16, Bexar County, Texas",2485,270,1745,248,740,210
1400000US48029191817,48029191817,"Census Tract 1918.17, Bexar County, Texas",9086,642,6470,582,2616,509
1400000US48029191900,48029191900,"Census Tract 1919, Bexar County, Texas",4844,640,1502,425,3342,523
1400000US48029192000,48029192000,"Census Tract 1920, Bexar County, Texas",4559,624,2875,513,1684,421
1400000US48029192100,48029192100,"Census Tract 1921, Bexar County, Texas",1822,182,765,158,1057,203
1400000US48029192200,48029192200,"Census Tract 1922, Bexar County, Texas",1783,557,453,173,1330,561
1400000US48029192300,48029192300,"Census Tract 1923, Bexar County, Texas",4317,354,2931,314,1386,363
1400000US48029980001,48029980001,"Census Tract 9800.01, Bexar County, Texas",0,127,0,127,0,127
1400000US48029980002,48029980002,"Census Tract 9800.02, Bexar County, Texas",0,127,0,127,0,127
1400000US48029980003,48029980003,"Census Tract 9800.03, Bexar County, Texas",1257,142,898,128,359,150
1400000US48029980004,48029980004,"Census Tract 9800.04, Bexar County, Texas",0,127,0,127,0,127
1400000US48029980005,48029980005,"Census Tract 9800.05, Bexar County, Texas",0,127,0,127,0,127
1400000US48029980100,48029980100,"Census Tract 9801, Bexar County, Texas",718,301,562,242,156,71
1400000US48031950100,48031950100,"Census Tract 9501, Blanco County, Texas",4550,408,3887,366,663,216
1400000US48031950200,48031950200,"Census Tract 9502, Blanco County, Texas",5535,408,4422,367,1113,216
1400000US48033950100,48033950100,"Census Tract 9501, Borden County, Texas",564,122,453,95,111,83
1400000US48035950100,48035950100,"Census Tract 9501, Bosque County, Texas",4366,334,3538,307,828,193
1400000US48035950200,48035950200,"Census Tract 9502, Bosque County, Texas",1867,536,1444,489,423,156
1400000US48035950300,48035950300,"Census Tract 9503, Bosque County, Texas",1592,217,1435,187,157,139
1400000US48035950400,48035950400,"Census Tract 9504, Bosque County, Texas",3378,380,3173,379,205,117
1400000US48035950500,48035950500,"Census Tract 9505, Bosque County, Texas",3145,130,2334,271,811,264
1400000US48035950600,48035950600,"Census Tract 9506, Bosque County, Texas",1444,283,1444,283,0,127
1400000US48035950700,48035950700,"Census Tract 9507, Bosque County, Texas",2275,242,1944,260,331,170
1400000US48037010100,48037010100,"Census Tract 101, Bowie County, Texas",4723,563,4574,573,149,129
1400000US48037010400,48037010400,"Census Tract 104, Bowie County, Texas",4802,702,4727,701,75,59
1400000US48037010500,48037010500,"Census Tract 105, Bowie County, Texas",2717,613,2481,604,236,184
1400000US48037010600,48037010600,"Census Tract 106, Bowie County, Texas",2574,595,2505,601,69,102
1400000US48037010700,48037010700,"Census Tract 107, Bowie County, Texas",4820,509,4455,554,365,252
1400000US48037010800,48037010800,"Census Tract 108, Bowie County, Texas",5342,853,5211,866,131,149
1400000US48037010901,48037010901,"Census Tract 109.01, Bowie County, Texas",6180,687,5653,731,527,378
1400000US48037010902,48037010902,"Census Tract 109.02, Bowie County, Texas",5948,538,5312,519,636,299
1400000US48037011000,48037011000,"Census Tract 110, Bowie County, Texas",7441,433,6733,357,708,437
1400000US48037011100,48037011100,"Census Tract 111, Bowie County, Texas",7130,596,6426,583,704,148
1400000US48037011200,48037011200,"Census Tract 112, Bowie County, Texas",6402,432,6019,403,383,209
1400000US48037011300,48037011300,"Census Tract 113, Bowie County, Texas",5781,577,5599,551,182,145
1400000US48037011401,48037011401,"Census Tract 114.01, Bowie County, Texas",7502,755,7225,721,277,263
1400000US48037011402,48037011402,"Census Tract 114.02, Bowie County, Texas",2577,285,2475,243,102,106
1400000US48037011501,48037011501,"Census Tract 115.01, Bowie County, Texas",5553,524,5188,488,365,188
1400000US48037011502,48037011502,"Census Tract 115.02, Bowie County, Texas",2906,446,2664,476,242,239
1400000US48037011600,48037011600,"Census Tract 116, Bowie County, Texas",6037,600,5645,583,392,172
1400000US48037011700,48037011700,"Census Tract 117, Bowie County, Texas",2964,472,2792,462,172,179
1400000US48039660100,48039660100,"Census Tract 6601, Brazoria County, Texas",4626,406,4023,421,603,225
1400000US48039660200,48039660200,"Census Tract 6602, Brazoria County, Texas",5748,443,4292,497,1456,510
1400000US48039660300,48039660300,"Census Tract 6603, Brazoria County, Texas",8842,572,6881,512,1961,460
1400000US48039660400,48039660400,"Census Tract 6604, Brazoria County, Texas",7782,582,6328,596,1454,423
1400000US48039660500,48039660500,"Census Tract 6605, Brazoria County, Texas",8824,579,5538,474,3286,547
1400000US48039660601,48039660601,"Census Tract 6606.01, Brazoria County, Texas",12373,732,11226,729,1147,215
1400000US48039660602,48039660602,"Census Tract 6606.02, Brazoria County, Texas",20882,1102,16182,903,4700,718
1400000US48039660701,48039660701,"Census Tract 6607.01, Brazoria County, Texas",15107,876,13067,957,2040,429
1400000US48039660702,48039660702,"Census Tract 6607.02, Brazoria County, Texas",11385,621,9211,621,2174,626
1400000US48039660801,48039660801,"Census Tract 6608.01, Brazoria County, Texas",8083,552,5573,439,2510,443
1400000US48039660802,48039660802,"Census Tract 6608.02, Brazoria County, Texas",6953,493,5311,519,1642,307
1400000US48039660900,48039660900,"Census Tract 6609, Brazoria County, Texas",6403,756,3186,524,3217,660
1400000US48039661000,48039661000,"Census Tract 6610, Brazoria County, Texas",6584,657,4128,496,2456,556
1400000US48039661100,48039661100,"Census Tract 6611, Brazoria County, Texas",2660,446,1614,366,1046,378
1400000US48039661200,48039661200,"Census Tract 6612, Brazoria County, Texas",3341,415,2247,394,1094,291
1400000US48039661300,48039661300,"Census Tract 6613, Brazoria County, Texas",1879,316,1012,257,867,270
1400000US48039661400,48039661400,"Census Tract 6614, Brazoria County, Texas",6314,655,4499,483,1815,477
1400000US48039661501,48039661501,"Census Tract 6615.01, Brazoria County, Texas",5815,758,3642,638,2173,548
1400000US48039661502,48039661502,"Census Tract 6615.02, Brazoria County, Texas",4964,711,4261,794,703,392
1400000US48039661601,48039661601,"Census Tract 6616.01, Brazoria County, Texas",6262,595,4636,487,1626,481
1400000US48039661602,48039661602,"Census Tract 6616.02, Brazoria County, Texas",3685,752,2163,461,1522,649
1400000US48039661700,48039661700,"Census Tract 6617, Brazoria County, Texas",2497,286,1945,338,552,307
1400000US48039661800,48039661800,"Census Tract 6618, Brazoria County, Texas",5283,561,3595,381,1688,556
1400000US48039661900,48039661900,"Census Tract 6619, Brazoria County, Texas",12546,1279,8844,976,3702,479
1400000US48039662000,48039662000,"Census Tract 6620, Brazoria County, Texas",6457,611,5329,569,1128,381
1400000US48039662100,48039662100,"Census Tract 6621, Brazoria County, Texas",4975,492,3482,466,1493,439
1400000US48039662200,48039662200,"Census Tract 6622, Brazoria County, Texas",6725,484,4989,490,1736,422
1400000US48039662300,48039662300,"Census Tract 6623, Brazoria County, Texas",4542,466,3054,330,1488,399
1400000US48039662400,48039662400,"Census Tract 6624, Brazoria County, Texas",5747,536,4283,452,1464,445
1400000US48039662500,48039662500,"Census Tract 6625, Brazoria County, Texas",2741,285,1866,271,875,213
1400000US48039662600,48039662600,"Census Tract 6626, Brazoria County, Texas",3553,482,3171,434,382,207
1400000US48039662700,48039662700,"Census Tract 6627, Brazoria County, Texas",2116,416,1837,400,279,216
1400000US48039662800,48039662800,"Census Tract 6628, Brazoria County, Texas",6409,545,5231,767,1178,476
1400000US48039662900,48039662900,"Census Tract 6629, Brazoria County, Texas",4598,443,3756,414,842,274
1400000US48039663000,48039663000,"Census Tract 6630, Brazoria County, Texas",4258,318,3289,332,969,255
1400000US48039663100,48039663100,"Census Tract 6631, Brazoria County, Texas",5689,686,4730,579,959,315
1400000US48039663200,48039663200,"Census Tract 6632, Brazoria County, Texas",5186,497,4041,382,1145,448
1400000US48039663300,48039663300,"Census Tract 6633, Brazoria County, Texas",2434,365,1526,308,908,376
1400000US48039663400,48039663400,"Census Tract 6634, Brazoria County, Texas",6172,579,5264,570,908,332
1400000US48039663500,48039663500,"Census Tract 6635, Brazoria County, Texas",5878,535,4828,636,1050,449
1400000US48039663600,48039663600,"Census Tract 6636, Brazoria County, Texas",4911,423,4271,460,640,245
1400000US48039663700,48039663700,"Census Tract 6637, Brazoria County, Texas",3476,127,2321,213,1155,197
1400000US48039663800,48039663800,"Census Tract 6638, Brazoria County, Texas",5275,397,2318,352,2957,465
1400000US48039663900,48039663900,"Census Tract 6639, Brazoria County, Texas",2349,357,1051,295,1298,252
1400000US48039664000,48039664000,"Census Tract 6640, Brazoria County, Texas",4123,439,1948,293,2175,429
1400000US48039664100,48039664100,"Census Tract 6641, Brazoria County, Texas",5219,567,3514,455,1705,590
1400000US48039664200,48039664200,"Census Tract 6642, Brazoria County, Texas",2055,249,1679,219,376,163
1400000US48039664300,48039664300,"Census Tract 6643, Brazoria County, Texas",5705,521,2350,521,3355,613
1400000US48039664400,48039664400,"Census Tract 6644, Brazoria County, Texas",6410,507,2435,476,3975,546
1400000US48039664501,48039664501,"Census Tract 6645.01, Brazoria County, Texas",4681,553,3978,535,703,182
1400000US48039990000,48039990000,"Census Tract 9900, Brazoria County, Texas",0,127,0,127,0,127
1400000US48041000101,48041000101,"Census Tract 1.01, Brazos County, Texas",7616,625,5782,440,1834,563
1400000US48041000102,48041000102,"Census Tract 1.02, Brazos County, Texas",6330,494,5628,461,702,295
1400000US48041000103,48041000103,"Census Tract 1.03, Brazos County, Texas",1516,245,1443,277,73,76
1400000US48041000201,48041000201,"Census Tract 2.01, Brazos County, Texas",6135,783,4710,768,1425,411
1400000US48041000202,48041000202,"Census Tract 2.02, Brazos County, Texas",6001,605,4249,526,1752,517
1400000US48041000300,48041000300,"Census Tract 3, Brazos County, Texas",6853,645,3980,532,2873,648
1400000US48041000400,48041000400,"Census Tract 4, Brazos County, Texas",5150,390,3037,364,2113,360
1400000US48041000500,48041000500,"Census Tract 5, Brazos County, Texas",5909,746,3228,506,2681,584
1400000US48041000603,48041000603,"Census Tract 6.03, Brazos County, Texas",5124,581,1747,476,3377,498
1400000US48041000604,48041000604,"Census Tract 6.04, Brazos County, Texas",5587,887,1822,541,3765,715
1400000US48041000700,48041000700,"Census Tract 7, Brazos County, Texas",2746,323,1526,227,1220,262
1400000US48041000800,48041000800,"Census Tract 8, Brazos County, Texas",4723,516,3409,445,1314,439
1400000US48041000900,48041000900,"Census Tract 9, Brazos County, Texas",2830,445,1454,398,1376,356
1400000US48041001000,48041001000,"Census Tract 10, Brazos County, Texas",6408,694,4894,573,1514,515
1400000US48041001100,48041001100,"Census Tract 11, Brazos County, Texas",5374,537,4495,510,879,371
1400000US48041001301,48041001301,"Census Tract 13.01, Brazos County, Texas",2621,334,2074,294,547,193
1400000US48041001302,48041001302,"Census Tract 13.02, Brazos County, Texas",4250,462,3799,430,451,209
1400000US48041001303,48041001303,"Census Tract 13.03, Brazos County, Texas",4721,585,3806,496,915,386
1400000US48041001400,48041001400,"Census Tract 14, Brazos County, Texas",3234,402,3121,376,113,92
1400000US48041001601,48041001601,"Census Tract 16.01, Brazos County, Texas",5655,592,5349,604,306,154
1400000US48041001604,48041001604,"Census Tract 16.04, Brazos County, Texas",4069,516,3580,484,489,292
1400000US48041001605,48041001605,"Census Tract 16.05, Brazos County, Texas",3272,451,2687,432,585,207
1400000US48041001606,48041001606,"Census Tract 16.06, Brazos County, Texas",2771,382,2191,312,580,326
1400000US48041001701,48041001701,"Census Tract 17.01, Brazos County, Texas",4967,500,4114,470,853,367
1400000US48041001702,48041001702,"Census Tract 17.02, Brazos County, Texas",2516,347,2016,440,500,263
1400000US48041001801,48041001801,"Census Tract 18.01, Brazos County, Texas",5829,581,4675,535,1154,412
1400000US48041001803,48041001803,"Census Tract 18.03, Brazos County, Texas",6649,509,5999,559,650,246
1400000US48041001804,48041001804,"Census Tract 18.04, Brazos County, Texas",1567,289,1317,268,250,174
1400000US48041001900,48041001900,"Census Tract 19, Brazos County, Texas",4977,378,4421,387,556,205
1400000US48041002001,48041002001,"Census Tract 20.01, Brazos County, Texas",4298,231,3895,300,403,148
1400000US48041002002,48041002002,"Census Tract 20.02, Brazos County, Texas",5384,461,4812,453,572,143
1400000US48041002006,48041002006,"Census Tract 20.06, Brazos County, Texas",1603,169,1427,158,176,109
1400000US48041002007,48041002007,"Census Tract 20.07, Brazos County, Texas",5254,473,4502,466,752,324
1400000US48041002008,48041002008,"Census Tract 20.08, Brazos County, Texas",4552,341,4091,330,461,203
1400000US48041002009,48041002009,"Census Tract 20.09, Brazos County, Texas",4069,189,3808,227,261,139
1400000US48041002010,48041002010,"Census Tract 20.10, Brazos County, Texas",2244,338,2052,343,192,141
1400000US48041002011,48041002011,"Census Tract 20.11, Brazos County, Texas",2182,285,1939,380,243,215
1400000US48041002012,48041002012,"Census Tract 20.12, Brazos County, Texas",4616,687,4050,681,566,235
1400000US48041002013,48041002013,"Census Tract 20.13, Brazos County, Texas",4560,508,3854,511,706,259
1400000US48041002014,48041002014,"Census Tract 20.14, Brazos County, Texas",1076,202,1002,228,74,63
1400000US48041002015,48041002015,"Census Tract 20.15, Brazos County, Texas",10188,1233,8233,1038,1955,335
1400000US48041980000,48041980000,"Census Tract 9800, Brazos County, Texas",0,127,0,127,0,127
1400000US48043950300,48043950300,"Census Tract 9503, Brewster County, Texas",3931,429,2693,357,1238,280
1400000US48043950400,48043950400,"Census Tract 9504, Brewster County, Texas",2127,295,447,164,1680,281
1400000US48043950500,48043950500,"Census Tract 9505, Brewster County, Texas",2913,386,2081,348,832,245
1400000US48045950200,48045950200,"Census Tract 9502, Briscoe County, Texas",1723,178,1334,175,389,99
1400000US48047950100,48047950100,"Census Tract 9501, Brooks County, Texas",2639,442,216,130,2423,441
1400000US48047950200,48047950200,"Census Tract 9502, Brooks County, Texas",4710,442,315,174,4395,451
1400000US48049950100,48049950100,"Census Tract 9501, Brown County, Texas",2124,338,1907,335,217,106
1400000US48049950200,48049950200,"Census Tract 9502, Brown County, Texas",3981,390,3450,401,531,252
1400000US48049950300,48049950300,"Census Tract 9503, Brown County, Texas",3319,322,3106,317,213,134
1400000US48049950500,48049950500,"Census Tract 9505, Brown County, Texas",3260,365,2575,309,685,227
1400000US48049950600,48049950600,"Census Tract 9506, Brown County, Texas",2526,334,1767,334,759,295
1400000US48049950700,48049950700,"Census Tract 9507, Brown County, Texas",925,464,544,351,381,255
1400000US48049950800,48049950800,"Census Tract 9508, Brown County, Texas",2824,339,1776,294,1048,254
1400000US48049950900,48049950900,"Census Tract 9509, Brown County, Texas",4808,393,3846,355,962,210
1400000US48049951000,48049951000,"Census Tract 9510, Brown County, Texas",2693,301,2240,343,453,231
1400000US48049951100,48049951100,"Census Tract 9511, Brown County, Texas",4146,438,3649,415,497,195
1400000US48049951200,48049951200,"Census Tract 9512, Brown County, Texas",4121,376,3512,346,609,277
1400000US48049951300,48049951300,"Census Tract 9513, Brown County, Texas",3472,582,2567,456,905,252
1400000US48051970100,48051970100,"Census Tract 9701, Burleson County, Texas",1433,371,1228,397,205,184
1400000US48051970200,48051970200,"Census Tract 9702, Burleson County, Texas",5083,583,4421,473,662,420
1400000US48051970300,48051970300,"Census Tract 9703, Burleson County, Texas",4051,222,2859,392,1192,297
1400000US48051970400,48051970400,"Census Tract 9704, Burleson County, Texas",3105,332,2625,330,480,251
1400000US48051970500,48051970500,"Census Tract 9705, Burleson County, Texas",3386,426,2948,396,438,198
1400000US48053960100,48053960100,"Census Tract 9601, Burnet County, Texas",5791,581,4544,547,1247,383
1400000US48053960200,48053960200,"Census Tract 9602, Burnet County, Texas",2347,376,2326,380,21,32
1400000US48053960300,48053960300,"Census Tract 9603, Burnet County, Texas",6577,410,5548,492,1029,313
1400000US48053960400,48053960400,"Census Tract 9604, Burnet County, Texas",5438,586,4586,587,852,478
1400000US48053960500,48053960500,"Census Tract 9605, Burnet County, Texas",5789,247,4084,471,1705,421
1400000US48053960600,48053960600,"Census Tract 9606, Burnet County, Texas",3590,280,3416,264,174,137
1400000US48053960700,48053960700,"Census Tract 9607, Burnet County, Texas",6888,308,4877,665,2011,580
1400000US48053960800,48053960800,"Census Tract 9608, Burnet County, Texas",5795,595,4732,619,1063,363
1400000US48055960101,48055960101,"Census Tract 9601.01, Caldwell County, Texas",5455,849,2574,442,2881,738
1400000US48055960102,48055960102,"Census Tract 9601.02, Caldwell County, Texas",4352,968,3118,629,1234,600
1400000US48055960200,48055960200,"Census Tract 9602, Caldwell County, Texas",6275,927,3472,929,2803,401
1400000US48055960300,48055960300,"Census Tract 9603, Caldwell County, Texas",3477,528,2111,417,1366,339
1400000US48055960400,48055960400,"Census Tract 9604, Caldwell County, Texas",3451,456,1703,335,1748,308
1400000US48055960500,48055960500,"Census Tract 9605, Caldwell County, Texas",6331,614,2858,437,3473,558
1400000US48055960600,48055960600,"Census Tract 9606, Caldwell County, Texas",2328,390,1872,303,456,219
1400000US48055960700,48055960700,"Census Tract 9607, Caldwell County, Texas",5747,236,2536,372,3211,447
1400000US48057000100,48057000100,"Census Tract 1, Calhoun County, Texas",5582,412,3046,369,2536,421
1400000US48057000200,48057000200,"Census Tract 2, Calhoun County, Texas",4172,479,1383,288,2789,442
1400000US48057000300,48057000300,"Census Tract 3, Calhoun County, Texas",1527,502,1223,510,304,104
1400000US48057000400,48057000400,"Census Tract 4, Calhoun County, Texas",6779,570,3589,403,3190,435
1400000US48057000500,48057000500,"Census Tract 5, Calhoun County, Texas",3060,417,2303,380,757,249
1400000US48057990000,48057990000,"Census Tract 9900, Calhoun County, Texas",0,127,0,127,0,127
1400000US48059030101,48059030101,"Census Tract 301.01, Callahan County, Texas",4679,354,4393,380,286,157
1400000US48059030102,48059030102,"Census Tract 301.02, Callahan County, Texas",4385,379,4005,429,380,151
1400000US48059030200,48059030200,"Census Tract 302, Callahan County, Texas",4394,321,4052,343,342,118
1400000US48061010100,48061010100,"Census Tract 101, Cameron County, Texas",6922,893,1054,255,5868,910
1400000US48061010201,48061010201,"Census Tract 102.01, Cameron County, Texas",1611,426,125,105,1486,425
1400000US48061010203,48061010203,"Census Tract 102.03, Cameron County, Texas",7886,850,1809,379,6077,862
1400000US48061010301,48061010301,"Census Tract 103.01, Cameron County, Texas",5074,650,452,328,4622,609
1400000US48061010302,48061010302,"Census Tract 103.02, Cameron County, Texas",7204,885,2257,568,4947,786
1400000US48061010401,48061010401,"Census Tract 104.01, Cameron County, Texas",6363,550,934,251,5429,582
1400000US48061010402,48061010402,"Census Tract 104.02, Cameron County, Texas",6307,750,2246,313,4061,690
1400000US48061010500,48061010500,"Census Tract 105, Cameron County, Texas",2279,437,48,51,2231,430
1400000US48061010601,48061010601,"Census Tract 106.01, Cameron County, Texas",7784,597,997,259,6787,623
1400000US48061010602,48061010602,"Census Tract 106.02, Cameron County, Texas",2143,259,983,308,1160,322
1400000US48061010700,48061010700,"Census Tract 107, Cameron County, Texas",3083,449,593,259,2490,430
1400000US48061010800,48061010800,"Census Tract 108, Cameron County, Texas",7498,641,1959,369,5539,674
1400000US48061010900,48061010900,"Census Tract 109, Cameron County, Texas",1695,416,176,112,1519,424
1400000US48061011000,48061011000,"Census Tract 110, Cameron County, Texas",3372,500,24,27,3348,498
1400000US48061011100,48061011100,"Census Tract 111, Cameron County, Texas",2300,392,28,22,2272,398
1400000US48061011200,48061011200,"Census Tract 112, Cameron County, Texas",1815,274,303,128,1512,286
1400000US48061011301,48061011301,"Census Tract 113.01, Cameron County, Texas",1940,382,889,278,1051,319
1400000US48061011302,48061011302,"Census Tract 113.02, Cameron County, Texas",3579,426,1680,370,1899,341
1400000US48061011400,48061011400,"Census Tract 114, Cameron County, Texas",6329,687,758,195,5571,719
1400000US48061011500,48061011500,"Census Tract 115, Cameron County, Texas",5503,649,332,216,5171,635
1400000US48061011600,48061011600,"Census Tract 116, Cameron County, Texas",6229,610,203,150,6026,608
1400000US48061011700,48061011700,"Census Tract 117, Cameron County, Texas",6809,779,362,156,6447,801
1400000US48061011801,48061011801,"Census Tract 118.01, Cameron County, Texas",5191,570,1072,314,4119,567
1400000US48061011802,48061011802,"Census Tract 118.02, Cameron County, Texas",3528,442,169,111,3359,467
1400000US48061011901,48061011901,"Census Tract 119.01, Cameron County, Texas",6226,570,991,310,5235,561
1400000US48061011902,48061011902,"Census Tract 119.02, Cameron County, Texas",4954,909,1008,230,3946,946
1400000US48061011903,48061011903,"Census Tract 119.03, Cameron County, Texas",2261,331,178,102,2083,317
1400000US48061012001,48061012001,"Census Tract 120.01, Cameron County, Texas",5475,781,2046,444,3429,780
1400000US48061012002,48061012002,"Census Tract 120.02, Cameron County, Texas",5625,651,1175,273,4450,621
1400000US48061012101,48061012101,"Census Tract 121.01, Cameron County, Texas",4381,570,1754,290,2627,539
1400000US48061012102,48061012102,"Census Tract 121.02, Cameron County, Texas",5404,725,150,121,5254,738
1400000US48061012200,48061012200,"Census Tract 122, Cameron County, Texas",10695,1347,935,297,9760,1319
1400000US48061012301,48061012301,"Census Tract 123.01, Cameron County, Texas",3825,351,1862,331,1963,396
1400000US48061012304,48061012304,"Census Tract 123.04, Cameron County, Texas",4481,314,1115,368,3366,431
1400000US48061012305,48061012305,"Census Tract 123.05, Cameron County, Texas",3608,281,2886,406,722,306
1400000US48061012401,48061012401,"Census Tract 124.01, Cameron County, Texas",5651,652,807,295,4844,603
1400000US48061012402,48061012402,"Census Tract 124.02, Cameron County, Texas",4882,518,1011,328,3871,478
1400000US48061012504,48061012504,"Census Tract 125.04, Cameron County, Texas",14869,923,1083,270,13786,932
1400000US48061012505,48061012505,"Census Tract 125.05, Cameron County, Texas",9623,962,247,171,9376,946
1400000US48061012506,48061012506,"Census Tract 125.06, Cameron County, Texas",3598,431,1036,162,2562,413
1400000US48061012507,48061012507,"Census Tract 125.07, Cameron County, Texas",6300,590,368,180,5932,615
1400000US48061012508,48061012508,"Census Tract 125.08, Cameron County, Texas",2358,440,441,207,1917,439
1400000US48061012607,48061012607,"Census Tract 126.07, Cameron County, Texas",2430,376,0,127,2430,376
1400000US48061012608,48061012608,"Census Tract 126.08, Cameron County, Texas",3501,457,502,187,2999,431
1400000US48061012609,48061012609,"Census Tract 126.09, Cameron County, Texas",8788,842,0,127,8788,842
1400000US48061012612,48061012612,"Census Tract 126.12, Cameron County, Texas",6595,407,578,200,6017,395
1400000US48061012613,48061012613,"Census Tract 126.13, Cameron County, Texas",4930,557,716,180,4214,543
1400000US48061012700,48061012700,"Census Tract 127, Cameron County, Texas",5944,748,392,209,5552,783
1400000US48061012800,48061012800,"Census Tract 128, Cameron County, Texas",4252,521,113,146,4139,568
1400000US48061012900,48061012900,"Census Tract 129, Cameron County, Texas",3907,481,667,252,3240,485
1400000US48061013002,48061013002,"Census Tract 130.02, Cameron County, Texas",4261,467,744,219,3517,462
1400000US48061013003,48061013003,"Census Tract 130.03, Cameron County, Texas",2104,299,99,69,2005,289
1400000US48061013004,48061013004,"Census Tract 130.04, Cameron County, Texas",2517,409,213,118,2304,401
1400000US48061013102,48061013102,"Census Tract 131.02, Cameron County, Texas",3225,291,416,143,2809,274
1400000US48061013104,48061013104,"Census Tract 131.04, Cameron County, Texas",3969,327,529,143,3440,342
1400000US48061013106,48061013106,"Census Tract 131.06, Cameron County, Texas",3892,748,208,124,3684,751
1400000US48061013203,48061013203,"Census Tract 132.03, Cameron County, Texas",2385,514,77,47,2308,523
1400000US48061013204,48061013204,"Census Tract 132.04, Cameron County, Texas",2495,606,114,78,2381,605
1400000US48061013205,48061013205,"Census Tract 132.05, Cameron County, Texas",3721,463,68,52,3653,463
1400000US48061013206,48061013206,"Census Tract 132.06, Cameron County, Texas",3612,563,10,17,3602,562
1400000US48061013207,48061013207,"Census Tract 132.07, Cameron County, Texas",4554,569,333,168,4221,553
1400000US48061013303,48061013303,"Census Tract 133.03, Cameron County, Texas",4061,448,179,95,3882,436
1400000US48061013305,48061013305,"Census Tract 133.05, Cameron County, Texas",4727,629,23,24,4704,627
1400000US48061013306,48061013306,"Census Tract 133.06, Cameron County, Texas",3599,565,29,46,3570,561
1400000US48061013307,48061013307,"Census Tract 133.07, Cameron County, Texas",1758,379,43,54,1715,408
1400000US48061013308,48061013308,"Census Tract 133.08, Cameron County, Texas",3626,485,58,61,3568,480
1400000US48061013309,48061013309,"Census Tract 133.09, Cameron County, Texas",3397,463,0,127,3397,463
1400000US48061013401,48061013401,"Census Tract 134.01, Cameron County, Texas",2540,447,143,97,2397,446
1400000US48061013402,48061013402,"Census Tract 134.02, Cameron County, Texas",1962,369,58,56,1904,370
1400000US48061013500,48061013500,"Census Tract 135, Cameron County, Texas",2786,284,467,121,2319,307
1400000US48061013600,48061013600,"Census Tract 136, Cameron County, Texas",3203,488,370,184,2833,476
1400000US48061013700,48061013700,"Census Tract 137, Cameron County, Texas",3800,578,148,93,3652,608
1400000US48061013801,48061013801,"Census Tract 138.01, Cameron County, Texas",3170,418,71,50,3099,413
1400000US48061013802,48061013802,"Census Tract 138.02, Cameron County, Texas",3318,332,31,38,3287,341
1400000US48061013901,48061013901,"Census Tract 139.01, Cameron County, Texas",2983,582,20,30,2963,581
1400000US48061013902,48061013902,"Census Tract 139.02, Cameron County, Texas",4702,532,31,40,4671,523
1400000US48061013903,48061013903,"Census Tract 139.03, Cameron County, Texas",4507,637,119,161,4388,620
1400000US48061014001,48061014001,"Census Tract 140.01, Cameron County, Texas",2015,366,265,164,1750,352
1400000US48061014002,48061014002,"Census Tract 140.02, Cameron County, Texas",2436,417,19,28,2417,417
1400000US48061014100,48061014100,"Census Tract 141, Cameron County, Texas",11189,1049,80,50,11109,1048
1400000US48061014200,48061014200,"Census Tract 142, Cameron County, Texas",4845,691,275,223,4570,748
1400000US48061014300,48061014300,"Census Tract 143, Cameron County, Texas",4256,431,388,170,3868,432
1400000US48061014400,48061014400,"Census Tract 144, Cameron County, Texas",12315,918,1254,349,11061,893
1400000US48061014500,48061014500,"Census Tract 145, Cameron County, Texas",8572,675,1139,343,7433,738
1400000US48061980001,48061980001,"Census Tract 9800.01, Cameron County, Texas",0,127,0,127,0,127
1400000US48061980100,48061980100,"Census Tract 9801, Cameron County, Texas",57,79,0,127,57,79
1400000US48061990000,48061990000,"Census Tract 9900, Cameron County, Texas",0,127,0,127,0,127
1400000US48063950101,48063950101,"Census Tract 9501.01, Camp County, Texas",3018,328,2758,296,260,213
1400000US48063950102,48063950102,"Census Tract 9501.02, Camp County, Texas",4293,392,3611,356,682,309
1400000US48063950200,48063950200,"Census Tract 9502, Camp County, Texas",4977,217,3524,295,1453,257
1400000US48065950100,48065950100,"Census Tract 9501, Carson County, Texas",2459,212,2331,218,128,62
1400000US48065950200,48065950200,"Census Tract 9502, Carson County, Texas",3825,212,3457,218,368,62
1400000US48067950100,48067950100,"Census Tract 9501, Cass County, Texas",6423,432,6252,425,171,108
1400000US48067950200,48067950200,"Census Tract 9502, Cass County, Texas",2636,329,2634,330,2,4
1400000US48067950300,48067950300,"Census Tract 9503, Cass County, Texas",1731,207,1710,206,21,24
1400000US48067950400,48067950400,"Census Tract 9504, Cass County, Texas",5306,267,5210,279,96,88
1400000US48067950500,48067950500,"Census Tract 9505, Cass County, Texas",2759,280,2689,277,70,70
1400000US48067950600,48067950600,"Census Tract 9506, Cass County, Texas",6468,548,6057,553,411,150
1400000US48067950700,48067950700,"Census Tract 9507, Cass County, Texas",4931,452,4668,440,263,115
1400000US48069950100,48069950100,"Census Tract 9501, Castro County, Texas",1503,195,1085,200,418,174
1400000US48069950200,48069950200,"Census Tract 9502, Castro County, Texas",4254,30,1409,206,2845,201
1400000US48069950300,48069950300,"Census Tract 9503, Castro County, Texas",2091,192,926,192,1165,217
1400000US48071710100,48071710100,"Census Tract 7101, Chambers County, Texas",6764,492,5890,536,874,236
1400000US48071710200,48071710200,"Census Tract 7102, Chambers County, Texas",15253,574,12216,610,3037,378
1400000US48071710300,48071710300,"Census Tract 7103, Chambers County, Texas",2245,373,1957,351,288,190
1400000US48071710401,48071710401,"Census Tract 7104.01, Chambers County, Texas",4935,517,4013,480,922,331
1400000US48071710500,48071710500,"Census Tract 7105, Chambers County, Texas",3174,432,2386,381,788,292
1400000US48071710600,48071710600,"Census Tract 7106, Chambers County, Texas",0,127,0,127,0,127
1400000US48071990000,48071990000,"Census Tract 9900, Chambers County, Texas",0,127,0,127,0,127
1400000US48073950100,48073950100,"Census Tract 9501, Cherokee County, Texas",4209,416,3069,326,1140,331
1400000US48073950200,48073950200,"Census Tract 9502, Cherokee County, Texas",5062,613,4992,592,70,95
1400000US48073950300,48073950300,"Census Tract 9503, Cherokee County, Texas",7183,716,5909,600,1274,528
1400000US48073950400,48073950400,"Census Tract 9504, Cherokee County, Texas",1867,332,1558,307,309,221
1400000US48073950500,48073950500,"Census Tract 9505, Cherokee County, Texas",4062,518,2338,314,1724,514
1400000US48073950600,48073950600,"Census Tract 9506, Cherokee County, Texas",5821,539,3979,581,1842,410
1400000US48073950700,48073950700,"Census Tract 9507, Cherokee County, Texas",3877,451,2299,327,1578,389
1400000US48073950801,48073950801,"Census Tract 9508.01, Cherokee County, Texas",5138,773,4688,738,450,429
1400000US48073950802,48073950802,"Census Tract 9508.02, Cherokee County, Texas",3172,676,2725,629,447,280
1400000US48073950900,48073950900,"Census Tract 9509, Cherokee County, Texas",4366,516,3881,475,485,151
1400000US48073951000,48073951000,"Census Tract 9510, Cherokee County, Texas",3606,500,3393,468,213,152
1400000US48073951100,48073951100,"Census Tract 9511, Cherokee County, Texas",1672,250,1582,237,90,81
1400000US48075950100,48075950100,"Census Tract 9501, Childress County, Texas",2348,235,1638,218,710,117
1400000US48075950200,48075950200,"Census Tract 9502, Childress County, Texas",4767,235,3699,268,1068,241
1400000US48077030200,48077030200,"Census Tract 302, Clay County, Texas",3338,106,3263,113,75,65
1400000US48077030301,48077030301,"Census Tract 303.01, Clay County, Texas",4719,185,4463,178,256,83
1400000US48077030302,48077030302,"Census Tract 303.02, Clay County, Texas",2865,188,2751,180,114,62
1400000US48079950100,48079950100,"Census Tract 9501, Cochran County, Texas",3155,,1566,,1589,
1400000US48081950100,48081950100,"Census Tract 9501, Coke County, Texas",1522,234,1217,187,305,117
1400000US48081950200,48081950200,"Census Tract 9502, Coke County, Texas",1779,257,1470,241,309,98
1400000US48083950300,48083950300,"Census Tract 9503, Coleman County, Texas",4613,185,3673,244,940,152
1400000US48083950600,48083950600,"Census Tract 9506, Coleman County, Texas",1544,258,1493,248,51,46
1400000US48083950700,48083950700,"Census Tract 9507, Coleman County, Texas",2700,202,2351,244,349,155
1400000US48085030100,48085030100,"Census Tract 301, Collin County, Texas",6202,518,5653,494,549,176
1400000US48085030201,48085030201,"Census Tract 302.01, Collin County, Texas",2592,402,2327,327,265,144
1400000US48085030202,48085030202,"Census Tract 302.02, Collin County, Texas",2294,277,2125,283,169,119
1400000US48085030203,48085030203,"Census Tract 302.03, Collin County, Texas",12041,532,9355,665,2686,621
1400000US48085030301,48085030301,"Census Tract 303.01, Collin County, Texas",1699,216,1536,203,163,127
1400000US48085030302,48085030302,"Census Tract 303.02, Collin County, Texas",1823,202,1790,205,33,38
1400000US48085030303,48085030303,"Census Tract 303.03, Collin County, Texas",3547,333,3466,340,81,59
1400000US48085030304,48085030304,"Census Tract 303.04, Collin County, Texas",2654,319,2083,293,571,355
1400000US48085030305,48085030305,"Census Tract 303.05, Collin County, Texas",7510,378,6197,528,1313,407
1400000US48085030403,48085030403,"Census Tract 304.03, Collin County, Texas",5163,400,4438,449,725,250
1400000US48085030404,48085030404,"Census Tract 304.04, Collin County, Texas",5771,391,4921,355,850,204
1400000US48085030405,48085030405,"Census Tract 304.05, Collin County, Texas",4018,333,3414,332,604,285
1400000US48085030406,48085030406,"Census Tract 304.06, Collin County, Texas",2423,396,1549,224,874,397
1400000US48085030407,48085030407,"Census Tract 304.07, Collin County, Texas",3196,216,2806,251,390,218
1400000US48085030408,48085030408,"Census Tract 304.08, Collin County, Texas",6123,732,3547,571,2576,813
1400000US48085030504,48085030504,"Census Tract 305.04, Collin County, Texas",2189,178,2107,166,82,93
1400000US48085030505,48085030505,"Census Tract 305.05, Collin County, Texas",1676,262,1481,328,195,184
1400000US48085030506,48085030506,"Census Tract 305.06, Collin County, Texas",2623,179,2404,208,219,125
1400000US48085030507,48085030507,"Census Tract 305.07, Collin County, Texas",1744,96,1635,141,109,107
1400000US48085030508,48085030508,"Census Tract 305.08, Collin County, Texas",6483,371,6215,370,268,130
1400000US48085030509,48085030509,"Census Tract 305.09, Collin County, Texas",2338,177,2041,240,297,176
1400000US48085030510,48085030510,"Census Tract 305.10, Collin County, Texas",2639,220,2468,251,171,86
1400000US48085030511,48085030511,"Census Tract 305.11, Collin County, Texas",4284,305,3659,295,625,163
1400000US48085030512,48085030512,"Census Tract 305.12, Collin County, Texas",4407,231,4198,209,209,103
1400000US48085030513,48085030513,"Census Tract 305.13, Collin County, Texas",1617,368,1387,391,230,188
1400000US48085030514,48085030514,"Census Tract 305.14, Collin County, Texas",6608,354,5844,402,764,194
1400000US48085030515,48085030515,"Census Tract 305.15, Collin County, Texas",6079,527,5259,456,820,310
1400000US48085030516,48085030516,"Census Tract 305.16, Collin County, Texas",4322,211,3943,271,379,136
1400000US48085030517,48085030517,"Census Tract 305.17, Collin County, Texas",4610,228,4280,297,330,167
1400000US48085030518,48085030518,"Census Tract 305.18, Collin County, Texas",1336,150,1087,178,249,159
1400000US48085030519,48085030519,"Census Tract 305.19, Collin County, Texas",786,205,710,235,76,74
1400000US48085030520,48085030520,"Census Tract 305.20, Collin County, Texas",3244,287,2813,317,431,117
1400000US48085030521,48085030521,"Census Tract 305.21, Collin County, Texas",2486,241,1915,285,571,289
1400000US48085030522,48085030522,"Census Tract 305.22, Collin County, Texas",2273,224,1789,183,484,158
1400000US48085030523,48085030523,"Census Tract 305.23, Collin County, Texas",6391,376,5298,387,1093,376
1400000US48085030524,48085030524,"Census Tract 305.24, Collin County, Texas",1990,121,1671,211,319,164
1400000US48085030525,48085030525,"Census Tract 305.25, Collin County, Texas",6061,243,5590,300,471,207
1400000US48085030526,48085030526,"Census Tract 305.26, Collin County, Texas",5794,419,5271,335,523,269
1400000US48085030527,48085030527,"Census Tract 305.27, Collin County, Texas",3580,378,2958,304,622,266
1400000US48085030528,48085030528,"Census Tract 305.28, Collin County, Texas",6887,374,6658,403,229,129
1400000US48085030529,48085030529,"Census Tract 305.29, Collin County, Texas",3078,428,2886,426,192,108
1400000US48085030530,48085030530,"Census Tract 305.30, Collin County, Texas",6486,359,6226,353,260,159
1400000US48085030531,48085030531,"Census Tract 305.31, Collin County, Texas",5092,286,4812,311,280,84
1400000US48085030601,48085030601,"Census Tract 306.01, Collin County, Texas",8403,413,8033,419,370,207
1400000US48085030603,48085030603,"Census Tract 306.03, Collin County, Texas",7092,669,5637,655,1455,601
1400000US48085030604,48085030604,"Census Tract 306.04, Collin County, Texas",3064,252,2648,263,416,136
1400000US48085030605,48085030605,"Census Tract 306.05, Collin County, Texas",5650,476,4589,481,1061,372
1400000US48085030701,48085030701,"Census Tract 307.01, Collin County, Texas",3702,500,2717,423,985,399
1400000US48085030702,48085030702,"Census Tract 307.02, Collin County, Texas",4460,464,2507,287,1953,445
1400000US48085030801,48085030801,"Census Tract 308.01, Collin County, Texas",3425,447,1999,261,1426,463
1400000US48085030802,48085030802,"Census Tract 308.02, Collin County, Texas",5816,634,3982,647,1834,618
1400000US48085030900,48085030900,"Census Tract 309, Collin County, Texas",8805,985,4117,633,4688,941
1400000US48085031001,48085031001,"Census Tract 310.01, Collin County, Texas",6818,532,5206,524,1612,460
1400000US48085031003,48085031003,"Census Tract 310.03, Collin County, Texas",3879,465,2955,380,924,263
1400000US48085031004,48085031004,"Census Tract 310.04, Collin County, Texas",5683,692,4549,560,1134,663
1400000US48085031100,48085031100,"Census Tract 311, Collin County, Texas",9390,790,7889,873,1501,575
1400000US48085031201,48085031201,"Census Tract 312.01, Collin County, Texas",3925,325,3539,329,386,91
1400000US48085031202,48085031202,"Census Tract 312.02, Collin County, Texas",3641,471,3171,478,470,271
1400000US48085031308,48085031308,"Census Tract 313.08, Collin County, Texas",6179,446,5477,339,702,253
1400000US48085031309,48085031309,"Census Tract 313.09, Collin County, Texas",8631,514,7706,517,925,246
1400000US48085031310,48085031310,"Census Tract 313.10, Collin County, Texas",8486,579,6819,732,1667,496
1400000US48085031311,48085031311,"Census Tract 313.11, Collin County, Texas",8069,565,6967,585,1102,306
1400000US48085031312,48085031312,"Census Tract 313.12, Collin County, Texas",6175,396,5681,385,494,251
1400000US48085031313,48085031313,"Census Tract 313.13, Collin County, Texas",10911,499,9966,554,945,334
1400000US48085031314,48085031314,"Census Tract 313.14, Collin County, Texas",1926,331,1898,338,28,32
1400000US48085031315,48085031315,"Census Tract 313.15, Collin County, Texas",14091,621,12186,615,1905,343
1400000US48085031316,48085031316,"Census Tract 313.16, Collin County, Texas",6467,439,6068,435,399,212
1400000US48085031317,48085031317,"Census Tract 313.17, Collin County, Texas",6773,396,5989,402,784,318
1400000US48085031405,48085031405,"Census Tract 314.05, Collin County, Texas",14083,725,13250,723,833,276
1400000US48085031406,48085031406,"Census Tract 314.06, Collin County, Texas",14615,623,13277,728,1338,428
1400000US48085031407,48085031407,"Census Tract 314.07, Collin County, Texas",6758,452,6440,464,318,141
1400000US48085031408,48085031408,"Census Tract 314.08, Collin County, Texas",3341,357,2611,411,730,377
1400000US48085031409,48085031409,"Census Tract 314.09, Collin County, Texas",9677,479,8419,384,1258,395
1400000US48085031410,48085031410,"Census Tract 314.10, Collin County, Texas",8440,363,7412,533,1028,394
1400000US48085031411,48085031411,"Census Tract 314.11, Collin County, Texas",4476,377,3980,424,496,172
1400000US48085031504,48085031504,"Census Tract 315.04, Collin County, Texas",6778,400,5995,414,783,229
1400000US48085031505,48085031505,"Census Tract 315.05, Collin County, Texas",7318,342,7014,384,304,144
1400000US48085031506,48085031506,"Census Tract 315.06, Collin County, Texas",7829,621,6028,675,1801,588
1400000US48085031507,48085031507,"Census Tract 315.07, Collin County, Texas",3631,273,3574,280,57,62
1400000US48085031508,48085031508,"Census Tract 315.08, Collin County, Texas",5157,528,4451,490,706,322
1400000US48085031611,48085031611,"Census Tract 316.11, Collin County, Texas",3548,327,2742,305,806,288
1400000US48085031612,48085031612,"Census Tract 316.12, Collin County, Texas",6250,433,5860,444,390,166
1400000US48085031613,48085031613,"Census Tract 316.13, Collin County, Texas",5555,277,4792,343,763,321
1400000US48085031621,48085031621,"Census Tract 316.21, Collin County, Texas",6407,485,5907,529,500,231
1400000US48085031622,48085031622,"Census Tract 316.22, Collin County, Texas",5231,391,4818,368,413,200
1400000US48085031623,48085031623,"Census Tract 316.23, Collin County, Texas",3073,286,2271,319,802,206
1400000US48085031624,48085031624,"Census Tract 316.24, Collin County, Texas",3510,400,2216,314,1294,421
1400000US48085031625,48085031625,"Census Tract 316.25, Collin County, Texas",4119,206,3753,216,366,115
1400000US48085031626,48085031626,"Census Tract 316.26, Collin County, Texas",2392,240,2258,232,134,101
1400000US48085031627,48085031627,"Census Tract 316.27, Collin County, Texas",4723,265,4074,297,649,261
1400000US48085031628,48085031628,"Census Tract 316.28, Collin County, Texas",3907,301,2886,378,1021,433
1400000US48085031629,48085031629,"Census Tract 316.29, Collin County, Texas",3363,387,2471,361,892,324
1400000US48085031630,48085031630,"Census Tract 316.30, Collin County, Texas",4350,178,4033,201,317,108
1400000US48085031631,48085031631,"Census Tract 316.31, Collin County, Texas",4505,318,4157,340,348,182
1400000US48085031632,48085031632,"Census Tract 316.32, Collin County, Texas",5447,306,5039,312,408,138
1400000US48085031633,48085031633,"Census Tract 316.33, Collin County, Texas",3690,271,3297,256,393,82
1400000US48085031634,48085031634,"Census Tract 316.34, Collin County, Texas",2863,312,2373,276,490,191
1400000US48085031635,48085031635,"Census Tract 316.35, Collin County, Texas",3809,407,3179,442,630,203
1400000US48085031636,48085031636,"Census Tract 316.36, Collin County, Texas",6024,335,5726,313,298,198
1400000US48085031637,48085031637,"Census Tract 316.37, Collin County, Texas",7366,310,7115,325,251,99
1400000US48085031638,48085031638,"Census Tract 316.38, Collin County, Texas",7373,304,7002,352,371,118
1400000US48085031639,48085031639,"Census Tract 316.39, Collin County, Texas",4478,247,4290,275,188,132
1400000US48085031640,48085031640,"Census Tract 316.40, Collin County, Texas",6479,435,5811,483,668,347
1400000US48085031641,48085031641,"Census Tract 316.41, Collin County, Texas",6822,372,6425,425,397,139
1400000US48085031642,48085031642,"Census Tract 316.42, Collin County, Texas",4748,254,4504,293,244,173
1400000US48085031643,48085031643,"Census Tract 316.43, Collin County, Texas",4198,293,3429,287,769,301
1400000US48085031645,48085031645,"Census Tract 316.45, Collin County, Texas",2245,122,2150,139,95,80
1400000US48085031646,48085031646,"Census Tract 316.46, Collin County, Texas",5633,309,5307,312,326,192
1400000US48085031647,48085031647,"Census Tract 316.47, Collin County, Texas",3434,461,3050,425,384,242
1400000US48085031648,48085031648,"Census Tract 316.48, Collin County, Texas",7293,443,6588,490,705,384
1400000US48085031649,48085031649,"Census Tract 316.49, Collin County, Texas",4816,420,4701,432,115,76
1400000US48085031652,48085031652,"Census Tract 316.52, Collin County, Texas",7185,537,6664,556,521,301
1400000US48085031653,48085031653,"Census Tract 316.53, Collin County, Texas",6791,620,6114,633,677,255
1400000US48085031654,48085031654,"Census Tract 316.54, Collin County, Texas",3523,185,3370,212,153,122
1400000US48085031655,48085031655,"Census Tract 316.55, Collin County, Texas",4858,534,4361,619,497,284
1400000US48085031656,48085031656,"Census Tract 316.56, Collin County, Texas",2299,208,1980,258,319,185
1400000US48085031657,48085031657,"Census Tract 316.57, Collin County, Texas",201,80,160,89,41,61
1400000US48085031658,48085031658,"Census Tract 316.58, Collin County, Texas",3222,424,2815,355,407,258
1400000US48085031659,48085031659,"Census Tract 316.59, Collin County, Texas",1202,197,1095,208,107,109
1400000US48085031660,48085031660,"Census Tract 316.60, Collin County, Texas",2889,565,2741,583,148,131
1400000US48085031661,48085031661,"Census Tract 316.61, Collin County, Texas",2465,301,2399,264,66,79
1400000US48085031662,48085031662,"Census Tract 316.62, Collin County, Texas",4603,345,4411,344,192,129
1400000US48085031663,48085031663,"Census Tract 316.63, Collin County, Texas",3122,294,3005,304,117,77
1400000US48085031664,48085031664,"Census Tract 316.64, Collin County, Texas",4236,255,3698,354,538,314
1400000US48085031704,48085031704,"Census Tract 317.04, Collin County, Texas",3729,382,3303,287,426,355
1400000US48085031706,48085031706,"Census Tract 317.06, Collin County, Texas",2591,185,2442,196,149,199
1400000US48085031708,48085031708,"Census Tract 317.08, Collin County, Texas",3613,283,3187,321,426,205
1400000US48085031709,48085031709,"Census Tract 317.09, Collin County, Texas",4243,373,3872,373,371,159
1400000US48085031711,48085031711,"Census Tract 317.11, Collin County, Texas",2870,275,2800,270,70,72
1400000US48085031712,48085031712,"Census Tract 317.12, Collin County, Texas",5049,355,4470,386,579,334
1400000US48085031713,48085031713,"Census Tract 317.13, Collin County, Texas",4237,410,3799,437,438,179
1400000US48085031714,48085031714,"Census Tract 317.14, Collin County, Texas",4930,445,4443,506,487,202
1400000US48085031715,48085031715,"Census Tract 317.15, Collin County, Texas",2489,198,2419,189,70,61
1400000US48085031716,48085031716,"Census Tract 317.16, Collin County, Texas",2065,211,1733,267,332,297
1400000US48085031717,48085031717,"Census Tract 317.17, Collin County, Texas",2478,548,2163,611,315,194
1400000US48085031718,48085031718,"Census Tract 317.18, Collin County, Texas",2440,317,2369,313,71,80
1400000US48085031719,48085031719,"Census Tract 317.19, Collin County, Texas",1932,161,1755,231,177,170
1400000US48085031720,48085031720,"Census Tract 317.20, Collin County, Texas",4159,548,2779,444,1380,502
1400000US48085031802,48085031802,"Census Tract 318.02, Collin County, Texas",6657,423,5922,448,735,210
1400000US48085031804,48085031804,"Census Tract 318.04, Collin County, Texas",3780,308,3391,356,389,218
1400000US48085031805,48085031805,"Census Tract 318.05, Collin County, Texas",5193,314,5049,318,144,91
1400000US48085031806,48085031806,"Census Tract 318.06, Collin County, Texas",1101,164,919,221,182,125
1400000US48085031807,48085031807,"Census Tract 318.07, Collin County, Texas",4770,412,4567,414,203,86
1400000US48085031900,48085031900,"Census Tract 319, Collin County, Texas",3926,560,1955,323,1971,459
1400000US48085032003,48085032003,"Census Tract 320.03, Collin County, Texas",5694,503,2799,438,2895,525
1400000US48085032004,48085032004,"Census Tract 320.04, Collin County, Texas",7913,726,4362,552,3551,773
1400000US48085032008,48085032008,"Census Tract 320.08, Collin County, Texas",3589,229,2962,243,627,141
1400000US48085032009,48085032009,"Census Tract 320.09, Collin County, Texas",6899,416,6453,408,446,124
1400000US48085032010,48085032010,"Census Tract 320.10, Collin County, Texas",4516,799,2099,466,2417,919
1400000US48085032011,48085032011,"Census Tract 320.11, Collin County, Texas",5231,398,4932,382,299,215
1400000US48085032012,48085032012,"Census Tract 320.12, Collin County, Texas",3990,324,1942,362,2048,475
1400000US48085032013,48085032013,"Census Tract 320.13, Collin County, Texas",6691,874,3363,383,3328,801
1400000US48087950300,48087950300,"Census Tract 9503, Collingsworth County, Texas",3009,,1969,184,1040,184
1400000US48089750100,48089750100,"Census Tract 7501, Colorado County, Texas",5018,383,3049,392,1969,243
1400000US48089750200,48089750200,"Census Tract 7502, Colorado County, Texas",1981,356,1664,329,317,192
1400000US48089750300,48089750300,"Census Tract 7503, Colorado County, Texas",4341,388,3629,373,712,203
1400000US48089750400,48089750400,"Census Tract 7504, Colorado County, Texas",4803,386,4126,356,677,251
1400000US48089750500,48089750500,"Census Tract 7505, Colorado County, Texas",4608,443,3232,367,1376,385
1400000US48091310100,48091310100,"Census Tract 3101, Comal County, Texas",3318,347,1954,239,1364,323
1400000US48091310200,48091310200,"Census Tract 3102, Comal County, Texas",2742,431,1526,248,1216,386
1400000US48091310300,48091310300,"Census Tract 3103, Comal County, Texas",6699,869,5729,839,970,441
1400000US48091310401,48091310401,"Census Tract 3104.01, Comal County, Texas",5222,514,1634,299,3588,520
1400000US48091310403,48091310403,"Census Tract 3104.03, Comal County, Texas",5177,462,3390,444,1787,460
1400000US48091310404,48091310404,"Census Tract 3104.04, Comal County, Texas",4323,361,2568,357,1755,284
1400000US48091310501,48091310501,"Census Tract 3105.01, Comal County, Texas",3291,464,2150,329,1141,297
1400000US48091310502,48091310502,"Census Tract 3105.02, Comal County, Texas",4825,587,2908,572,1917,423
1400000US48091310503,48091310503,"Census Tract 3105.03, Comal County, Texas",3254,354,2373,278,881,362
1400000US48091310603,48091310603,"Census Tract 3106.03, Comal County, Texas",2330,399,1815,421,515,310
1400000US48091310604,48091310604,"Census Tract 3106.04, Comal County, Texas",2572,297,2329,328,243,172
1400000US48091310605,48091310605,"Census Tract 3106.05, Comal County, Texas",4975,557,4336,490,639,293
1400000US48091310606,48091310606,"Census Tract 3106.06, Comal County, Texas",3843,423,3580,395,263,181
1400000US48091310607,48091310607,"Census Tract 3106.07, Comal County, Texas",4796,560,4198,408,598,313
1400000US48091310608,48091310608,"Census Tract 3106.08, Comal County, Texas",3188,415,2744,367,444,245
1400000US48091310701,48091310701,"Census Tract 3107.01, Comal County, Texas",5431,496,4738,421,693,246
1400000US48091310702,48091310702,"Census Tract 3107.02, Comal County, Texas",4957,422,4284,389,673,231
1400000US48091310703,48091310703,"Census Tract 3107.03, Comal County, Texas",5215,536,4045,349,1170,486
1400000US48091310704,48091310704,"Census Tract 3107.04, Comal County, Texas",5027,463,3997,481,1030,273
1400000US48091310801,48091310801,"Census Tract 3108.01, Comal County, Texas",3994,315,3554,343,440,155
1400000US48091310802,48091310802,"Census Tract 3108.02, Comal County, Texas",5672,603,3674,377,1998,570
1400000US48091310901,48091310901,"Census Tract 3109.01, Comal County, Texas",3570,416,3338,352,232,182
1400000US48091310902,48091310902,"Census Tract 3109.02, Comal County, Texas",5276,455,4058,307,1218,360
1400000US48091310903,48091310903,"Census Tract 3109.03, Comal County, Texas",3139,225,2749,313,390,246
1400000US48093950100,48093950100,"Census Tract 9501, Comanche County, Texas",4586,327,3838,317,748,201
1400000US48093950200,48093950200,"Census Tract 9502, Comanche County, Texas",2983,334,2628,258,355,230
1400000US48093950300,48093950300,"Census Tract 9503, Comanche County, Texas",4162,239,2575,261,1587,300
1400000US48093950400,48093950400,"Census Tract 9504, Comanche County, Texas",2132,298,1474,262,658,273
1400000US48095950300,48095950300,"Census Tract 9503, Concho County, Texas",4047,,2026,,2021,
1400000US48097000100,48097000100,"Census Tract 1, Cooke County, Texas",5218,482,4783,459,435,141
1400000US48097000200,48097000200,"Census Tract 2, Cooke County, Texas",5078,361,4933,361,145,93
1400000US48097000400,48097000400,"Census Tract 4, Cooke County, Texas",1882,299,1598,251,284,158
1400000US48097000500,48097000500,"Census Tract 5, Cooke County, Texas",3870,474,2458,448,1412,373
1400000US48097000600,48097000600,"Census Tract 6, Cooke County, Texas",4660,474,3450,310,1210,384
1400000US48097000700,48097000700,"Census Tract 7, Cooke County, Texas",6614,465,6395,498,219,111
1400000US48097000900,48097000900,"Census Tract 9, Cooke County, Texas",4845,319,4490,321,355,171
1400000US48097001100,48097001100,"Census Tract 11, Cooke County, Texas",6149,548,4626,399,1523,490
1400000US48099010101,48099010101,"Census Tract 101.01, Coryell County, Texas",3167,382,2951,368,216,119
1400000US48099010102,48099010102,"Census Tract 101.02, Coryell County, Texas",2911,409,2697,399,214,146
1400000US48099010201,48099010201,"Census Tract 102.01, Coryell County, Texas",3073,1167,2293,818,780,376
1400000US48099010202,48099010202,"Census Tract 102.02, Coryell County, Texas",7489,796,6571,767,918,353
1400000US48099010300,48099010300,"Census Tract 103, Coryell County, Texas",2857,489,2291,490,566,294
1400000US48099010400,48099010400,"Census Tract 104, Coryell County, Texas",5390,687,4728,553,662,436
1400000US48099010501,48099010501,"Census Tract 105.01, Coryell County, Texas",5844,525,4595,519,1249,493
1400000US48099010502,48099010502,"Census Tract 105.02, Coryell County, Texas",3665,623,2519,479,1146,546
1400000US48099010503,48099010503,"Census Tract 105.03, Coryell County, Texas",4018,1297,3304,1088,714,279
1400000US48099010504,48099010504,"Census Tract 105.04, Coryell County, Texas",2286,464,1920,436,366,172
1400000US48099010601,48099010601,"Census Tract 106.01, Coryell County, Texas",4449,624,3881,561,568,336
1400000US48099010603,48099010603,"Census Tract 106.03, Coryell County, Texas",5490,652,4556,620,934,355
1400000US48099010604,48099010604,"Census Tract 106.04, Coryell County, Texas",3367,496,2924,506,443,246
1400000US48099010701,48099010701,"Census Tract 107.01, Coryell County, Texas",4253,464,3714,461,539,202
1400000US48099010702,48099010702,"Census Tract 107.02, Coryell County, Texas",3432,368,2979,383,453,283
1400000US48099010802,48099010802,"Census Tract 108.02, Coryell County, Texas",5265,468,4432,408,833,278
1400000US48099010803,48099010803,"Census Tract 108.03, Coryell County, Texas",3174,501,2818,504,356,184
1400000US48099010804,48099010804,"Census Tract 108.04, Coryell County, Texas",3952,597,3576,517,376,262
1400000US48099980000,48099980000,"Census Tract 9800, Coryell County, Texas",0,127,0,127,0,127
1400000US48101950100,48101950100,"Census Tract 9501, Cottle County, Texas",1618,137,1379,144,239,78
1400000US48103950100,48103950100,"Census Tract 9501, Crane County, Texas",4141,,2089,169,2052,169
1400000US48105950100,48105950100,"Census Tract 9501, Crockett County, Texas",3746,,1583,286,2163,286
1400000US48107950100,48107950100,"Census Tract 9501, Crosby County, Texas",2201,235,1151,131,1050,185
1400000US48107950200,48107950200,"Census Tract 9502, Crosby County, Texas",2578,266,1167,156,1411,215
1400000US48107950300,48107950300,"Census Tract 9503, Crosby County, Texas",1428,196,753,125,675,151
1400000US48109950300,48109950300,"Census Tract 9503, Culberson County, Texas",2480,,702,222,1778,222
1400000US48111950100,48111950100,"Census Tract 9501, Dallam County, Texas",1466,280,1226,235,240,156
1400000US48111950300,48111950300,"Census Tract 9503, Dallam County, Texas",5005,280,2827,235,2178,156
1400000US48113000100,48113000100,"Census Tract 1, Dallas County, Texas",3926,282,3457,338,469,241
1400000US48113000201,48113000201,"Census Tract 2.01, Dallas County, Texas",3177,227,3049,230,128,78
1400000US48113000202,48113000202,"Census Tract 2.02, Dallas County, Texas",3380,230,2981,235,399,135
1400000US48113000300,48113000300,"Census Tract 3, Dallas County, Texas",3852,416,3035,359,817,264
1400000US48113000401,48113000401,"Census Tract 4.01, Dallas County, Texas",3213,479,1025,304,2188,348
1400000US48113000404,48113000404,"Census Tract 4.04, Dallas County, Texas",3996,653,1752,318,2244,622
1400000US48113000405,48113000405,"Census Tract 4.05, Dallas County, Texas",2703,471,1524,290,1179,444
1400000US48113000406,48113000406,"Census Tract 4.06, Dallas County, Texas",7599,891,1084,307,6515,959
1400000US48113000500,48113000500,"Census Tract 5, Dallas County, Texas",4632,717,2608,380,2024,632
1400000US48113000601,48113000601,"Census Tract 6.01, Dallas County, Texas",6747,916,2660,365,4087,845
1400000US48113000603,48113000603,"Census Tract 6.03, Dallas County, Texas",3614,347,3284,335,330,150
1400000US48113000605,48113000605,"Census Tract 6.05, Dallas County, Texas",2182,248,1995,231,187,168
1400000US48113000606,48113000606,"Census Tract 6.06, Dallas County, Texas",3073,334,2946,334,127,66
1400000US48113000701,48113000701,"Census Tract 7.01, Dallas County, Texas",3943,401,3404,337,539,289
1400000US48113000702,48113000702,"Census Tract 7.02, Dallas County, Texas",3033,316,2232,283,801,288
1400000US48113000800,48113000800,"Census Tract 8, Dallas County, Texas",6078,555,1688,264,4390,519
1400000US48113000900,48113000900,"Census Tract 9, Dallas County, Texas",5127,917,973,212,4154,954
1400000US48113001001,48113001001,"Census Tract 10.01, Dallas County, Texas",1566,239,1164,221,402,146
1400000US48113001002,48113001002,"Census Tract 10.02, Dallas County, Texas",2265,347,1091,274,1174,313
1400000US48113001101,48113001101,"Census Tract 11.01, Dallas County, Texas",3681,420,2564,255,1117,330
1400000US48113001102,48113001102,"Census Tract 11.02, Dallas County, Texas",2238,250,1788,254,450,248
1400000US48113001202,48113001202,"Census Tract 12.02, Dallas County, Texas",3013,470,1895,321,1118,480
1400000US48113001203,48113001203,"Census Tract 12.03, Dallas County, Texas",1734,252,304,95,1430,290
1400000US48113001204,48113001204,"Census Tract 12.04, Dallas County, Texas",3063,496,227,116,2836,482
1400000US48113001301,48113001301,"Census Tract 13.01, Dallas County, Texas",2271,280,1840,243,431,180
1400000US48113001302,48113001302,"Census Tract 13.02, Dallas County, Texas",2468,394,1265,192,1203,426
1400000US48113001400,48113001400,"Census Tract 14, Dallas County, Texas",3544,456,2098,354,1446,542
1400000US48113001502,48113001502,"Census Tract 15.02, Dallas County, Texas",3366,456,1051,218,2315,479
1400000US48113001503,48113001503,"Census Tract 15.03, Dallas County, Texas",3318,523,1046,252,2272,517
1400000US48113001504,48113001504,"Census Tract 15.04, Dallas County, Texas",2401,281,1226,209,1175,315
1400000US48113001600,48113001600,"Census Tract 16, Dallas County, Texas",4353,809,3158,629,1195,719
1400000US48113001701,48113001701,"Census Tract 17.01, Dallas County, Texas",24,21,24,21,0,127
1400000US48113001703,48113001703,"Census Tract 17.03, Dallas County, Texas",2565,238,2329,225,236,111
1400000US48113001704,48113001704,"Census Tract 17.04, Dallas County, Texas",1015,250,988,252,27,34
1400000US48113001800,48113001800,"Census Tract 18, Dallas County, Texas",3272,285,3051,301,221,135
1400000US48113001900,48113001900,"Census Tract 19, Dallas County, Texas",3463,316,2849,360,614,194
1400000US48113002000,48113002000,"Census Tract 20, Dallas County, Texas",6747,818,1559,322,5188,727
1400000US48113002100,48113002100,"Census Tract 21, Dallas County, Texas",856,122,731,131,125,70
1400000US48113002200,48113002200,"Census Tract 22, Dallas County, Texas",2093,353,1829,378,264,112
1400000US48113002400,48113002400,"Census Tract 24, Dallas County, Texas",3230,477,506,150,2724,497
1400000US48113002500,48113002500,"Census Tract 25, Dallas County, Texas",5030,714,1570,412,3460,562
1400000US48113002701,48113002701,"Census Tract 27.01, Dallas County, Texas",2205,385,1695,311,510,270
1400000US48113002702,48113002702,"Census Tract 27.02, Dallas County, Texas",1561,281,1451,292,110,82
1400000US48113003101,48113003101,"Census Tract 31.01, Dallas County, Texas",2523,273,2221,277,302,118
1400000US48113003400,48113003400,"Census Tract 34, Dallas County, Texas",1227,312,973,356,254,175
1400000US48113003700,48113003700,"Census Tract 37, Dallas County, Texas",3496,461,3430,492,66,93
1400000US48113003800,48113003800,"Census Tract 38, Dallas County, Texas",1739,204,1679,209,60,60
1400000US48113003901,48113003901,"Census Tract 39.01, Dallas County, Texas",1798,593,1798,593,0,127
1400000US48113003902,48113003902,"Census Tract 39.02, Dallas County, Texas",1789,379,1477,381,312,215
1400000US48113004000,48113004000,"Census Tract 40, Dallas County, Texas",795,191,776,191,19,22
1400000US48113004100,48113004100,"Census Tract 41, Dallas County, Texas",1173,303,889,305,284,219
1400000US48113004201,48113004201,"Census Tract 42.01, Dallas County, Texas",3548,554,1558,228,1990,529
1400000US48113004202,48113004202,"Census Tract 42.02, Dallas County, Texas",2097,428,651,202,1446,371
1400000US48113004300,48113004300,"Census Tract 43, Dallas County, Texas",2456,367,617,320,1839,439
1400000US48113004400,48113004400,"Census Tract 44, Dallas County, Texas",3507,350,2546,236,961,327
1400000US48113004500,48113004500,"Census Tract 45, Dallas County, Texas",6017,701,1166,281,4851,755
1400000US48113004600,48113004600,"Census Tract 46, Dallas County, Texas",1177,233,768,159,409,135
1400000US48113004700,48113004700,"Census Tract 47, Dallas County, Texas",3657,584,486,210,3171,579
1400000US48113004800,48113004800,"Census Tract 48, Dallas County, Texas",2853,489,283,164,2570,514
1400000US48113004900,48113004900,"Census Tract 49, Dallas County, Texas",3804,616,2694,625,1110,359
1400000US48113005000,48113005000,"Census Tract 50, Dallas County, Texas",4017,522,529,182,3488,566
1400000US48113005100,48113005100,"Census Tract 51, Dallas County, Texas",2918,461,538,236,2380,448
1400000US48113005200,48113005200,"Census Tract 52, Dallas County, Texas",5732,686,653,193,5079,714
1400000US48113005300,48113005300,"Census Tract 53, Dallas County, Texas",6834,635,878,175,5956,633
1400000US48113005400,48113005400,"Census Tract 54, Dallas County, Texas",4899,645,2402,447,2497,589
1400000US48113005500,48113005500,"Census Tract 55, Dallas County, Texas",3747,537,2140,358,1607,451
1400000US48113005600,48113005600,"Census Tract 56, Dallas County, Texas",6753,825,1739,340,5014,798
1400000US48113005700,48113005700,"Census Tract 57, Dallas County, Texas",4204,506,2624,418,1580,384
1400000US48113005901,48113005901,"Census Tract 59.01, Dallas County, Texas",5606,598,4640,510,966,358
1400000US48113005902,48113005902,"Census Tract 59.02, Dallas County, Texas",3452,388,3062,356,390,167
1400000US48113006001,48113006001,"Census Tract 60.01, Dallas County, Texas",4401,414,1130,327,3271,452
1400000US48113006002,48113006002,"Census Tract 60.02, Dallas County, Texas",3918,527,3305,487,613,278
1400000US48113006100,48113006100,"Census Tract 61, Dallas County, Texas",4363,376,2220,327,2143,404
1400000US48113006200,48113006200,"Census Tract 62, Dallas County, Texas",6013,520,2509,390,3504,495
1400000US48113006301,48113006301,"Census Tract 63.01, Dallas County, Texas",5999,475,1302,198,4697,472
1400000US48113006302,48113006302,"Census Tract 63.02, Dallas County, Texas",4303,365,826,272,3477,494
1400000US48113006401,48113006401,"Census Tract 64.01, Dallas County, Texas",3118,571,211,132,2907,576
1400000US48113006402,48113006402,"Census Tract 64.02, Dallas County, Texas",6029,597,259,141,5770,656
1400000US48113006501,48113006501,"Census Tract 65.01, Dallas County, Texas",6649,456,590,264,6059,474
1400000US48113006502,48113006502,"Census Tract 65.02, Dallas County, Texas",3728,466,411,120,3317,456
1400000US48113006700,48113006700,"Census Tract 67, Dallas County, Texas",7111,672,443,164,6668,704
1400000US48113006800,48113006800,"Census Tract 68, Dallas County, Texas",5288,567,1171,337,4117,539
1400000US48113006900,48113006900,"Census Tract 69, Dallas County, Texas",3772,463,563,169,3209,502
1400000US48113007101,48113007101,"Census Tract 71.01, Dallas County, Texas",1800,145,1727,146,73,67
1400000US48113007102,48113007102,"Census Tract 71.02, Dallas County, Texas",6435,683,4408,435,2027,731
1400000US48113007201,48113007201,"Census Tract 72.01, Dallas County, Texas",9490,1096,801,368,8689,1105
1400000US48113007202,48113007202,"Census Tract 72.02, Dallas County, Texas",8274,888,154,125,8120,883
1400000US48113007301,48113007301,"Census Tract 73.01, Dallas County, Texas",1962,185,1849,130,113,114
1400000US48113007302,48113007302,"Census Tract 73.02, Dallas County, Texas",3728,543,2831,341,897,394
1400000US48113007601,48113007601,"Census Tract 76.01, Dallas County, Texas",1906,288,1732,242,174,125
1400000US48113007604,48113007604,"Census Tract 76.04, Dallas County, Texas",3293,211,3186,210,107,98
1400000US48113007605,48113007605,"Census Tract 76.05, Dallas County, Texas",1810,175,1765,160,45,45
1400000US48113007700,48113007700,"Census Tract 77, Dallas County, Texas",4688,396,4666,391,22,36
1400000US48113007801,48113007801,"Census Tract 78.01, Dallas County, Texas",2362,127,2336,134,26,40
1400000US48113007804,48113007804,"Census Tract 78.04, Dallas County, Texas",5629,628,4987,613,642,223
1400000US48113007805,48113007805,"Census Tract 78.05, Dallas County, Texas",3313,272,2733,278,580,101
1400000US48113007809,48113007809,"Census Tract 78.09, Dallas County, Texas",2062,286,1627,272,435,254
1400000US48113007810,48113007810,"Census Tract 78.10, Dallas County, Texas",3464,419,3256,431,208,138
1400000US48113007811,48113007811,"Census Tract 78.11, Dallas County, Texas",4774,621,3921,592,853,416
1400000US48113007812,48113007812,"Census Tract 78.12, Dallas County, Texas",3202,202,3042,284,160,124
1400000US48113007815,48113007815,"Census Tract 78.15, Dallas County, Texas",5013,657,2204,553,2809,628
1400000US48113007818,48113007818,"Census Tract 78.18, Dallas County, Texas",4934,655,1578,347,3356,679
1400000US48113007819,48113007819,"Census Tract 78.19, Dallas County, Texas",3255,485,1276,249,1979,521
1400000US48113007820,48113007820,"Census Tract 78.20, Dallas County, Texas",5195,802,1485,365,3710,899
1400000US48113007821,48113007821,"Census Tract 78.21, Dallas County, Texas",3879,681,2283,586,1596,533
1400000US48113007822,48113007822,"Census Tract 78.22, Dallas County, Texas",971,346,653,198,318,300
1400000US48113007823,48113007823,"Census Tract 78.23, Dallas County, Texas",1324,409,866,342,458,267
1400000US48113007824,48113007824,"Census Tract 78.24, Dallas County, Texas",1576,119,1576,119,0,127
1400000US48113007825,48113007825,"Census Tract 78.25, Dallas County, Texas",5291,474,4111,472,1180,384
1400000US48113007826,48113007826,"Census Tract 78.26, Dallas County, Texas",486,226,323,175,163,175
1400000US48113007827,48113007827,"Census Tract 78.27, Dallas County, Texas",3122,411,2769,410,353,190
1400000US48113007902,48113007902,"Census Tract 79.02, Dallas County, Texas",5813,789,4902,726,911,342
1400000US48113007903,48113007903,"Census Tract 79.03, Dallas County, Texas",1996,275,1526,121,470,268
1400000US48113007906,48113007906,"Census Tract 79.06, Dallas County, Texas",2302,159,2194,160,108,82
1400000US48113007909,48113007909,"Census Tract 79.09, Dallas County, Texas",2171,240,1650,198,521,265
1400000US48113007910,48113007910,"Census Tract 79.10, Dallas County, Texas",3276,350,2753,328,523,221
1400000US48113007911,48113007911,"Census Tract 79.11, Dallas County, Texas",2641,315,2212,312,429,195
1400000US48113007912,48113007912,"Census Tract 79.12, Dallas County, Texas",1796,173,1593,165,203,158
1400000US48113007913,48113007913,"Census Tract 79.13, Dallas County, Texas",1857,400,1213,255,644,301
1400000US48113007914,48113007914,"Census Tract 79.14, Dallas County, Texas",2026,255,1804,238,222,107
1400000US48113008000,48113008000,"Census Tract 80, Dallas County, Texas",5904,339,5761,338,143,89
1400000US48113008100,48113008100,"Census Tract 81, Dallas County, Texas",6151,554,5305,425,846,366
1400000US48113008200,48113008200,"Census Tract 82, Dallas County, Texas",3844,360,3221,302,623,283
1400000US48113008400,48113008400,"Census Tract 84, Dallas County, Texas",9697,700,1493,235,8204,719
1400000US48113008500,48113008500,"Census Tract 85, Dallas County, Texas",5010,458,1424,320,3586,389
1400000US48113008603,48113008603,"Census Tract 86.03, Dallas County, Texas",1406,293,656,289,750,377
1400000US48113008604,48113008604,"Census Tract 86.04, Dallas County, Texas",2897,465,2366,414,531,354
1400000US48113008701,48113008701,"Census Tract 87.01, Dallas County, Texas",4059,493,3779,453,280,297
1400000US48113008703,48113008703,"Census Tract 87.03, Dallas County, Texas",2462,314,1622,221,840,295
1400000US48113008704,48113008704,"Census Tract 87.04, Dallas County, Texas",3428,514,3312,524,116,103
1400000US48113008705,48113008705,"Census Tract 87.05, Dallas County, Texas",1324,305,909,206,415,273
1400000US48113008801,48113008801,"Census Tract 88.01, Dallas County, Texas",2143,260,1802,254,341,129
1400000US48113008802,48113008802,"Census Tract 88.02, Dallas County, Texas",5307,553,4462,462,845,471
1400000US48113008900,48113008900,"Census Tract 89, Dallas County, Texas",2794,499,1816,303,978,391
1400000US48113009000,48113009000,"Census Tract 90, Dallas County, Texas",7324,748,3453,699,3871,607
1400000US48113009101,48113009101,"Census Tract 91.01, Dallas County, Texas",5762,560,1831,379,3931,612
1400000US48113009103,48113009103,"Census Tract 91.03, Dallas County, Texas",4116,522,1581,305,2535,505
1400000US48113009104,48113009104,"Census Tract 91.04, Dallas County, Texas",3502,434,916,193,2586,543
1400000US48113009105,48113009105,"Census Tract 91.05, Dallas County, Texas",3951,370,1330,545,2621,544
1400000US48113009201,48113009201,"Census Tract 92.01, Dallas County, Texas",6726,668,2444,340,4282,670
1400000US48113009202,48113009202,"Census Tract 92.02, Dallas County, Texas",6331,565,2094,424,4237,686
1400000US48113009301,48113009301,"Census Tract 93.01, Dallas County, Texas",5282,480,867,249,4415,497
1400000US48113009303,48113009303,"Census Tract 93.03, Dallas County, Texas",4382,648,678,197,3704,696
1400000US48113009304,48113009304,"Census Tract 93.04, Dallas County, Texas",6091,964,3873,550,2218,980
1400000US48113009401,48113009401,"Census Tract 94.01, Dallas County, Texas",3604,302,1447,174,2157,313
1400000US48113009402,48113009402,"Census Tract 94.02, Dallas County, Texas",2489,298,1823,232,666,385
1400000US48113009500,48113009500,"Census Tract 95, Dallas County, Texas",2304,165,1999,256,305,255
1400000US48113009603,48113009603,"Census Tract 96.03, Dallas County, Texas",4466,309,4031,378,435,168
1400000US48113009604,48113009604,"Census Tract 96.04, Dallas County, Texas",4169,511,2870,267,1299,474
1400000US48113009605,48113009605,"Census Tract 96.05, Dallas County, Texas",3229,387,1382,291,1847,395
1400000US48113009607,48113009607,"Census Tract 96.07, Dallas County, Texas",3938,618,2270,212,1668,623
1400000US48113009608,48113009608,"Census Tract 96.08, Dallas County, Texas",4889,599,2792,286,2097,612
1400000US48113009609,48113009609,"Census Tract 96.09, Dallas County, Texas",2966,169,2792,179,174,192
1400000US48113009610,48113009610,"Census Tract 96.10, Dallas County, Texas",4964,602,229,120,4735,611
1400000US48113009611,48113009611,"Census Tract 96.11, Dallas County, Texas",3408,404,1151,201,2257,412
1400000US48113009701,48113009701,"Census Tract 97.01, Dallas County, Texas",4412,384,1354,183,3058,381
1400000US48113009702,48113009702,"Census Tract 97.02, Dallas County, Texas",3052,195,2628,196,424,135
1400000US48113009802,48113009802,"Census Tract 98.02, Dallas County, Texas",6081,571,533,188,5548,612
1400000US48113009803,48113009803,"Census Tract 98.03, Dallas County, Texas",2812,609,701,178,2111,631
1400000US48113009804,48113009804,"Census Tract 98.04, Dallas County, Texas",7824,988,315,175,7509,932
1400000US48113009900,48113009900,"Census Tract 99, Dallas County, Texas",2329,307,1062,237,1267,367
1400000US48113010000,48113010000,"Census Tract 100, Dallas County, Texas",12823,1113,10334,840,2489,663
1400000US48113010101,48113010101,"Census Tract 101.01, Dallas County, Texas",4287,546,1956,462,2331,562
1400000US48113010102,48113010102,"Census Tract 101.02, Dallas County, Texas",3342,389,253,149,3089,400
1400000US48113010500,48113010500,"Census Tract 105, Dallas County, Texas",2901,470,967,322,1934,486
1400000US48113010601,48113010601,"Census Tract 106.01, Dallas County, Texas",6413,542,236,148,6177,516
1400000US48113010602,48113010602,"Census Tract 106.02, Dallas County, Texas",2548,390,601,160,1947,360
1400000US48113010701,48113010701,"Census Tract 107.01, Dallas County, Texas",3990,517,609,213,3381,541
1400000US48113010703,48113010703,"Census Tract 107.03, Dallas County, Texas",2995,474,814,272,2181,413
1400000US48113010704,48113010704,"Census Tract 107.04, Dallas County, Texas",4704,551,1374,351,3330,530
1400000US48113010801,48113010801,"Census Tract 108.01, Dallas County, Texas",8784,911,2648,495,6136,959
1400000US48113010803,48113010803,"Census Tract 108.03, Dallas County, Texas",6990,768,4018,525,2972,748
1400000US48113010804,48113010804,"Census Tract 108.04, Dallas County, Texas",3921,636,1242,292,2679,569
1400000US48113010805,48113010805,"Census Tract 108.05, Dallas County, Texas",5890,565,1862,383,4028,536
1400000US48113010902,48113010902,"Census Tract 109.02, Dallas County, Texas",5533,637,5285,548,248,252
1400000US48113010903,48113010903,"Census Tract 109.03, Dallas County, Texas",2836,334,1821,280,1015,264
1400000US48113010904,48113010904,"Census Tract 109.04, Dallas County, Texas",3340,570,2966,544,374,331
1400000US48113011001,48113011001,"Census Tract 110.01, Dallas County, Texas",6528,526,6117,532,411,271
1400000US48113011002,48113011002,"Census Tract 110.02, Dallas County, Texas",2945,354,2430,284,515,237
1400000US48113011101,48113011101,"Census Tract 111.01, Dallas County, Texas",3987,520,3934,521,53,27
1400000US48113011103,48113011103,"Census Tract 111.03, Dallas County, Texas",3893,489,2089,328,1804,358
1400000US48113011104,48113011104,"Census Tract 111.04, Dallas County, Texas",3710,514,3046,470,664,386
1400000US48113011105,48113011105,"Census Tract 111.05, Dallas County, Texas",3452,608,2913,509,539,403
1400000US48113011200,48113011200,"Census Tract 112, Dallas County, Texas",5464,539,4852,534,612,220
1400000US48113011300,48113011300,"Census Tract 113, Dallas County, Texas",4760,379,4567,359,193,125
1400000US48113011401,48113011401,"Census Tract 114.01, Dallas County, Texas",5301,632,5008,599,293,232
1400000US48113011500,48113011500,"Census Tract 115, Dallas County, Texas",2855,598,1551,381,1304,475
1400000US48113011601,48113011601,"Census Tract 116.01, Dallas County, Texas",4758,533,2673,483,2085,611
1400000US48113011602,48113011602,"Census Tract 116.02, Dallas County, Texas",5883,498,1942,329,3941,517
1400000US48113011701,48113011701,"Census Tract 117.01, Dallas County, Texas",6723,747,1705,474,5018,865
1400000US48113011702,48113011702,"Census Tract 117.02, Dallas County, Texas",4671,519,1647,461,3024,579
1400000US48113011800,48113011800,"Census Tract 118, Dallas County, Texas",9527,896,4337,624,5190,925
1400000US48113011900,48113011900,"Census Tract 119, Dallas County, Texas",8843,993,4170,568,4673,982
1400000US48113012000,48113012000,"Census Tract 120, Dallas County, Texas",6313,583,3795,480,2518,520
1400000US48113012100,48113012100,"Census Tract 121, Dallas County, Texas",5863,531,3408,425,2455,507
1400000US48113012204,48113012204,"Census Tract 122.04, Dallas County, Texas",6038,607,4393,583,1645,460
1400000US48113012206,48113012206,"Census Tract 122.06, Dallas County, Texas",5118,547,4012,544,1106,339
1400000US48113012207,48113012207,"Census Tract 122.07, Dallas County, Texas",6862,710,4338,653,2524,639
1400000US48113012208,48113012208,"Census Tract 122.08, Dallas County, Texas",2121,479,706,241,1415,505
1400000US48113012209,48113012209,"Census Tract 122.09, Dallas County, Texas",3000,417,1779,276,1221,394
1400000US48113012210,48113012210,"Census Tract 122.10, Dallas County, Texas",4318,429,2971,437,1347,433
1400000US48113012211,48113012211,"Census Tract 122.11, Dallas County, Texas",4318,502,2304,393,2014,451
1400000US48113012301,48113012301,"Census Tract 123.01, Dallas County, Texas",3799,240,2129,342,1670,332
1400000US48113012302,48113012302,"Census Tract 123.02, Dallas County, Texas",7664,1568,5528,1452,2136,687
1400000US48113012400,48113012400,"Census Tract 124, Dallas County, Texas",4593,427,3191,344,1402,442
1400000US48113012500,48113012500,"Census Tract 125, Dallas County, Texas",7187,566,3230,387,3957,558
1400000US48113012601,48113012601,"Census Tract 126.01, Dallas County, Texas",5464,611,3023,487,2441,578
1400000US48113012603,48113012603,"Census Tract 126.03, Dallas County, Texas",1990,293,863,174,1127,325
1400000US48113012604,48113012604,"Census Tract 126.04, Dallas County, Texas",5656,735,3985,597,1671,621
1400000US48113012701,48113012701,"Census Tract 127.01, Dallas County, Texas",6021,712,2200,422,3821,604
1400000US48113012702,48113012702,"Census Tract 127.02, Dallas County, Texas",2979,514,801,215,2178,551
1400000US48113012800,48113012800,"Census Tract 128, Dallas County, Texas",7723,744,5024,322,2699,747
1400000US48113012900,48113012900,"Census Tract 129, Dallas County, Texas",4259,307,3644,279,615,283
1400000US48113013004,48113013004,"Census Tract 130.04, Dallas County, Texas",5794,363,5347,381,447,131
1400000US48113013005,48113013005,"Census Tract 130.05, Dallas County, Texas",3798,282,3502,298,296,109
1400000US48113013007,48113013007,"Census Tract 130.07, Dallas County, Texas",3049,384,2310,208,739,363
1400000US48113013008,48113013008,"Census Tract 130.08, Dallas County, Texas",3482,251,2728,372,754,331
1400000US48113013009,48113013009,"Census Tract 130.09, Dallas County, Texas",4240,609,3645,642,595,211
1400000US48113013010,48113013010,"Census Tract 130.10, Dallas County, Texas",4303,486,2030,403,2273,471
1400000US48113013011,48113013011,"Census Tract 130.11, Dallas County, Texas",4338,535,1284,318,3054,545
1400000US48113013101,48113013101,"Census Tract 131.01, Dallas County, Texas",2526,135,2441,153,85,81
1400000US48113013102,48113013102,"Census Tract 131.02, Dallas County, Texas",1666,131,1492,159,174,152
1400000US48113013104,48113013104,"Census Tract 131.04, Dallas County, Texas",1045,212,923,184,122,95
1400000US48113013105,48113013105,"Census Tract 131.05, Dallas County, Texas",6071,649,3372,516,2699,641
1400000US48113013200,48113013200,"Census Tract 132, Dallas County, Texas",6218,506,5822,495,396,240
1400000US48113013300,48113013300,"Census Tract 133, Dallas County, Texas",2277,144,2045,144,232,160
1400000US48113013400,48113013400,"Census Tract 134, Dallas County, Texas",2076,157,2027,170,49,43
1400000US48113013500,48113013500,"Census Tract 135, Dallas County, Texas",2611,196,2527,198,84,63
1400000US48113013605,48113013605,"Census Tract 136.05, Dallas County, Texas",5157,270,4893,266,264,148
1400000US48113013606,48113013606,"Census Tract 136.06, Dallas County, Texas",5389,319,4348,399,1041,337
1400000US48113013607,48113013607,"Census Tract 136.07, Dallas County, Texas",3360,306,2986,214,374,298
1400000US48113013608,48113013608,"Census Tract 136.08, Dallas County, Texas",2577,264,2470,259,107,83
1400000US48113013609,48113013609,"Census Tract 136.09, Dallas County, Texas",3668,384,2447,340,1221,382
1400000US48113013610,48113013610,"Census Tract 136.10, Dallas County, Texas",4290,580,2472,335,1818,592
1400000US48113013611,48113013611,"Census Tract 136.11, Dallas County, Texas",2526,247,2406,256,120,116
1400000US48113013615,48113013615,"Census Tract 136.15, Dallas County, Texas",5107,705,2134,448,2973,828
1400000US48113013616,48113013616,"Census Tract 136.16, Dallas County, Texas",4549,490,3542,391,1007,382
1400000US48113013617,48113013617,"Census Tract 136.17, Dallas County, Texas",2948,270,2508,276,440,248
1400000US48113013618,48113013618,"Census Tract 136.18, Dallas County, Texas",2441,154,2394,166,47,62
1400000US48113013619,48113013619,"Census Tract 136.19, Dallas County, Texas",5511,331,4898,279,613,390
1400000US48113013620,48113013620,"Census Tract 136.20, Dallas County, Texas",4016,407,3337,395,679,261
1400000US48113013621,48113013621,"Census Tract 136.21, Dallas County, Texas",4117,487,2736,482,1381,443
1400000US48113013622,48113013622,"Census Tract 136.22, Dallas County, Texas",3232,553,2325,383,907,572
1400000US48113013623,48113013623,"Census Tract 136.23, Dallas County, Texas",5909,621,3455,431,2454,583
1400000US48113013624,48113013624,"Census Tract 136.24, Dallas County, Texas",3432,346,2785,316,647,318
1400000US48113013625,48113013625,"Census Tract 136.25, Dallas County, Texas",3057,572,1579,342,1478,653
1400000US48113013626,48113013626,"Census Tract 136.26, Dallas County, Texas",2531,317,1196,216,1335,308
1400000US48113013711,48113013711,"Census Tract 137.11, Dallas County, Texas",2856,421,732,270,2124,472
1400000US48113013712,48113013712,"Census Tract 137.12, Dallas County, Texas",2131,174,1186,151,945,173
1400000US48113013713,48113013713,"Census Tract 137.13, Dallas County, Texas",1866,379,209,204,1657,337
1400000US48113013714,48113013714,"Census Tract 137.14, Dallas County, Texas",5209,460,1099,287,4110,578
1400000US48113013715,48113013715,"Census Tract 137.15, Dallas County, Texas",2498,296,776,240,1722,384
1400000US48113013716,48113013716,"Census Tract 137.16, Dallas County, Texas",4441,283,2715,251,1726,262
1400000US48113013717,48113013717,"Census Tract 137.17, Dallas County, Texas",2458,319,734,187,1724,322
1400000US48113013718,48113013718,"Census Tract 137.18, Dallas County, Texas",4548,437,1148,312,3400,440
1400000US48113013719,48113013719,"Census Tract 137.19, Dallas County, Texas",3739,261,3462,270,277,229
1400000US48113013720,48113013720,"Census Tract 137.20, Dallas County, Texas",5678,351,3541,298,2137,350
1400000US48113013721,48113013721,"Census Tract 137.21, Dallas County, Texas",5724,472,5011,482,713,260
1400000US48113013722,48113013722,"Census Tract 137.22, Dallas County, Texas",3955,324,2999,318,956,270
1400000US48113013725,48113013725,"Census Tract 137.25, Dallas County, Texas",3747,336,2414,361,1333,429
1400000US48113013726,48113013726,"Census Tract 137.26, Dallas County, Texas",2761,342,1895,313,866,379
1400000US48113013727,48113013727,"Census Tract 137.27, Dallas County, Texas",2641,282,2305,299,336,190
1400000US48113013803,48113013803,"Census Tract 138.03, Dallas County, Texas",5859,384,4340,352,1519,501
1400000US48113013804,48113013804,"Census Tract 138.04, Dallas County, Texas",3284,296,1940,203,1344,345
1400000US48113013805,48113013805,"Census Tract 138.05, Dallas County, Texas",3830,446,1121,285,2709,505
1400000US48113013806,48113013806,"Census Tract 138.06, Dallas County, Texas",2040,254,1681,265,359,148
1400000US48113013901,48113013901,"Census Tract 139.01, Dallas County, Texas",3154,281,667,165,2487,284
1400000US48113013902,48113013902,"Census Tract 139.02, Dallas County, Texas",4089,362,2399,233,1690,264
1400000US48113014001,48113014001,"Census Tract 140.01, Dallas County, Texas",4282,426,2747,377,1535,426
1400000US48113014002,48113014002,"Census Tract 140.02, Dallas County, Texas",463,120,430,122,33,42
1400000US48113014103,48113014103,"Census Tract 141.03, Dallas County, Texas",2809,390,1698,290,1111,327
1400000US48113014113,48113014113,"Census Tract 141.13, Dallas County, Texas",4430,534,3134,448,1296,378
1400000US48113014114,48113014114,"Census Tract 141.14, Dallas County, Texas",3204,307,2420,374,784,335
1400000US48113014115,48113014115,"Census Tract 141.15, Dallas County, Texas",6477,605,3378,394,3099,577
1400000US48113014116,48113014116,"Census Tract 141.16, Dallas County, Texas",4153,478,3019,455,1134,415
1400000US48113014119,48113014119,"Census Tract 141.19, Dallas County, Texas",4118,175,3780,248,338,221
1400000US48113014120,48113014120,"Census Tract 141.20, Dallas County, Texas",4854,232,4354,267,500,173
1400000US48113014121,48113014121,"Census Tract 141.21, Dallas County, Texas",4861,296,4523,276,338,211
1400000US48113014123,48113014123,"Census Tract 141.23, Dallas County, Texas",5817,200,5279,337,538,298
1400000US48113014124,48113014124,"Census Tract 141.24, Dallas County, Texas",3911,279,3701,286,210,123
1400000US48113014126,48113014126,"Census Tract 141.26, Dallas County, Texas",5508,227,5034,244,474,164
1400000US48113014127,48113014127,"Census Tract 141.27, Dallas County, Texas",7936,554,7498,608,438,190
1400000US48113014128,48113014128,"Census Tract 141.28, Dallas County, Texas",3373,371,3209,378,164,108
1400000US48113014129,48113014129,"Census Tract 141.29, Dallas County, Texas",3867,497,3502,536,365,232
1400000US48113014130,48113014130,"Census Tract 141.30, Dallas County, Texas",3697,577,3131,435,566,553
1400000US48113014131,48113014131,"Census Tract 141.31, Dallas County, Texas",4348,388,3876,394,472,201
1400000US48113014132,48113014132,"Census Tract 141.32, Dallas County, Texas",2315,221,2091,225,224,138
1400000US48113014133,48113014133,"Census Tract 141.33, Dallas County, Texas",4071,384,3332,381,739,253
1400000US48113014134,48113014134,"Census Tract 141.34, Dallas County, Texas",3826,225,3672,235,154,79
1400000US48113014135,48113014135,"Census Tract 141.35, Dallas County, Texas",4668,296,4143,421,525,286
1400000US48113014136,48113014136,"Census Tract 141.36, Dallas County, Texas",5049,587,4353,450,696,360
1400000US48113014137,48113014137,"Census Tract 141.37, Dallas County, Texas",2423,313,2145,287,278,152
1400000US48113014138,48113014138,"Census Tract 141.38, Dallas County, Texas",2543,300,2380,308,163,101
1400000US48113014203,48113014203,"Census Tract 142.03, Dallas County, Texas",3002,255,1776,241,1226,290
1400000US48113014204,48113014204,"Census Tract 142.04, Dallas County, Texas",1879,430,1380,435,499,243
1400000US48113014205,48113014205,"Census Tract 142.05, Dallas County, Texas",1574,95,1433,103,141,72
1400000US48113014206,48113014206,"Census Tract 142.06, Dallas County, Texas",2553,324,2130,296,423,170
1400000US48113014302,48113014302,"Census Tract 143.02, Dallas County, Texas",7125,573,3298,373,3827,592
1400000US48113014306,48113014306,"Census Tract 143.06, Dallas County, Texas",5056,517,1954,242,3102,543
1400000US48113014307,48113014307,"Census Tract 143.07, Dallas County, Texas",4509,353,3809,375,700,222
1400000US48113014308,48113014308,"Census Tract 143.08, Dallas County, Texas",4948,578,1652,465,3296,579
1400000US48113014309,48113014309,"Census Tract 143.09, Dallas County, Texas",4452,502,2347,436,2105,457
1400000US48113014310,48113014310,"Census Tract 143.10, Dallas County, Texas",4373,544,3408,543,965,383
1400000US48113014311,48113014311,"Census Tract 143.11, Dallas County, Texas",4660,567,4509,572,151,91
1400000US48113014312,48113014312,"Census Tract 143.12, Dallas County, Texas",4596,471,4231,473,365,184
1400000US48113014403,48113014403,"Census Tract 144.03, Dallas County, Texas",3708,509,2006,345,1702,426
1400000US48113014405,48113014405,"Census Tract 144.05, Dallas County, Texas",3704,641,1112,232,2592,584
1400000US48113014406,48113014406,"Census Tract 144.06, Dallas County, Texas",5029,627,2022,359,3007,621
1400000US48113014407,48113014407,"Census Tract 144.07, Dallas County, Texas",4891,473,2186,441,2705,597
1400000US48113014408,48113014408,"Census Tract 144.08, Dallas County, Texas",4327,323,2597,348,1730,400
1400000US48113014501,48113014501,"Census Tract 145.01, Dallas County, Texas",3510,479,1692,276,1818,460
1400000US48113014502,48113014502,"Census Tract 145.02, Dallas County, Texas",4443,521,1892,301,2551,502
1400000US48113014601,48113014601,"Census Tract 146.01, Dallas County, Texas",2251,438,1009,153,1242,422
1400000US48113014602,48113014602,"Census Tract 146.02, Dallas County, Texas",5145,578,1365,286,3780,637
1400000US48113014603,48113014603,"Census Tract 146.03, Dallas County, Texas",1628,236,342,108,1286,262
1400000US48113014701,48113014701,"Census Tract 147.01, Dallas County, Texas",4176,503,875,169,3301,511
1400000US48113014702,48113014702,"Census Tract 147.02, Dallas County, Texas",3911,472,928,176,2983,463
1400000US48113014703,48113014703,"Census Tract 147.03, Dallas County, Texas",1477,369,346,130,1131,352
1400000US48113014901,48113014901,"Census Tract 149.01, Dallas County, Texas",1621,353,474,187,1147,334
1400000US48113014902,48113014902,"Census Tract 149.02, Dallas County, Texas",2524,462,861,289,1663,500
1400000US48113015000,48113015000,"Census Tract 150, Dallas County, Texas",7774,742,3072,386,4702,761
1400000US48113015100,48113015100,"Census Tract 151, Dallas County, Texas",6743,706,2948,376,3795,755
1400000US48113015202,48113015202,"Census Tract 152.02, Dallas County, Texas",3628,539,1179,335,2449,555
1400000US48113015204,48113015204,"Census Tract 152.04, Dallas County, Texas",7339,612,4019,404,3320,554
1400000US48113015205,48113015205,"Census Tract 152.05, Dallas County, Texas",3523,476,931,263,2592,539
1400000US48113015206,48113015206,"Census Tract 152.06, Dallas County, Texas",3786,482,2106,366,1680,380
1400000US48113015303,48113015303,"Census Tract 153.03, Dallas County, Texas",2418,577,680,149,1738,598
1400000US48113015304,48113015304,"Census Tract 153.04, Dallas County, Texas",2974,322,1673,259,1301,318
1400000US48113015305,48113015305,"Census Tract 153.05, Dallas County, Texas",4622,449,1871,375,2751,597
1400000US48113015306,48113015306,"Census Tract 153.06, Dallas County, Texas",4561,303,3209,285,1352,263
1400000US48113015401,48113015401,"Census Tract 154.01, Dallas County, Texas",5657,387,4560,466,1097,381
1400000US48113015403,48113015403,"Census Tract 154.03, Dallas County, Texas",3068,394,1660,349,1408,344
1400000US48113015404,48113015404,"Census Tract 154.04, Dallas County, Texas",4525,579,1854,425,2671,485
1400000US48113015500,48113015500,"Census Tract 155, Dallas County, Texas",4509,518,1992,392,2517,520
1400000US48113015600,48113015600,"Census Tract 156, Dallas County, Texas",5120,546,1184,307,3936,594
1400000US48113015700,48113015700,"Census Tract 157, Dallas County, Texas",2106,340,624,210,1482,440
1400000US48113015800,48113015800,"Census Tract 158, Dallas County, Texas",2133,324,811,138,1322,314
1400000US48113015900,48113015900,"Census Tract 159, Dallas County, Texas",3114,356,1453,251,1661,196
1400000US48113016001,48113016001,"Census Tract 160.01, Dallas County, Texas",3831,472,1439,340,2392,544
1400000US48113016002,48113016002,"Census Tract 160.02, Dallas County, Texas",2717,307,736,270,1981,416
1400000US48113016100,48113016100,"Census Tract 161, Dallas County, Texas",3598,317,2566,329,1032,289
1400000US48113016201,48113016201,"Census Tract 162.01, Dallas County, Texas",3783,534,1544,323,2239,565
1400000US48113016202,48113016202,"Census Tract 162.02, Dallas County, Texas",7068,840,3133,640,3935,994
1400000US48113016301,48113016301,"Census Tract 163.01, Dallas County, Texas",5449,588,1830,439,3619,616
1400000US48113016302,48113016302,"Census Tract 163.02, Dallas County, Texas",2022,391,493,175,1529,405
1400000US48113016401,48113016401,"Census Tract 164.01, Dallas County, Texas",8501,579,4972,543,3529,384
1400000US48113016406,48113016406,"Census Tract 164.06, Dallas County, Texas",4587,389,1550,411,3037,516
1400000US48113016407,48113016407,"Census Tract 164.07, Dallas County, Texas",7349,683,3158,430,4191,680
1400000US48113016408,48113016408,"Census Tract 164.08, Dallas County, Texas",6920,618,3310,425,3610,697
1400000US48113016409,48113016409,"Census Tract 164.09, Dallas County, Texas",3376,394,2500,241,876,360
1400000US48113016410,48113016410,"Census Tract 164.10, Dallas County, Texas",4928,423,3846,475,1082,276
1400000US48113016411,48113016411,"Census Tract 164.11, Dallas County, Texas",8381,516,5779,480,2602,491
1400000US48113016412,48113016412,"Census Tract 164.12, Dallas County, Texas",3878,259,3436,303,442,131
1400000US48113016413,48113016413,"Census Tract 164.13, Dallas County, Texas",7030,563,5197,619,1833,652
1400000US48113016502,48113016502,"Census Tract 165.02, Dallas County, Texas",7056,654,3481,465,3575,720
1400000US48113016509,48113016509,"Census Tract 165.09, Dallas County, Texas",5213,397,3811,420,1402,273
1400000US48113016510,48113016510,"Census Tract 165.10, Dallas County, Texas",10652,949,7288,787,3364,560
1400000US48113016511,48113016511,"Census Tract 165.11, Dallas County, Texas",4206,328,2851,339,1355,409
1400000US48113016513,48113016513,"Census Tract 165.13, Dallas County, Texas",5245,375,4571,428,674,222
1400000US48113016514,48113016514,"Census Tract 165.14, Dallas County, Texas",7189,651,6091,658,1098,358
1400000US48113016516,48113016516,"Census Tract 165.16, Dallas County, Texas",5220,497,2910,406,2310,607
1400000US48113016517,48113016517,"Census Tract 165.17, Dallas County, Texas",4586,468,3313,465,1273,390
1400000US48113016518,48113016518,"Census Tract 165.18, Dallas County, Texas",4897,553,3132,401,1765,481
1400000US48113016519,48113016519,"Census Tract 165.19, Dallas County, Texas",2232,297,1440,258,792,284
1400000US48113016520,48113016520,"Census Tract 165.20, Dallas County, Texas",6633,681,3502,652,3131,637
1400000US48113016521,48113016521,"Census Tract 165.21, Dallas County, Texas",5568,840,4999,732,569,282
1400000US48113016522,48113016522,"Census Tract 165.22, Dallas County, Texas",2883,392,2435,348,448,264
1400000US48113016523,48113016523,"Census Tract 165.23, Dallas County, Texas",3770,401,3416,353,354,212
1400000US48113016605,48113016605,"Census Tract 166.05, Dallas County, Texas",6289,566,4630,465,1659,361
1400000US48113016606,48113016606,"Census Tract 166.06, Dallas County, Texas",6872,612,5235,578,1637,303
1400000US48113016607,48113016607,"Census Tract 166.07, Dallas County, Texas",2942,295,2593,325,349,198
1400000US48113016610,48113016610,"Census Tract 166.10, Dallas County, Texas",4378,405,4206,397,172,79
1400000US48113016611,48113016611,"Census Tract 166.11, Dallas County, Texas",5866,497,5496,475,370,273
1400000US48113016612,48113016612,"Census Tract 166.12, Dallas County, Texas",11831,911,10914,940,917,250
1400000US48113016615,48113016615,"Census Tract 166.15, Dallas County, Texas",4056,384,3341,350,715,310
1400000US48113016616,48113016616,"Census Tract 166.16, Dallas County, Texas",5330,447,4615,492,715,360
1400000US48113016617,48113016617,"Census Tract 166.17, Dallas County, Texas",4355,375,4067,397,288,152
1400000US48113016618,48113016618,"Census Tract 166.18, Dallas County, Texas",4456,515,3948,512,508,313
1400000US48113016619,48113016619,"Census Tract 166.19, Dallas County, Texas",3515,468,3307,487,208,150
1400000US48113016620,48113016620,"Census Tract 166.20, Dallas County, Texas",4994,506,4541,478,453,169
1400000US48113016621,48113016621,"Census Tract 166.21, Dallas County, Texas",4943,544,3615,598,1328,375
1400000US48113016622,48113016622,"Census Tract 166.22, Dallas County, Texas",3025,440,2326,430,699,220
1400000US48113016623,48113016623,"Census Tract 166.23, Dallas County, Texas",5317,562,4317,513,1000,338
1400000US48113016624,48113016624,"Census Tract 166.24, Dallas County, Texas",3210,348,2592,402,618,279
1400000US48113016625,48113016625,"Census Tract 166.25, Dallas County, Texas",8032,579,7133,590,899,270
1400000US48113016626,48113016626,"Census Tract 166.26, Dallas County, Texas",3872,524,3258,580,614,359
1400000US48113016701,48113016701,"Census Tract 167.01, Dallas County, Texas",5528,457,5518,457,10,15
1400000US48113016703,48113016703,"Census Tract 167.03, Dallas County, Texas",8560,841,6505,875,2055,670
1400000US48113016704,48113016704,"Census Tract 167.04, Dallas County, Texas",3876,481,3428,486,448,226
1400000US48113016705,48113016705,"Census Tract 167.05, Dallas County, Texas",6537,634,5548,629,989,382
1400000US48113016802,48113016802,"Census Tract 168.02, Dallas County, Texas",2936,431,2439,416,497,191
1400000US48113016803,48113016803,"Census Tract 168.03, Dallas County, Texas",6273,669,4904,482,1369,534
1400000US48113016804,48113016804,"Census Tract 168.04, Dallas County, Texas",6538,762,6064,580,474,517
1400000US48113016902,48113016902,"Census Tract 169.02, Dallas County, Texas",6573,380,4540,440,2033,321
1400000US48113016903,48113016903,"Census Tract 169.03, Dallas County, Texas",4792,244,2724,329,2068,356
1400000US48113017001,48113017001,"Census Tract 170.01, Dallas County, Texas",7810,531,6075,548,1735,361
1400000US48113017003,48113017003,"Census Tract 170.03, Dallas County, Texas",9639,836,6035,758,3604,911
1400000US48113017004,48113017004,"Census Tract 170.04, Dallas County, Texas",7989,1086,2995,487,4994,1057
1400000US48113017101,48113017101,"Census Tract 171.01, Dallas County, Texas",4269,520,2119,387,2150,441
1400000US48113017102,48113017102,"Census Tract 171.02, Dallas County, Texas",5519,732,2429,471,3090,693
1400000US48113017201,48113017201,"Census Tract 172.01, Dallas County, Texas",4917,505,2491,328,2426,459
1400000US48113017202,48113017202,"Census Tract 172.02, Dallas County, Texas",8677,710,5376,648,3301,639
1400000US48113017301,48113017301,"Census Tract 173.01, Dallas County, Texas",6130,486,3864,398,2266,370
1400000US48113017303,48113017303,"Census Tract 173.03, Dallas County, Texas",7872,545,5732,647,2140,404
1400000US48113017304,48113017304,"Census Tract 173.04, Dallas County, Texas",9066,582,7241,628,1825,501
1400000US48113017305,48113017305,"Census Tract 173.05, Dallas County, Texas",9248,571,7315,572,1933,411
1400000US48113017306,48113017306,"Census Tract 173.06, Dallas County, Texas",7581,517,5196,479,2385,469
1400000US48113017400,48113017400,"Census Tract 174, Dallas County, Texas",5121,504,3858,373,1263,449
1400000US48113017500,48113017500,"Census Tract 175, Dallas County, Texas",3664,342,3126,357,538,253
1400000US48113017602,48113017602,"Census Tract 176.02, Dallas County, Texas",4072,377,2576,322,1496,272
1400000US48113017604,48113017604,"Census Tract 176.04, Dallas County, Texas",3196,504,1819,296,1377,490
1400000US48113017605,48113017605,"Census Tract 176.05, Dallas County, Texas",4948,717,2309,330,2639,764
1400000US48113017606,48113017606,"Census Tract 176.06, Dallas County, Texas",4536,551,2838,458,1698,470
1400000US48113017702,48113017702,"Census Tract 177.02, Dallas County, Texas",8089,672,6435,710,1654,730
1400000US48113017703,48113017703,"Census Tract 177.03, Dallas County, Texas",4448,617,2061,401,2387,706
1400000US48113017704,48113017704,"Census Tract 177.04, Dallas County, Texas",5000,667,2906,498,2094,502
1400000US48113017804,48113017804,"Census Tract 178.04, Dallas County, Texas",6355,695,4322,747,2033,561
1400000US48113017805,48113017805,"Census Tract 178.05, Dallas County, Texas",5418,608,3982,557,1436,442
1400000US48113017806,48113017806,"Census Tract 178.06, Dallas County, Texas",4623,454,2921,360,1702,422
1400000US48113017807,48113017807,"Census Tract 178.07, Dallas County, Texas",4337,460,2814,326,1523,432
1400000US48113017808,48113017808,"Census Tract 178.08, Dallas County, Texas",4350,465,3698,510,652,220
1400000US48113017811,48113017811,"Census Tract 178.11, Dallas County, Texas",4224,337,3505,323,719,186
1400000US48113017812,48113017812,"Census Tract 178.12, Dallas County, Texas",2298,204,2106,212,192,169
1400000US48113017813,48113017813,"Census Tract 178.13, Dallas County, Texas",6066,665,4203,631,1863,458
1400000US48113017814,48113017814,"Census Tract 178.14, Dallas County, Texas",5289,391,4629,417,660,202
1400000US48113017900,48113017900,"Census Tract 179, Dallas County, Texas",5234,445,2734,406,2500,435
1400000US48113018001,48113018001,"Census Tract 180.01, Dallas County, Texas",6382,673,3886,391,2496,632
1400000US48113018002,48113018002,"Census Tract 180.02, Dallas County, Texas",3586,397,2296,320,1290,360
1400000US48113018104,48113018104,"Census Tract 181.04, Dallas County, Texas",6246,328,5488,480,758,324
1400000US48113018105,48113018105,"Census Tract 181.05, Dallas County, Texas",5986,514,2864,503,3122,601
1400000US48113018110,48113018110,"Census Tract 181.10, Dallas County, Texas",4743,503,4015,391,728,562
1400000US48113018111,48113018111,"Census Tract 181.11, Dallas County, Texas",6543,691,3965,563,2578,557
1400000US48113018118,48113018118,"Census Tract 181.18, Dallas County, Texas",7275,512,5574,514,1701,415
1400000US48113018120,48113018120,"Census Tract 181.20, Dallas County, Texas",4417,386,3329,296,1088,292
1400000US48113018121,48113018121,"Census Tract 181.21, Dallas County, Texas",5243,366,2670,332,2573,388
1400000US48113018122,48113018122,"Census Tract 181.22, Dallas County, Texas",11552,419,9536,526,2016,428
1400000US48113018123,48113018123,"Census Tract 181.23, Dallas County, Texas",7842,585,6087,579,1755,508
1400000US48113018124,48113018124,"Census Tract 181.24, Dallas County, Texas",15823,772,13599,864,2224,473
1400000US48113018126,48113018126,"Census Tract 181.26, Dallas County, Texas",5884,564,3996,417,1888,536
1400000US48113018127,48113018127,"Census Tract 181.27, Dallas County, Texas",3429,371,1679,385,1750,308
1400000US48113018128,48113018128,"Census Tract 181.28, Dallas County, Texas",5397,637,3746,533,1651,520
1400000US48113018129,48113018129,"Census Tract 181.29, Dallas County, Texas",4351,573,3673,514,678,181
1400000US48113018130,48113018130,"Census Tract 181.30, Dallas County, Texas",4196,506,3290,446,906,446
1400000US48113018132,48113018132,"Census Tract 181.32, Dallas County, Texas",5140,381,3723,380,1417,253
1400000US48113018133,48113018133,"Census Tract 181.33, Dallas County, Texas",3805,223,2967,296,838,277
1400000US48113018134,48113018134,"Census Tract 181.34, Dallas County, Texas",5136,365,4675,367,461,314
1400000US48113018135,48113018135,"Census Tract 181.35, Dallas County, Texas",3146,525,2593,444,553,277
1400000US48113018136,48113018136,"Census Tract 181.36, Dallas County, Texas",7869,436,6982,505,887,339
1400000US48113018137,48113018137,"Census Tract 181.37, Dallas County, Texas",3935,373,3105,352,830,321
1400000US48113018138,48113018138,"Census Tract 181.38, Dallas County, Texas",4233,482,3577,464,656,312
1400000US48113018139,48113018139,"Census Tract 181.39, Dallas County, Texas",5633,623,4820,561,813,295
1400000US48113018140,48113018140,"Census Tract 181.40, Dallas County, Texas",5573,406,4635,403,938,344
1400000US48113018141,48113018141,"Census Tract 181.41, Dallas County, Texas",3264,487,2465,370,799,367
1400000US48113018142,48113018142,"Census Tract 181.42, Dallas County, Texas",3225,309,2743,319,482,124
1400000US48113018203,48113018203,"Census Tract 182.03, Dallas County, Texas",5968,633,2936,532,3032,597
1400000US48113018204,48113018204,"Census Tract 182.04, Dallas County, Texas",4352,505,1303,293,3049,549
1400000US48113018205,48113018205,"Census Tract 182.05, Dallas County, Texas",4248,441,1435,297,2813,451
1400000US48113018206,48113018206,"Census Tract 182.06, Dallas County, Texas",4974,461,1522,338,3452,531
1400000US48113018300,48113018300,"Census Tract 183, Dallas County, Texas",6061,510,2998,368,3063,596
1400000US48113018401,48113018401,"Census Tract 184.01, Dallas County, Texas",4993,671,2142,291,2851,681
1400000US48113018402,48113018402,"Census Tract 184.02, Dallas County, Texas",3817,388,3063,359,754,316
1400000US48113018403,48113018403,"Census Tract 184.03, Dallas County, Texas",743,171,443,101,300,164
1400000US48113018501,48113018501,"Census Tract 185.01, Dallas County, Texas",3729,439,2030,402,1699,351
1400000US48113018503,48113018503,"Census Tract 185.03, Dallas County, Texas",4238,513,3361,465,877,354
1400000US48113018505,48113018505,"Census Tract 185.05, Dallas County, Texas",2990,563,1996,444,994,468
1400000US48113018506,48113018506,"Census Tract 185.06, Dallas County, Texas",3143,461,2023,403,1120,385
1400000US48113018600,48113018600,"Census Tract 186, Dallas County, Texas",3554,348,2384,268,1170,392
1400000US48113018700,48113018700,"Census Tract 187, Dallas County, Texas",6065,597,2043,342,4022,645
1400000US48113018801,48113018801,"Census Tract 188.01, Dallas County, Texas",4163,444,1837,309,2326,507
1400000US48113018802,48113018802,"Census Tract 188.02, Dallas County, Texas",826,166,290,110,536,195
1400000US48113018900,48113018900,"Census Tract 189, Dallas County, Texas",6716,591,3826,501,2890,542
1400000US48113019004,48113019004,"Census Tract 190.04, Dallas County, Texas",6707,479,5558,477,1149,407
1400000US48113019013,48113019013,"Census Tract 190.13, Dallas County, Texas",5964,742,1251,369,4713,672
1400000US48113019014,48113019014,"Census Tract 190.14, Dallas County, Texas",7482,756,3523,740,3959,1000
1400000US48113019016,48113019016,"Census Tract 190.16, Dallas County, Texas",3022,299,2175,260,847,322
1400000US48113019018,48113019018,"Census Tract 190.18, Dallas County, Texas",5007,681,4357,693,650,404
1400000US48113019019,48113019019,"Census Tract 190.19, Dallas County, Texas",6202,517,4331,544,1871,491
1400000US48113019020,48113019020,"Census Tract 190.20, Dallas County, Texas",5023,519,4347,524,676,379
1400000US48113019021,48113019021,"Census Tract 190.21, Dallas County, Texas",6988,557,4235,368,2753,510
1400000US48113019023,48113019023,"Census Tract 190.23, Dallas County, Texas",4817,233,4379,318,438,249
1400000US48113019024,48113019024,"Census Tract 190.24, Dallas County, Texas",4568,391,3972,451,596,281
1400000US48113019025,48113019025,"Census Tract 190.25, Dallas County, Texas",5400,385,4848,433,552,489
1400000US48113019026,48113019026,"Census Tract 190.26, Dallas County, Texas",5253,379,4350,485,903,453
1400000US48113019027,48113019027,"Census Tract 190.27, Dallas County, Texas",4991,377,4590,395,401,182
1400000US48113019028,48113019028,"Census Tract 190.28, Dallas County, Texas",3737,302,2871,255,866,245
1400000US48113019029,48113019029,"Census Tract 190.29, Dallas County, Texas",6034,544,4507,546,1527,425
1400000US48113019031,48113019031,"Census Tract 190.31, Dallas County, Texas",6090,342,5302,334,788,312
1400000US48113019032,48113019032,"Census Tract 190.32, Dallas County, Texas",4820,435,1960,214,2860,489
1400000US48113019033,48113019033,"Census Tract 190.33, Dallas County, Texas",3918,524,1851,389,2067,411
1400000US48113019034,48113019034,"Census Tract 190.34, Dallas County, Texas",4112,511,3640,485,472,227
1400000US48113019035,48113019035,"Census Tract 190.35, Dallas County, Texas",4608,621,2543,388,2065,619
1400000US48113019036,48113019036,"Census Tract 190.36, Dallas County, Texas",2851,238,2592,236,259,134
1400000US48113019037,48113019037,"Census Tract 190.37, Dallas County, Texas",3733,280,3454,289,279,100
1400000US48113019038,48113019038,"Census Tract 190.38, Dallas County, Texas",239,97,227,96,12,18
1400000US48113019039,48113019039,"Census Tract 190.39, Dallas County, Texas",5816,387,4506,469,1310,467
1400000US48113019040,48113019040,"Census Tract 190.40, Dallas County, Texas",5810,593,5554,597,256,95
1400000US48113019041,48113019041,"Census Tract 190.41, Dallas County, Texas",2721,408,2616,414,105,81
1400000US48113019042,48113019042,"Census Tract 190.42, Dallas County, Texas",4695,448,3837,480,858,318
1400000US48113019043,48113019043,"Census Tract 190.43, Dallas County, Texas",7016,356,6509,359,507,254
1400000US48113019100,48113019100,"Census Tract 191, Dallas County, Texas",5225,543,4237,590,988,382
1400000US48113019202,48113019202,"Census Tract 192.02, Dallas County, Texas",4302,538,2600,455,1702,503
1400000US48113019203,48113019203,"Census Tract 192.03, Dallas County, Texas",3444,269,3071,184,373,175
1400000US48113019204,48113019204,"Census Tract 192.04, Dallas County, Texas",8461,490,3834,361,4627,640
1400000US48113019205,48113019205,"Census Tract 192.05, Dallas County, Texas",3459,278,3239,257,220,175
1400000US48113019206,48113019206,"Census Tract 192.06, Dallas County, Texas",5624,407,4674,475,950,352
1400000US48113019208,48113019208,"Census Tract 192.08, Dallas County, Texas",5893,773,2198,326,3695,749
1400000US48113019210,48113019210,"Census Tract 192.10, Dallas County, Texas",3886,237,3595,187,291,217
1400000US48113019211,48113019211,"Census Tract 192.11, Dallas County, Texas",5014,401,4399,404,615,209
1400000US48113019212,48113019212,"Census Tract 192.12, Dallas County, Texas",3371,525,52,61,3319,542
1400000US48113019213,48113019213,"Census Tract 192.13, Dallas County, Texas",3071,411,1571,300,1500,404
1400000US48113019301,48113019301,"Census Tract 193.01, Dallas County, Texas",2847,168,2626,254,221,226
1400000US48113019302,48113019302,"Census Tract 193.02, Dallas County, Texas",5080,536,4777,533,303,162
1400000US48113019400,48113019400,"Census Tract 194, Dallas County, Texas",4022,360,3890,338,132,114
1400000US48113019501,48113019501,"Census Tract 195.01, Dallas County, Texas",6578,343,6556,344,22,36
1400000US48113019502,48113019502,"Census Tract 195.02, Dallas County, Texas",4445,324,4264,330,181,120
1400000US48113019600,48113019600,"Census Tract 196, Dallas County, Texas",2548,292,2297,299,251,111
1400000US48113019700,48113019700,"Census Tract 197, Dallas County, Texas",2053,217,1887,339,166,171
1400000US48113019800,48113019800,"Census Tract 198, Dallas County, Texas",3930,231,3763,217,167,113
1400000US48113019900,48113019900,"Census Tract 199, Dallas County, Texas",4203,18,676,262,3527,262
1400000US48113020000,48113020000,"Census Tract 200, Dallas County, Texas",4058,238,3534,249,524,94
1400000US48113020100,48113020100,"Census Tract 201, Dallas County, Texas",2437,314,1084,250,1353,345
1400000US48113020200,48113020200,"Census Tract 202, Dallas County, Texas",3768,553,3768,553,0,127
1400000US48113020300,48113020300,"Census Tract 203, Dallas County, Texas",2161,322,2091,325,70,52
1400000US48113020400,48113020400,"Census Tract 204, Dallas County, Texas",4247,427,3285,396,962,166
1400000US48113020500,48113020500,"Census Tract 205, Dallas County, Texas",4566,510,3284,436,1282,388
1400000US48113020600,48113020600,"Census Tract 206, Dallas County, Texas",2280,193,2242,196,38,36
1400000US48113020700,48113020700,"Census Tract 207, Dallas County, Texas",4885,325,3772,306,1113,313
1400000US48113980000,48113980000,"Census Tract 9800, Dallas County, Texas",0,127,0,127,0,127
1400000US48113980100,48113980100,"Census Tract 9801, Dallas County, Texas",0,127,0,127,0,127
1400000US48115950401,48115950401,"Census Tract 9504.01, Dawson County, Texas",4219,396,2235,268,1984,382
1400000US48115950402,48115950402,"Census Tract 9504.02, Dawson County, Texas",4109,286,1839,151,2270,282
1400000US48115950500,48115950500,"Census Tract 9505, Dawson County, Texas",3925,383,1543,205,2382,359
1400000US48115950600,48115950600,"Census Tract 9506, Dawson County, Texas",1600,172,1097,168,503,163
1400000US48117950300,48117950300,"Census Tract 9503, Deaf Smith County, Texas",5588,392,2092,265,3496,387
1400000US48117950400,48117950400,"Census Tract 9504, Deaf Smith County, Texas",5932,420,1747,267,4185,481
1400000US48117950500,48117950500,"Census Tract 9505, Deaf Smith County, Texas",3382,553,688,269,2694,545
1400000US48117950600,48117950600,"Census Tract 9506, Deaf Smith County, Texas",4152,199,2159,315,1993,337
1400000US48119950100,48119950100,"Census Tract 9501, Delta County, Texas",3154,181,3045,183,109,42
1400000US48119950200,48119950200,"Census Tract 9502, Delta County, Texas",2094,181,1941,183,153,42
1400000US48121020103,48121020103,"Census Tract 201.03, Denton County, Texas",9476,457,8033,699,1443,601
1400000US48121020104,48121020104,"Census Tract 201.04, Denton County, Texas",2969,474,2591,479,378,222
1400000US48121020105,48121020105,"Census Tract 201.05, Denton County, Texas",4982,469,3986,470,996,371
1400000US48121020106,48121020106,"Census Tract 201.06, Denton County, Texas",5082,380,4541,429,541,217
1400000US48121020107,48121020107,"Census Tract 201.07, Denton County, Texas",3861,454,3372,393,489,231
1400000US48121020108,48121020108,"Census Tract 201.08, Denton County, Texas",5876,553,4738,484,1138,293
1400000US48121020109,48121020109,"Census Tract 201.09, Denton County, Texas",1359,211,1307,195,52,51
1400000US48121020110,48121020110,"Census Tract 201.10, Denton County, Texas",4441,290,3938,300,503,163
1400000US48121020111,48121020111,"Census Tract 201.11, Denton County, Texas",3518,258,3338,287,180,113
1400000US48121020112,48121020112,"Census Tract 201.12, Denton County, Texas",2503,284,2213,282,290,106
1400000US48121020113,48121020113,"Census Tract 201.13, Denton County, Texas",8336,487,6210,492,2126,299
1400000US48121020114,48121020114,"Census Tract 201.14, Denton County, Texas",7725,569,5611,536,2114,581
1400000US48121020115,48121020115,"Census Tract 201.15, Denton County, Texas",4184,537,2904,343,1280,532
1400000US48121020202,48121020202,"Census Tract 202.02, Denton County, Texas",9114,765,7843,794,1271,320
1400000US48121020203,48121020203,"Census Tract 202.03, Denton County, Texas",4125,400,3569,406,556,207
1400000US48121020204,48121020204,"Census Tract 202.04, Denton County, Texas",4159,459,3918,504,241,152
1400000US48121020205,48121020205,"Census Tract 202.05, Denton County, Texas",1628,233,1316,232,312,227
1400000US48121020303,48121020303,"Census Tract 203.03, Denton County, Texas",8963,501,7987,492,976,418
1400000US48121020305,48121020305,"Census Tract 203.05, Denton County, Texas",6899,410,6681,424,218,118
1400000US48121020306,48121020306,"Census Tract 203.06, Denton County, Texas",5238,495,4773,508,465,164
1400000US48121020307,48121020307,"Census Tract 203.07, Denton County, Texas",6285,377,5492,334,793,216
1400000US48121020308,48121020308,"Census Tract 203.08, Denton County, Texas",9273,755,7597,594,1676,510
1400000US48121020309,48121020309,"Census Tract 203.09, Denton County, Texas",8156,597,7194,545,962,492
1400000US48121020310,48121020310,"Census Tract 203.10, Denton County, Texas",2437,248,2287,176,150,167
1400000US48121020401,48121020401,"Census Tract 204.01, Denton County, Texas",5565,527,4251,444,1314,414
1400000US48121020402,48121020402,"Census Tract 204.02, Denton County, Texas",4725,396,4157,358,568,228
1400000US48121020403,48121020403,"Census Tract 204.03, Denton County, Texas",3538,326,2962,311,576,235
1400000US48121020503,48121020503,"Census Tract 205.03, Denton County, Texas",5490,392,4705,455,785,266
1400000US48121020504,48121020504,"Census Tract 205.04, Denton County, Texas",2646,589,1384,472,1262,597
1400000US48121020505,48121020505,"Census Tract 205.05, Denton County, Texas",6443,400,6145,378,298,230
1400000US48121020506,48121020506,"Census Tract 205.06, Denton County, Texas",1916,235,1453,271,463,273
1400000US48121020601,48121020601,"Census Tract 206.01, Denton County, Texas",4917,722,3321,530,1596,512
1400000US48121020602,48121020602,"Census Tract 206.02, Denton County, Texas",7939,570,5253,588,2686,554
1400000US48121020700,48121020700,"Census Tract 207, Denton County, Texas",3803,432,3239,335,564,214
1400000US48121020800,48121020800,"Census Tract 208, Denton County, Texas",4843,580,3767,522,1076,429
1400000US48121020900,48121020900,"Census Tract 209, Denton County, Texas",3826,497,2942,458,884,305
1400000US48121021000,48121021000,"Census Tract 210, Denton County, Texas",6802,905,5462,741,1340,432
1400000US48121021100,48121021100,"Census Tract 211, Denton County, Texas",2315,258,1928,247,387,171
1400000US48121021201,48121021201,"Census Tract 212.01, Denton County, Texas",5303,486,4269,563,1034,438
1400000US48121021202,48121021202,"Census Tract 212.02, Denton County, Texas",5321,1158,3720,746,1601,537
1400000US48121021301,48121021301,"Census Tract 213.01, Denton County, Texas",2008,250,1813,269,195,107
1400000US48121021303,48121021303,"Census Tract 213.03, Denton County, Texas",7297,1246,6380,1114,917,417
1400000US48121021304,48121021304,"Census Tract 213.04, Denton County, Texas",5993,771,4893,514,1100,512
1400000US48121021305,48121021305,"Census Tract 213.05, Denton County, Texas",3414,277,3110,301,304,208
1400000US48121021403,48121021403,"Census Tract 214.03, Denton County, Texas",9362,523,7521,578,1841,366
1400000US48121021404,48121021404,"Census Tract 214.04, Denton County, Texas",7434,341,6857,359,577,203
1400000US48121021405,48121021405,"Census Tract 214.05, Denton County, Texas",9428,841,6037,625,3391,780
1400000US48121021406,48121021406,"Census Tract 214.06, Denton County, Texas",6884,984,5534,988,1350,426
1400000US48121021407,48121021407,"Census Tract 214.07, Denton County, Texas",5790,502,3933,460,1857,672
1400000US48121021408,48121021408,"Census Tract 214.08, Denton County, Texas",6294,340,5507,375,787,357
1400000US48121021409,48121021409,"Census Tract 214.09, Denton County, Texas",7298,403,6415,403,883,252
1400000US48121021502,48121021502,"Census Tract 215.02, Denton County, Texas",4698,455,2594,309,2104,429
1400000US48121021505,48121021505,"Census Tract 215.05, Denton County, Texas",6175,369,5312,379,863,244
1400000US48121021512,48121021512,"Census Tract 215.12, Denton County, Texas",4723,246,4534,271,189,162
1400000US48121021513,48121021513,"Census Tract 215.13, Denton County, Texas",3633,199,3411,237,222,141
1400000US48121021514,48121021514,"Census Tract 215.14, Denton County, Texas",3998,250,3653,295,345,182
1400000US48121021515,48121021515,"Census Tract 215.15, Denton County, Texas",3721,442,2851,430,870,264
1400000US48121021516,48121021516,"Census Tract 215.16, Denton County, Texas",6752,336,5408,482,1344,433
1400000US48121021517,48121021517,"Census Tract 215.17, Denton County, Texas",1468,214,1375,222,93,100
1400000US48121021518,48121021518,"Census Tract 215.18, Denton County, Texas",3349,276,3049,317,300,182
1400000US48121021519,48121021519,"Census Tract 215.19, Denton County, Texas",10436,510,8645,476,1791,374
1400000US48121021520,48121021520,"Census Tract 215.20, Denton County, Texas",3467,267,2513,269,954,168
1400000US48121021521,48121021521,"Census Tract 215.21, Denton County, Texas",4191,304,3021,324,1170,352
1400000US48121021522,48121021522,"Census Tract 215.22, Denton County, Texas",431,295,431,295,0,127
1400000US48121021523,48121021523,"Census Tract 215.23, Denton County, Texas",3906,365,2590,321,1316,372
1400000US48121021524,48121021524,"Census Tract 215.24, Denton County, Texas",1517,256,1396,244,121,99
1400000US48121021525,48121021525,"Census Tract 215.25, Denton County, Texas",6713,337,5953,339,760,350
1400000US48121021526,48121021526,"Census Tract 215.26, Denton County, Texas",4850,307,4504,331,346,167
1400000US48121021527,48121021527,"Census Tract 215.27, Denton County, Texas",5609,310,5276,329,333,185
1400000US48121021611,48121021611,"Census Tract 216.11, Denton County, Texas",3954,236,3351,257,603,184
1400000US48121021612,48121021612,"Census Tract 216.12, Denton County, Texas",3733,353,3022,283,711,270
1400000US48121021613,48121021613,"Census Tract 216.13, Denton County, Texas",5454,396,3748,447,1706,425
1400000US48121021614,48121021614,"Census Tract 216.14, Denton County, Texas",3726,383,1820,296,1906,434
1400000US48121021615,48121021615,"Census Tract 216.15, Denton County, Texas",4321,436,2381,296,1940,394
1400000US48121021616,48121021616,"Census Tract 216.16, Denton County, Texas",3847,400,3135,427,712,338
1400000US48121021618,48121021618,"Census Tract 216.18, Denton County, Texas",3832,483,2313,366,1519,432
1400000US48121021619,48121021619,"Census Tract 216.19, Denton County, Texas",2939,700,1098,295,1841,680
1400000US48121021620,48121021620,"Census Tract 216.20, Denton County, Texas",1506,291,1380,304,126,48
1400000US48121021621,48121021621,"Census Tract 216.21, Denton County, Texas",4351,373,4061,364,290,200
1400000US48121021622,48121021622,"Census Tract 216.22, Denton County, Texas",5209,306,4782,314,427,128
1400000US48121021623,48121021623,"Census Tract 216.23, Denton County, Texas",5256,442,4811,469,445,168
1400000US48121021624,48121021624,"Census Tract 216.24, Denton County, Texas",7613,1063,5711,671,1902,850
1400000US48121021625,48121021625,"Census Tract 216.25, Denton County, Texas",2777,239,2575,277,202,126
1400000US48121021626,48121021626,"Census Tract 216.26, Denton County, Texas",1981,286,1891,314,90,108
1400000US48121021627,48121021627,"Census Tract 216.27, Denton County, Texas",5811,380,5570,391,241,136
1400000US48121021628,48121021628,"Census Tract 216.28, Denton County, Texas",6443,429,5491,432,952,335
1400000US48121021629,48121021629,"Census Tract 216.29, Denton County, Texas",5367,466,4928,486,439,164
1400000US48121021630,48121021630,"Census Tract 216.30, Denton County, Texas",4828,434,4134,532,694,362
1400000US48121021631,48121021631,"Census Tract 216.31, Denton County, Texas",4965,232,4320,336,645,281
1400000US48121021632,48121021632,"Census Tract 216.32, Denton County, Texas",3510,263,3250,223,260,141
1400000US48121021633,48121021633,"Census Tract 216.33, Denton County, Texas",4121,275,3736,256,385,163
1400000US48121021634,48121021634,"Census Tract 216.34, Denton County, Texas",4457,443,3230,429,1227,475
1400000US48121021635,48121021635,"Census Tract 216.35, Denton County, Texas",4077,500,3217,389,860,393
1400000US48121021636,48121021636,"Census Tract 216.36, Denton County, Texas",6668,477,5015,477,1653,452
1400000US48121021637,48121021637,"Census Tract 216.37, Denton County, Texas",4349,443,2956,423,1393,547
1400000US48121021638,48121021638,"Census Tract 216.38, Denton County, Texas",4167,469,2922,438,1245,406
1400000US48121021715,48121021715,"Census Tract 217.15, Denton County, Texas",4528,533,3820,473,708,331
1400000US48121021716,48121021716,"Census Tract 217.16, Denton County, Texas",5665,609,4758,609,907,437
1400000US48121021717,48121021717,"Census Tract 217.17, Denton County, Texas",5503,420,4882,450,621,217
1400000US48121021718,48121021718,"Census Tract 217.18, Denton County, Texas",6516,416,6187,446,329,108
1400000US48121021719,48121021719,"Census Tract 217.19, Denton County, Texas",3956,211,3664,227,292,93
1400000US48121021720,48121021720,"Census Tract 217.20, Denton County, Texas",2992,223,2689,239,303,192
1400000US48121021721,48121021721,"Census Tract 217.21, Denton County, Texas",3549,274,3120,194,429,255
1400000US48121021722,48121021722,"Census Tract 217.22, Denton County, Texas",3963,299,3562,359,401,182
1400000US48121021723,48121021723,"Census Tract 217.23, Denton County, Texas",1364,208,1144,305,220,176
1400000US48121021724,48121021724,"Census Tract 217.24, Denton County, Texas",4171,277,3982,316,189,148
1400000US48121021725,48121021725,"Census Tract 217.25, Denton County, Texas",3683,225,3335,196,348,167
1400000US48121021726,48121021726,"Census Tract 217.26, Denton County, Texas",2928,177,2794,227,134,132
1400000US48121021727,48121021727,"Census Tract 217.27, Denton County, Texas",4460,378,4314,401,146,116
1400000US48121021728,48121021728,"Census Tract 217.28, Denton County, Texas",1622,307,865,201,757,387
1400000US48121021729,48121021729,"Census Tract 217.29, Denton County, Texas",2726,231,2425,248,301,135
1400000US48121021730,48121021730,"Census Tract 217.30, Denton County, Texas",3525,321,3377,317,148,126
1400000US48121021731,48121021731,"Census Tract 217.31, Denton County, Texas",3693,318,3261,288,432,256
1400000US48121021732,48121021732,"Census Tract 217.32, Denton County, Texas",2219,293,1701,375,518,379
1400000US48121021733,48121021733,"Census Tract 217.33, Denton County, Texas",2009,365,1384,348,625,259
1400000US48121021734,48121021734,"Census Tract 217.34, Denton County, Texas",2649,284,2437,331,212,136
1400000US48121021735,48121021735,"Census Tract 217.35, Denton County, Texas",3310,461,2651,398,659,344
1400000US48121021736,48121021736,"Census Tract 217.36, Denton County, Texas",2246,405,1869,462,377,199
1400000US48121021737,48121021737,"Census Tract 217.37, Denton County, Texas",3900,269,3542,324,358,120
1400000US48121021738,48121021738,"Census Tract 217.38, Denton County, Texas",1797,283,1556,282,241,117
1400000US48121021739,48121021739,"Census Tract 217.39, Denton County, Texas",3598,441,1950,274,1648,493
1400000US48121021740,48121021740,"Census Tract 217.40, Denton County, Texas",5113,442,3844,492,1269,417
1400000US48121021741,48121021741,"Census Tract 217.41, Denton County, Texas",1880,296,1659,263,221,206
1400000US48121021742,48121021742,"Census Tract 217.42, Denton County, Texas",6277,512,4141,645,2136,518
1400000US48121021743,48121021743,"Census Tract 217.43, Denton County, Texas",3766,502,2136,416,1630,389
1400000US48121021744,48121021744,"Census Tract 217.44, Denton County, Texas",2622,337,1343,283,1279,311
1400000US48121021745,48121021745,"Census Tract 217.45, Denton County, Texas",5230,748,2574,439,2656,725
1400000US48121021746,48121021746,"Census Tract 217.46, Denton County, Texas",3375,191,3209,243,166,139
1400000US48121021747,48121021747,"Census Tract 217.47, Denton County, Texas",3937,277,3535,396,402,259
1400000US48121021748,48121021748,"Census Tract 217.48, Denton County, Texas",3987,206,3709,236,278,167
1400000US48121021749,48121021749,"Census Tract 217.49, Denton County, Texas",3113,162,2739,296,374,259
1400000US48121021750,48121021750,"Census Tract 217.50, Denton County, Texas",3861,252,3559,331,302,182
1400000US48121021751,48121021751,"Census Tract 217.51, Denton County, Texas",4580,228,4265,260,315,176
1400000US48121021752,48121021752,"Census Tract 217.52, Denton County, Texas",4704,213,4026,349,678,325
1400000US48121021753,48121021753,"Census Tract 217.53, Denton County, Texas",5170,351,5033,356,137,82
1400000US48121021800,48121021800,"Census Tract 218, Denton County, Texas",3363,225,3240,247,123,100
1400000US48121021900,48121021900,"Census Tract 219, Denton County, Texas",4452,367,4128,351,324,191
1400000US48123970100,48123970100,"Census Tract 9701, DeWitt County, Texas",4023,404,2789,411,1234,243
1400000US48123970200,48123970200,"Census Tract 9702, DeWitt County, Texas",5688,347,3268,341,2420,310
1400000US48123970300,48123970300,"Census Tract 9703, DeWitt County, Texas",4217,381,3224,428,993,256
1400000US48123970400,48123970400,"Census Tract 9704, DeWitt County, Texas",3498,334,2548,293,950,295
1400000US48123970500,48123970500,"Census Tract 9705, DeWitt County, Texas",2599,319,2034,263,565,136
1400000US48125950300,48125950300,"Census Tract 9503, Dickens County, Texas",2441,,1715,80,726,80
1400000US48127950200,48127950200,"Census Tract 9502, Dimmit County, Texas",7478,388,1092,259,6386,353
1400000US48127950400,48127950400,"Census Tract 9504, Dimmit County, Texas",2430,388,437,259,1993,353
1400000US48129950200,48129950200,"Census Tract 9502, Donley County, Texas",2032,214,1872,220,160,78
1400000US48129950300,48129950300,"Census Tract 9503, Donley County, Texas",1623,177,1501,176,122,62
1400000US48131950100,48131950100,"Census Tract 9501, Duval County, Texas",4987,423,551,152,4436,413
1400000US48131950200,48131950200,"Census Tract 9502, Duval County, Texas",3316,278,865,158,2451,240
1400000US48131950500,48131950500,"Census Tract 9505, Duval County, Texas",3696,459,147,74,3549,454
1400000US48133950100,48133950100,"Census Tract 9501, Eastland County, Texas",3512,501,3023,465,489,182
1400000US48133950200,48133950200,"Census Tract 9502, Eastland County, Texas",6052,472,5159,499,893,251
1400000US48133950300,48133950300,"Census Tract 9503, Eastland County, Texas",4836,317,4164,357,672,235
1400000US48133950400,48133950400,"Census Tract 9504, Eastland County, Texas",1847,303,1776,293,71,48
1400000US48133950500,48133950500,"Census Tract 9505, Eastland County, Texas",2313,365,1869,321,444,213
1400000US48135000100,48135000100,"Census Tract 1, Ector County, Texas",2971,347,1804,220,1167,387
1400000US48135000300,48135000300,"Census Tract 3, Ector County, Texas",2038,188,1565,208,473,116
1400000US48135000400,48135000400,"Census Tract 4, Ector County, Texas",4698,390,3111,333,1587,357
1400000US48135000500,48135000500,"Census Tract 5, Ector County, Texas",4003,436,2237,343,1766,399
1400000US48135000600,48135000600,"Census Tract 6, Ector County, Texas",5616,543,2393,387,3223,484
1400000US48135000700,48135000700,"Census Tract 7, Ector County, Texas",4602,479,1683,308,2919,482
1400000US48135000800,48135000800,"Census Tract 8, Ector County, Texas",3619,421,1847,366,1772,384
1400000US48135001000,48135001000,"Census Tract 10, Ector County, Texas",4799,370,1801,284,2998,334
1400000US48135001100,48135001100,"Census Tract 11, Ector County, Texas",6525,596,1558,243,4967,580
1400000US48135001300,48135001300,"Census Tract 13, Ector County, Texas",4594,390,2084,280,2510,385
1400000US48135001500,48135001500,"Census Tract 15, Ector County, Texas",4357,439,878,189,3479,501
1400000US48135001600,48135001600,"Census Tract 16, Ector County, Texas",5704,906,3055,382,2649,799
1400000US48135001700,48135001700,"Census Tract 17, Ector County, Texas",5730,466,4015,387,1715,593
1400000US48135001800,48135001800,"Census Tract 18, Ector County, Texas",3044,354,1253,210,1791,340
1400000US48135001900,48135001900,"Census Tract 19, Ector County, Texas",5472,573,413,135,5059,564
1400000US48135002000,48135002000,"Census Tract 20, Ector County, Texas",3429,414,760,269,2669,328
1400000US48135002200,48135002200,"Census Tract 22, Ector County, Texas",2739,391,746,220,1993,413
1400000US48135002300,48135002300,"Census Tract 23, Ector County, Texas",3550,310,2776,349,774,198
1400000US48135002400,48135002400,"Census Tract 24, Ector County, Texas",4390,346,3583,308,807,201
1400000US48135002501,48135002501,"Census Tract 25.01, Ector County, Texas",3520,289,1671,258,1849,372
1400000US48135002502,48135002502,"Census Tract 25.02, Ector County, Texas",5954,521,4816,517,1138,360
1400000US48135002503,48135002503,"Census Tract 25.03, Ector County, Texas",5531,500,3570,471,1961,482
1400000US48135002700,48135002700,"Census Tract 27, Ector County, Texas",9077,645,4517,523,4560,588
1400000US48135002801,48135002801,"Census Tract 28.01, Ector County, Texas",3816,401,1398,326,2418,291
1400000US48135002802,48135002802,"Census Tract 28.02, Ector County, Texas",8614,822,3654,439,4960,757
1400000US48135002900,48135002900,"Census Tract 29, Ector County, Texas",3428,313,2687,331,741,231
1400000US48135003000,48135003000,"Census Tract 30, Ector County, Texas",7797,624,4503,557,3294,493
1400000US48135003100,48135003100,"Census Tract 31, Ector County, Texas",3398,417,993,286,2405,354
1400000US48137950300,48137950300,"Census Tract 9503, Edwards County, Texas",2029,,944,130,1085,130
1400000US48139060101,48139060101,"Census Tract 601.01, Ellis County, Texas",7524,715,5028,630,2496,567
1400000US48139060102,48139060102,"Census Tract 601.02, Ellis County, Texas",6874,615,4320,429,2554,470
1400000US48139060204,48139060204,"Census Tract 602.04, Ellis County, Texas",8495,495,7080,480,1415,364
1400000US48139060206,48139060206,"Census Tract 602.06, Ellis County, Texas",5485,678,4164,463,1321,612
1400000US48139060207,48139060207,"Census Tract 602.07, Ellis County, Texas",6183,433,4916,379,1267,248
1400000US48139060208,48139060208,"Census Tract 602.08, Ellis County, Texas",3520,303,3074,298,446,224
1400000US48139060209,48139060209,"Census Tract 602.09, Ellis County, Texas",3247,343,2940,343,307,114
1400000US48139060210,48139060210,"Census Tract 602.10, Ellis County, Texas",1429,251,1164,177,265,239
1400000US48139060211,48139060211,"Census Tract 602.11, Ellis County, Texas",2751,268,2456,303,295,164
1400000US48139060212,48139060212,"Census Tract 602.12, Ellis County, Texas",3384,237,2740,244,644,189
1400000US48139060213,48139060213,"Census Tract 602.13, Ellis County, Texas",6000,361,4691,321,1309,288
1400000US48139060214,48139060214,"Census Tract 602.14, Ellis County, Texas",6312,430,5569,532,743,312
1400000US48139060300,48139060300,"Census Tract 603, Ellis County, Texas",4432,419,3169,389,1263,445
1400000US48139060400,48139060400,"Census Tract 604, Ellis County, Texas",4592,465,3460,507,1132,281
1400000US48139060500,48139060500,"Census Tract 605, Ellis County, Texas",3475,352,2068,319,1407,369
1400000US48139060600,48139060600,"Census Tract 606, Ellis County, Texas",7761,679,6395,719,1366,459
1400000US48139060701,48139060701,"Census Tract 607.01, Ellis County, Texas",2023,328,1411,270,612,357
1400000US48139060702,48139060702,"Census Tract 607.02, Ellis County, Texas",3656,421,2692,383,964,340
1400000US48139060703,48139060703,"Census Tract 607.03, Ellis County, Texas",1806,249,1606,231,200,128
1400000US48139060801,48139060801,"Census Tract 608.01, Ellis County, Texas",5548,346,5361,359,187,80
1400000US48139060802,48139060802,"Census Tract 608.02, Ellis County, Texas",6021,537,5314,489,707,248
1400000US48139060803,48139060803,"Census Tract 608.03, Ellis County, Texas",1282,177,993,297,289,306
1400000US48139060900,48139060900,"Census Tract 609, Ellis County, Texas",6067,518,5392,490,675,305
1400000US48139061000,48139061000,"Census Tract 610, Ellis County, Texas",4022,277,3596,274,426,145
1400000US48139061100,48139061100,"Census Tract 611, Ellis County, Texas",4538,441,3289,381,1249,268
1400000US48139061200,48139061200,"Census Tract 612, Ellis County, Texas",1852,295,1089,215,763,237
1400000US48139061300,48139061300,"Census Tract 613, Ellis County, Texas",1871,251,1376,247,495,195
1400000US48139061400,48139061400,"Census Tract 614, Ellis County, Texas",7440,505,5493,451,1947,498
1400000US48139061500,48139061500,"Census Tract 615, Ellis County, Texas",4867,442,2554,373,2313,447
1400000US48139061600,48139061600,"Census Tract 616, Ellis County, Texas",6300,384,3979,500,2321,318
1400000US48139061700,48139061700,"Census Tract 617, Ellis County, Texas",4745,586,3670,440,1075,386
1400000US48141000101,48141000101,"Census Tract 1.01, El Paso County, Texas",6656,433,3079,368,3577,508
1400000US48141000106,48141000106,"Census Tract 1.06, El Paso County, Texas",6586,543,3384,356,3202,474
1400000US48141000107,48141000107,"Census Tract 1.07, El Paso County, Texas",5569,382,1404,253,4165,336
1400000US48141000108,48141000108,"Census Tract 1.08, El Paso County, Texas",2206,467,831,255,1375,386
1400000US48141000109,48141000109,"Census Tract 1.09, El Paso County, Texas",3648,366,771,266,2877,330
1400000US48141000110,48141000110,"Census Tract 1.10, El Paso County, Texas",3496,275,1159,328,2337,333
1400000US48141000111,48141000111,"Census Tract 1.11, El Paso County, Texas",2892,360,1373,258,1519,357
1400000US48141000112,48141000112,"Census Tract 1.12, El Paso County, Texas",5165,520,1847,380,3318,540
1400000US48141000204,48141000204,"Census Tract 2.04, El Paso County, Texas",5393,420,2173,426,3220,551
1400000US48141000205,48141000205,"Census Tract 2.05, El Paso County, Texas",4344,494,974,210,3370,504
1400000US48141000206,48141000206,"Census Tract 2.06, El Paso County, Texas",4661,408,1001,207,3660,405
1400000US48141000207,48141000207,"Census Tract 2.07, El Paso County, Texas",4513,617,929,250,3584,573
1400000US48141000208,48141000208,"Census Tract 2.08, El Paso County, Texas",3161,586,642,242,2519,583
1400000US48141000301,48141000301,"Census Tract 3.01, El Paso County, Texas",6725,626,951,276,5774,661
1400000US48141000302,48141000302,"Census Tract 3.02, El Paso County, Texas",5541,632,719,235,4822,640
1400000US48141000401,48141000401,"Census Tract 4.01, El Paso County, Texas",5955,372,2883,285,3072,456
1400000US48141000403,48141000403,"Census Tract 4.03, El Paso County, Texas",3172,298,818,202,2354,307
1400000US48141000404,48141000404,"Census Tract 4.04, El Paso County, Texas",4353,442,473,146,3880,447
1400000US48141000600,48141000600,"Census Tract 6, El Paso County, Texas",4120,436,531,143,3589,482
1400000US48141000800,48141000800,"Census Tract 8, El Paso County, Texas",5816,578,667,230,5149,567
1400000US48141000900,48141000900,"Census Tract 9, El Paso County, Texas",7817,926,822,289,6995,976
1400000US48141001001,48141001001,"Census Tract 10.01, El Paso County, Texas",3182,380,244,98,2938,402
1400000US48141001002,48141001002,"Census Tract 10.02, El Paso County, Texas",4318,388,222,79,4096,397
1400000US48141001104,48141001104,"Census Tract 11.04, El Paso County, Texas",8063,742,2524,536,5539,722
1400000US48141001107,48141001107,"Census Tract 11.07, El Paso County, Texas",7008,493,2515,371,4493,484
1400000US48141001109,48141001109,"Census Tract 11.09, El Paso County, Texas",4427,271,2261,224,2166,218
1400000US48141001110,48141001110,"Census Tract 11.10, El Paso County, Texas",4728,417,2438,488,2290,441
1400000US48141001111,48141001111,"Census Tract 11.11, El Paso County, Texas",4429,617,1622,392,2807,630
1400000US48141001112,48141001112,"Census Tract 11.12, El Paso County, Texas",4748,357,1932,281,2816,291
1400000US48141001113,48141001113,"Census Tract 11.13, El Paso County, Texas",6860,572,1930,315,4930,656
1400000US48141001114,48141001114,"Census Tract 11.14, El Paso County, Texas",4654,658,1178,388,3476,542
1400000US48141001115,48141001115,"Census Tract 11.15, El Paso County, Texas",3636,616,287,123,3349,660
1400000US48141001201,48141001201,"Census Tract 12.01, El Paso County, Texas",6282,587,499,130,5783,577
1400000US48141001202,48141001202,"Census Tract 12.02, El Paso County, Texas",4687,273,1075,229,3612,331
1400000US48141001203,48141001203,"Census Tract 12.03, El Paso County, Texas",858,177,17,28,841,183
1400000US48141001301,48141001301,"Census Tract 13.01, El Paso County, Texas",3554,297,1556,225,1998,287
1400000US48141001302,48141001302,"Census Tract 13.02, El Paso County, Texas",6929,728,3037,460,3892,735
1400000US48141001400,48141001400,"Census Tract 14, El Paso County, Texas",2230,339,447,198,1783,309
1400000US48141001501,48141001501,"Census Tract 15.01, El Paso County, Texas",4758,420,1609,341,3149,453
1400000US48141001502,48141001502,"Census Tract 15.02, El Paso County, Texas",2622,317,1217,292,1405,264
1400000US48141001600,48141001600,"Census Tract 16, El Paso County, Texas",4454,466,1007,250,3447,469
1400000US48141001700,48141001700,"Census Tract 17, El Paso County, Texas",1638,258,129,46,1509,260
1400000US48141001800,48141001800,"Census Tract 18, El Paso County, Texas",1195,314,70,69,1125,347
1400000US48141001900,48141001900,"Census Tract 19, El Paso County, Texas",2523,382,0,127,2523,382
1400000US48141002000,48141002000,"Census Tract 20, El Paso County, Texas",2104,495,43,54,2061,475
1400000US48141002100,48141002100,"Census Tract 21, El Paso County, Texas",2894,417,54,50,2840,415
1400000US48141002201,48141002201,"Census Tract 22.01, El Paso County, Texas",3448,416,485,151,2963,465
1400000US48141002202,48141002202,"Census Tract 22.02, El Paso County, Texas",4765,641,265,115,4500,660
1400000US48141002300,48141002300,"Census Tract 23, El Paso County, Texas",4450,453,426,219,4024,447
1400000US48141002400,48141002400,"Census Tract 24, El Paso County, Texas",3902,529,439,221,3463,499
1400000US48141002500,48141002500,"Census Tract 25, El Paso County, Texas",6176,746,459,141,5717,708
1400000US48141002600,48141002600,"Census Tract 26, El Paso County, Texas",3044,360,51,52,2993,373
1400000US48141002800,48141002800,"Census Tract 28, El Paso County, Texas",5133,540,89,61,5044,548
1400000US48141002900,48141002900,"Census Tract 29, El Paso County, Texas",1365,354,132,154,1233,333
1400000US48141003000,48141003000,"Census Tract 30, El Paso County, Texas",4359,428,155,141,4204,407
1400000US48141003100,48141003100,"Census Tract 31, El Paso County, Texas",3680,383,166,207,3514,400
1400000US48141003200,48141003200,"Census Tract 32, El Paso County, Texas",2639,374,47,58,2592,382
1400000US48141003300,48141003300,"Census Tract 33, El Paso County, Texas",6432,636,372,124,6060,650
1400000US48141003402,48141003402,"Census Tract 34.02, El Paso County, Texas",6010,669,682,213,5328,674
1400000US48141003403,48141003403,"Census Tract 34.03, El Paso County, Texas",6045,578,1657,342,4388,656
1400000US48141003404,48141003404,"Census Tract 34.04, El Paso County, Texas",5947,422,1856,342,4091,446
1400000US48141003501,48141003501,"Census Tract 35.01, El Paso County, Texas",2926,375,213,180,2713,406
1400000US48141003502,48141003502,"Census Tract 35.02, El Paso County, Texas",4680,616,272,153,4408,640
1400000US48141003601,48141003601,"Census Tract 36.01, El Paso County, Texas",3705,467,181,82,3524,458
1400000US48141003602,48141003602,"Census Tract 36.02, El Paso County, Texas",3099,501,157,115,2942,493
1400000US48141003701,48141003701,"Census Tract 37.01, El Paso County, Texas",5186,472,118,88,5068,461
1400000US48141003702,48141003702,"Census Tract 37.02, El Paso County, Texas",4418,471,164,163,4254,484
1400000US48141003801,48141003801,"Census Tract 38.01, El Paso County, Texas",5412,509,204,100,5208,515
1400000US48141003803,48141003803,"Census Tract 38.03, El Paso County, Texas",3345,279,90,65,3255,297
1400000US48141003804,48141003804,"Census Tract 38.04, El Paso County, Texas",4127,411,230,202,3897,396
1400000US48141003901,48141003901,"Census Tract 39.01, El Paso County, Texas",4019,464,82,51,3937,467
1400000US48141003902,48141003902,"Census Tract 39.02, El Paso County, Texas",2652,375,211,115,2441,383
1400000US48141003903,48141003903,"Census Tract 39.03, El Paso County, Texas",6751,656,138,107,6613,650
1400000US48141004002,48141004002,"Census Tract 40.02, El Paso County, Texas",7768,571,150,86,7618,569
1400000US48141004003,48141004003,"Census Tract 40.03, El Paso County, Texas",8755,695,241,121,8514,703
1400000US48141004004,48141004004,"Census Tract 40.04, El Paso County, Texas",5152,437,123,83,5029,446
1400000US48141004103,48141004103,"Census Tract 41.03, El Paso County, Texas",6921,709,299,142,6622,714
1400000US48141004104,48141004104,"Census Tract 41.04, El Paso County, Texas",6080,672,228,98,5852,659
1400000US48141004105,48141004105,"Census Tract 41.05, El Paso County, Texas",3858,490,141,73,3717,500
1400000US48141004106,48141004106,"Census Tract 41.06, El Paso County, Texas",5662,556,369,151,5293,575
1400000US48141004107,48141004107,"Census Tract 41.07, El Paso County, Texas",1497,188,36,33,1461,198
1400000US48141004201,48141004201,"Census Tract 42.01, El Paso County, Texas",5648,575,370,152,5278,599
1400000US48141004202,48141004202,"Census Tract 42.02, El Paso County, Texas",6252,532,439,256,5813,539
1400000US48141004303,48141004303,"Census Tract 43.03, El Paso County, Texas",6187,527,1666,250,4521,582
1400000US48141004307,48141004307,"Census Tract 43.07, El Paso County, Texas",5389,529,1339,261,4050,507
1400000US48141004309,48141004309,"Census Tract 43.09, El Paso County, Texas",4922,398,722,189,4200,426
1400000US48141004310,48141004310,"Census Tract 43.10, El Paso County, Texas",5110,319,860,231,4250,387
1400000US48141004311,48141004311,"Census Tract 43.11, El Paso County, Texas",4457,398,1088,249,3369,368
1400000US48141004312,48141004312,"Census Tract 43.12, El Paso County, Texas",4938,436,1680,327,3258,459
1400000US48141004313,48141004313,"Census Tract 43.13, El Paso County, Texas",3634,431,880,173,2754,433
1400000US48141004314,48141004314,"Census Tract 43.14, El Paso County, Texas",6431,499,1087,395,5344,583
1400000US48141004316,48141004316,"Census Tract 43.16, El Paso County, Texas",6091,513,723,194,5368,499
1400000US48141004317,48141004317,"Census Tract 43.17, El Paso County, Texas",4526,522,2005,481,2521,530
1400000US48141004318,48141004318,"Census Tract 43.18, El Paso County, Texas",4239,400,869,234,3370,324
1400000US48141004319,48141004319,"Census Tract 43.19, El Paso County, Texas",5882,392,779,261,5103,480
1400000US48141004320,48141004320,"Census Tract 43.20, El Paso County, Texas",3505,490,247,182,3258,462
1400000US48141010101,48141010101,"Census Tract 101.01, El Paso County, Texas",1351,167,1193,197,158,169
1400000US48141010102,48141010102,"Census Tract 101.02, El Paso County, Texas",5870,1423,4466,1017,1404,547
1400000US48141010103,48141010103,"Census Tract 101.03, El Paso County, Texas",2370,376,1907,323,463,214
1400000US48141010203,48141010203,"Census Tract 102.03, El Paso County, Texas",4707,94,909,143,3798,159
1400000US48141010207,48141010207,"Census Tract 102.07, El Paso County, Texas",3958,424,1440,306,2518,359
1400000US48141010210,48141010210,"Census Tract 102.10, El Paso County, Texas",4938,509,2836,552,2102,439
1400000US48141010211,48141010211,"Census Tract 102.11, El Paso County, Texas",3070,208,1667,237,1403,246
1400000US48141010212,48141010212,"Census Tract 102.12, El Paso County, Texas",4868,519,2166,359,2702,434
1400000US48141010213,48141010213,"Census Tract 102.13, El Paso County, Texas",4808,431,2101,386,2707,308
1400000US48141010214,48141010214,"Census Tract 102.14, El Paso County, Texas",6184,457,3312,333,2872,414
1400000US48141010215,48141010215,"Census Tract 102.15, El Paso County, Texas",7041,481,1625,366,5416,519
1400000US48141010216,48141010216,"Census Tract 102.16, El Paso County, Texas",6429,885,728,250,5701,926
1400000US48141010217,48141010217,"Census Tract 102.17, El Paso County, Texas",4995,414,1529,455,3466,564
1400000US48141010218,48141010218,"Census Tract 102.18, El Paso County, Texas",2569,369,922,257,1647,409
1400000US48141010219,48141010219,"Census Tract 102.19, El Paso County, Texas",7033,419,2079,266,4954,475
1400000US48141010220,48141010220,"Census Tract 102.20, El Paso County, Texas",3856,510,147,81,3709,516
1400000US48141010221,48141010221,"Census Tract 102.21, El Paso County, Texas",7451,871,432,178,7019,884
1400000US48141010222,48141010222,"Census Tract 102.22, El Paso County, Texas",2318,400,623,188,1695,414
1400000US48141010303,48141010303,"Census Tract 103.03, El Paso County, Texas",3421,205,666,258,2755,335
1400000US48141010307,48141010307,"Census Tract 103.07, El Paso County, Texas",6634,530,1150,306,5484,596
1400000US48141010311,48141010311,"Census Tract 103.11, El Paso County, Texas",7376,469,1314,325,6062,532
1400000US48141010312,48141010312,"Census Tract 103.12, El Paso County, Texas",4205,312,863,189,3342,355
1400000US48141010316,48141010316,"Census Tract 103.16, El Paso County, Texas",4498,405,559,174,3939,422
1400000US48141010317,48141010317,"Census Tract 103.17, El Paso County, Texas",4468,476,780,229,3688,501
1400000US48141010319,48141010319,"Census Tract 103.19, El Paso County, Texas",697,129,278,191,419,210
1400000US48141010322,48141010322,"Census Tract 103.22, El Paso County, Texas",4705,525,589,192,4116,558
1400000US48141010323,48141010323,"Census Tract 103.23, El Paso County, Texas",4019,313,343,89,3676,330
1400000US48141010324,48141010324,"Census Tract 103.24, El Paso County, Texas",8718,660,757,300,7961,697
1400000US48141010325,48141010325,"Census Tract 103.25, El Paso County, Texas",8180,654,988,475,7192,574
1400000US48141010326,48141010326,"Census Tract 103.26, El Paso County, Texas",5104,372,1145,339,3959,474
1400000US48141010327,48141010327,"Census Tract 103.27, El Paso County, Texas",4183,387,509,161,3674,426
1400000US48141010328,48141010328,"Census Tract 103.28, El Paso County, Texas",4264,371,1257,358,3007,365
1400000US48141010329,48141010329,"Census Tract 103.29, El Paso County, Texas",4755,322,409,151,4346,344
1400000US48141010330,48141010330,"Census Tract 103.30, El Paso County, Texas",9792,695,1616,297,8176,667
1400000US48141010331,48141010331,"Census Tract 103.31, El Paso County, Texas",7969,589,1022,326,6947,594
1400000US48141010332,48141010332,"Census Tract 103.32, El Paso County, Texas",6847,533,735,432,6112,579
1400000US48141010333,48141010333,"Census Tract 103.33, El Paso County, Texas",4178,515,15,25,4163,517
1400000US48141010334,48141010334,"Census Tract 103.34, El Paso County, Texas",3846,707,93,106,3753,707
1400000US48141010335,48141010335,"Census Tract 103.35, El Paso County, Texas",3192,797,105,116,3087,806
1400000US48141010336,48141010336,"Census Tract 103.36, El Paso County, Texas",6912,781,391,194,6521,796
1400000US48141010337,48141010337,"Census Tract 103.37, El Paso County, Texas",7005,435,535,165,6470,461
1400000US48141010338,48141010338,"Census Tract 103.38, El Paso County, Texas",7855,475,1205,313,6650,492
1400000US48141010339,48141010339,"Census Tract 103.39, El Paso County, Texas",7414,1140,1520,477,5894,832
1400000US48141010340,48141010340,"Census Tract 103.40, El Paso County, Texas",2011,301,247,181,1764,329
1400000US48141010341,48141010341,"Census Tract 103.41, El Paso County, Texas",13562,1362,1384,250,12178,1337
1400000US48141010342,48141010342,"Census Tract 103.42, El Paso County, Texas",9373,883,1405,528,7968,964
1400000US48141010343,48141010343,"Census Tract 103.43, El Paso County, Texas",5093,387,1188,215,3905,373
1400000US48141010344,48141010344,"Census Tract 103.44, El Paso County, Texas",4563,669,36,50,4527,663
1400000US48141010345,48141010345,"Census Tract 103.45, El Paso County, Texas",4695,619,267,136,4428,619
1400000US48141010346,48141010346,"Census Tract 103.46, El Paso County, Texas",4787,498,135,64,4652,502
1400000US48141010347,48141010347,"Census Tract 103.47, El Paso County, Texas",2967,509,219,136,2748,518
1400000US48141010401,48141010401,"Census Tract 104.01, El Paso County, Texas",6072,478,140,99,5932,475
1400000US48141010404,48141010404,"Census Tract 104.04, El Paso County, Texas",4775,665,343,272,4432,528
1400000US48141010405,48141010405,"Census Tract 104.05, El Paso County, Texas",6017,579,192,202,5825,609
1400000US48141010406,48141010406,"Census Tract 104.06, El Paso County, Texas",4706,628,11,26,4695,624
1400000US48141010407,48141010407,"Census Tract 104.07, El Paso County, Texas",6416,798,0,127,6416,798
1400000US48141010408,48141010408,"Census Tract 104.08, El Paso County, Texas",3501,443,27,37,3474,441
1400000US48141010409,48141010409,"Census Tract 104.09, El Paso County, Texas",5803,531,113,116,5690,544
1400000US48141010501,48141010501,"Census Tract 105.01, El Paso County, Texas",4291,497,315,240,3976,522
1400000US48141010502,48141010502,"Census Tract 105.02, El Paso County, Texas",2021,497,258,224,1763,502
1400000US48141010504,48141010504,"Census Tract 105.04, El Paso County, Texas",1546,234,19,19,1527,237
1400000US48141010505,48141010505,"Census Tract 105.05, El Paso County, Texas",3544,460,47,46,3497,458
1400000US48141010506,48141010506,"Census Tract 105.06, El Paso County, Texas",3063,357,38,53,3025,377
1400000US48141010600,48141010600,"Census Tract 106, El Paso County, Texas",4232,543,3534,600,698,191
1400000US48141980000,48141980000,"Census Tract 9800, El Paso County, Texas",0,127,0,127,0,127
1400000US48143950100,48143950100,"Census Tract 9501, Erath County, Texas",2929,295,2625,268,304,196
1400000US48143950201,48143950201,"Census Tract 9502.01, Erath County, Texas",3625,491,2787,459,838,484
1400000US48143950202,48143950202,"Census Tract 9502.02, Erath County, Texas",6342,411,5611,422,731,209
1400000US48143950300,48143950300,"Census Tract 9503, Erath County, Texas",5569,409,3639,468,1930,425
1400000US48143950400,48143950400,"Census Tract 9504, Erath County, Texas",5540,529,4919,536,621,260
1400000US48143950500,48143950500,"Census Tract 9505, Erath County, Texas",7594,587,6104,590,1490,360
1400000US48143950600,48143950600,"Census Tract 9506, Erath County, Texas",3407,395,2843,334,564,322
1400000US48143950700,48143950700,"Census Tract 9507, Erath County, Texas",2136,288,1850,270,286,128
1400000US48145000200,48145000200,"Census Tract 2, Falls County, Texas",3053,318,2236,280,817,258
1400000US48145000300,48145000300,"Census Tract 3, Falls County, Texas",4337,373,3440,412,897,242
1400000US48145000400,48145000400,"Census Tract 4, Falls County, Texas",1514,374,1327,359,187,88
1400000US48145000500,48145000500,"Census Tract 5, Falls County, Texas",2644,301,2103,324,541,226
1400000US48145000700,48145000700,"Census Tract 7, Falls County, Texas",2581,309,2104,289,477,175
1400000US48145000800,48145000800,"Census Tract 8, Falls County, Texas",3670,462,3147,387,523,200
1400000US48147950100,48147950100,"Census Tract 9501, Fannin County, Texas",3001,361,2568,367,433,147
1400000US48147950300,48147950300,"Census Tract 9503, Fannin County, Texas",3094,325,2855,313,239,133
1400000US48147950401,48147950401,"Census Tract 9504.01, Fannin County, Texas",3892,439,3205,412,687,217
1400000US48147950402,48147950402,"Census Tract 9504.02, Fannin County, Texas",6672,477,6081,521,591,307
1400000US48147950500,48147950500,"Census Tract 9505, Fannin County, Texas",2608,246,2421,206,187,162
1400000US48147950600,48147950600,"Census Tract 9506, Fannin County, Texas",2310,349,2010,274,300,271
1400000US48147950701,48147950701,"Census Tract 9507.01, Fannin County, Texas",4777,471,4489,481,288,122
1400000US48147950702,48147950702,"Census Tract 9507.02, Fannin County, Texas",3275,350,2981,346,294,194
1400000US48147950800,48147950800,"Census Tract 9508, Fannin County, Texas",4136,442,4100,435,36,35
1400000US48149970100,48149970100,"Census Tract 9701, Fayette County, Texas",1732,246,1657,254,75,111
1400000US48149970200,48149970200,"Census Tract 9702, Fayette County, Texas",2510,439,2253,407,257,148
1400000US48149970300,48149970300,"Census Tract 9703, Fayette County, Texas",5925,292,4530,427,1395,326
1400000US48149970400,48149970400,"Census Tract 9704, Fayette County, Texas",3095,346,2863,323,232,174
1400000US48149970500,48149970500,"Census Tract 9705, Fayette County, Texas",3994,426,2720,329,1274,317
1400000US48149970600,48149970600,"Census Tract 9706, Fayette County, Texas",4798,271,3911,272,887,264
1400000US48149970700,48149970700,"Census Tract 9707, Fayette County, Texas",2121,247,2044,236,77,56
1400000US48151950300,48151950300,"Census Tract 9503, Fisher County, Texas",1830,204,1422,177,408,123
1400000US48151950400,48151950400,"Census Tract 9504, Fisher County, Texas",2227,190,1718,150,509,120
1400000US48153950500,48153950500,"Census Tract 9505, Floyd County, Texas",2522,218,1241,165,1281,238
1400000US48153950600,48153950600,"Census Tract 9506, Floyd County, Texas",4077,218,1998,165,2079,237
1400000US48155950100,48155950100,"Census Tract 9501, Foard County, Texas",1379,103,1082,121,297,83
1400000US48157670101,48157670101,"Census Tract 6701.01, Fort Bend County, Texas",6810,772,2645,471,4165,710
1400000US48157670102,48157670102,"Census Tract 6701.02, Fort Bend County, Texas",3446,531,2963,538,483,396
1400000US48157670200,48157670200,"Census Tract 6702, Fort Bend County, Texas",8315,690,5182,649,3133,496
1400000US48157670300,48157670300,"Census Tract 6703, Fort Bend County, Texas",3503,377,2852,361,651,217
1400000US48157670400,48157670400,"Census Tract 6704, Fort Bend County, Texas",4867,437,4287,454,580,152
1400000US48157670500,48157670500,"Census Tract 6705, Fort Bend County, Texas",4454,551,3012,525,1442,634
1400000US48157670601,48157670601,"Census Tract 6706.01, Fort Bend County, Texas",8629,645,7692,678,937,361
1400000US48157670602,48157670602,"Census Tract 6706.02, Fort Bend County, Texas",2199,398,1659,498,540,291
1400000US48157670700,48157670700,"Census Tract 6707, Fort Bend County, Texas",2644,336,2032,361,612,218
1400000US48157670800,48157670800,"Census Tract 6708, Fort Bend County, Texas",13275,856,9261,772,4014,587
1400000US48157670901,48157670901,"Census Tract 6709.01, Fort Bend County, Texas",9050,538,8164,647,886,369
1400000US48157670902,48157670902,"Census Tract 6709.02, Fort Bend County, Texas",3748,603,2923,608,825,536
1400000US48157671001,48157671001,"Census Tract 6710.01, Fort Bend County, Texas",5236,435,4797,431,439,222
1400000US48157671002,48157671002,"Census Tract 6710.02, Fort Bend County, Texas",6052,407,4824,434,1228,395
1400000US48157671100,48157671100,"Census Tract 6711, Fort Bend County, Texas",8170,883,4664,442,3506,850
1400000US48157671200,48157671200,"Census Tract 6712, Fort Bend County, Texas",5462,497,3934,413,1528,384
1400000US48157671300,48157671300,"Census Tract 6713, Fort Bend County, Texas",3616,403,2738,382,878,269
1400000US48157671400,48157671400,"Census Tract 6714, Fort Bend County, Texas",7758,606,6237,614,1521,375
1400000US48157671501,48157671501,"Census Tract 6715.01, Fort Bend County, Texas",7973,561,7279,590,694,208
1400000US48157671502,48157671502,"Census Tract 6715.02, Fort Bend County, Texas",2236,292,1924,335,312,202
1400000US48157671601,48157671601,"Census Tract 6716.01, Fort Bend County, Texas",6221,361,5303,480,918,446
1400000US48157671602,48157671602,"Census Tract 6716.02, Fort Bend County, Texas",3594,346,3553,351,41,42
1400000US48157671700,48157671700,"Census Tract 6717, Fort Bend County, Texas",5126,539,4681,591,445,204
1400000US48157671800,48157671800,"Census Tract 6718, Fort Bend County, Texas",2880,304,1869,367,1011,412
1400000US48157671900,48157671900,"Census Tract 6719, Fort Bend County, Texas",4418,146,3443,288,975,278
1400000US48157672001,48157672001,"Census Tract 6720.01, Fort Bend County, Texas",8297,677,6183,445,2114,696
1400000US48157672002,48157672002,"Census Tract 6720.02, Fort Bend County, Texas",6410,501,5364,612,1046,388
1400000US48157672100,48157672100,"Census Tract 6721, Fort Bend County, Texas",3961,374,3755,379,206,148
1400000US48157672200,48157672200,"Census Tract 6722, Fort Bend County, Texas",3347,258,2620,273,727,215
1400000US48157672301,48157672301,"Census Tract 6723.01, Fort Bend County, Texas",8107,613,6546,695,1561,330
1400000US48157672302,48157672302,"Census Tract 6723.02, Fort Bend County, Texas",9368,580,8212,550,1156,295
1400000US48157672400,48157672400,"Census Tract 6724, Fort Bend County, Texas",8395,619,5520,456,2875,705
1400000US48157672500,48157672500,"Census Tract 6725, Fort Bend County, Texas",7856,607,5185,440,2671,586
1400000US48157672601,48157672601,"Census Tract 6726.01, Fort Bend County, Texas",10452,861,5974,929,4478,610
1400000US48157672602,48157672602,"Census Tract 6726.02, Fort Bend County, Texas",7417,716,4219,924,3198,1016
1400000US48157672701,48157672701,"Census Tract 6727.01, Fort Bend County, Texas",13250,752,9321,700,3929,752
1400000US48157672702,48157672702,"Census Tract 6727.02, Fort Bend County, Texas",6641,711,5499,571,1142,408
1400000US48157672800,48157672800,"Census Tract 6728, Fort Bend County, Texas",7486,465,6722,456,764,215
1400000US48157672900,48157672900,"Census Tract 6729, Fort Bend County, Texas",22129,942,16122,834,6007,636
1400000US48157673001,48157673001,"Census Tract 6730.01, Fort Bend County, Texas",8763,516,7672,502,1091,285
1400000US48157673002,48157673002,"Census Tract 6730.02, Fort Bend County, Texas",7221,507,5865,582,1356,383
1400000US48157673003,48157673003,"Census Tract 6730.03, Fort Bend County, Texas",12285,485,10451,504,1834,406
1400000US48157673101,48157673101,"Census Tract 6731.01, Fort Bend County, Texas",25073,1021,20724,961,4349,759
1400000US48157673102,48157673102,"Census Tract 6731.02, Fort Bend County, Texas",12621,612,10718,649,1903,360
1400000US48157673200,48157673200,"Census Tract 6732, Fort Bend County, Texas",3740,436,3004,370,736,314
1400000US48157673300,48157673300,"Census Tract 6733, Fort Bend County, Texas",4065,282,3745,312,320,123
1400000US48157673400,48157673400,"Census Tract 6734, Fort Bend County, Texas",11334,544,9016,549,2318,415
1400000US48157673500,48157673500,"Census Tract 6735, Fort Bend County, Texas",8951,497,7575,446,1376,350
1400000US48157673600,48157673600,"Census Tract 6736, Fort Bend County, Texas",7365,582,6364,588,1001,330
1400000US48157673700,48157673700,"Census Tract 6737, Fort Bend County, Texas",2527,204,1978,180,549,116
1400000US48157673800,48157673800,"Census Tract 6738, Fort Bend County, Texas",9124,708,7321,622,1803,463
1400000US48157673901,48157673901,"Census Tract 6739.01, Fort Bend County, Texas",10017,544,8976,544,1041,286
1400000US48157673902,48157673902,"Census Tract 6739.02, Fort Bend County, Texas",3434,372,3207,367,227,149
1400000US48157674000,48157674000,"Census Tract 6740, Fort Bend County, Texas",7746,520,6923,511,823,279
1400000US48157674100,48157674100,"Census Tract 6741, Fort Bend County, Texas",7100,472,6293,410,807,332
1400000US48157674200,48157674200,"Census Tract 6742, Fort Bend County, Texas",5404,369,5193,400,211,117
1400000US48157674300,48157674300,"Census Tract 6743, Fort Bend County, Texas",8483,394,7823,463,660,284
1400000US48157674400,48157674400,"Census Tract 6744, Fort Bend County, Texas",8450,556,8134,509,316,196
1400000US48157674501,48157674501,"Census Tract 6745.01, Fort Bend County, Texas",4697,507,4262,497,435,213
1400000US48157674502,48157674502,"Census Tract 6745.02, Fort Bend County, Texas",15450,732,12545,488,2905,525
1400000US48157674601,48157674601,"Census Tract 6746.01, Fort Bend County, Texas",3603,305,3490,273,113,121
1400000US48157674602,48157674602,"Census Tract 6746.02, Fort Bend County, Texas",7691,415,6870,386,821,216
1400000US48157674603,48157674603,"Census Tract 6746.03, Fort Bend County, Texas",5933,375,3984,498,1949,475
1400000US48157674604,48157674604,"Census Tract 6746.04, Fort Bend County, Texas",4469,419,3435,445,1034,306
1400000US48157674700,48157674700,"Census Tract 6747, Fort Bend County, Texas",10012,605,7700,563,2312,436
1400000US48157674800,48157674800,"Census Tract 6748, Fort Bend County, Texas",6056,544,3157,592,2899,605
1400000US48157674900,48157674900,"Census Tract 6749, Fort Bend County, Texas",4881,520,1899,474,2982,491
1400000US48157675000,48157675000,"Census Tract 6750, Fort Bend County, Texas",3167,473,864,239,2303,486
1400000US48157675100,48157675100,"Census Tract 6751, Fort Bend County, Texas",9341,629,4511,520,4830,683
1400000US48157675200,48157675200,"Census Tract 6752, Fort Bend County, Texas",5885,493,1687,263,4198,555
1400000US48157675300,48157675300,"Census Tract 6753, Fort Bend County, Texas",6649,726,2164,422,4485,726
1400000US48157675400,48157675400,"Census Tract 6754, Fort Bend County, Texas",5112,565,2711,565,2401,324
1400000US48157675500,48157675500,"Census Tract 6755, Fort Bend County, Texas",8045,553,5008,462,3037,498
1400000US48157675600,48157675600,"Census Tract 6756, Fort Bend County, Texas",4832,506,3514,408,1318,359
1400000US48157675700,48157675700,"Census Tract 6757, Fort Bend County, Texas",6562,745,4426,521,2136,713
1400000US48157675800,48157675800,"Census Tract 6758, Fort Bend County, Texas",3097,344,2258,294,839,222
1400000US48159950100,48159950100,"Census Tract 9501, Franklin County, Texas",5095,415,4456,444,639,229
1400000US48159950200,48159950200,"Census Tract 9502, Franklin County, Texas",2742,256,2185,297,557,206
1400000US48159950300,48159950300,"Census Tract 9503, Franklin County, Texas",2838,407,2763,412,75,74
1400000US48161000100,48161000100,"Census Tract 1, Freestone County, Texas",4884,484,4680,448,204,134
1400000US48161000200,48161000200,"Census Tract 2, Freestone County, Texas",1446,222,1205,233,241,173
1400000US48161000300,48161000300,"Census Tract 3, Freestone County, Texas",1164,236,1088,241,76,104
1400000US48161000400,48161000400,"Census Tract 4, Freestone County, Texas",2737,421,2478,385,259,152
1400000US48161000600,48161000600,"Census Tract 6, Freestone County, Texas",4769,778,4115,550,654,356
1400000US48161000700,48161000700,"Census Tract 7, Freestone County, Texas",3128,189,2281,270,847,249
1400000US48161000900,48161000900,"Census Tract 9, Freestone County, Texas",1333,406,1252,391,81,91
1400000US48163950100,48163950100,"Census Tract 9501, Frio County, Texas",6184,593,1640,328,4544,601
1400000US48163950200,48163950200,"Census Tract 9502, Frio County, Texas",5362,580,334,154,5028,561
1400000US48163950300,48163950300,"Census Tract 9503, Frio County, Texas",5410,290,2075,305,3335,406
1400000US48165950100,48165950100,"Census Tract 9501, Gaines County, Texas",4383,447,1875,423,2508,414
1400000US48165950200,48165950200,"Census Tract 9502, Gaines County, Texas",6944,538,5719,529,1225,391
1400000US48165950300,48165950300,"Census Tract 9503, Gaines County, Texas",5331,339,3098,439,2233,328
1400000US48167720100,48167720100,"Census Tract 7201, Galveston County, Texas",5763,340,5011,308,752,181
1400000US48167720200,48167720200,"Census Tract 7202, Galveston County, Texas",4189,343,3824,321,365,254
1400000US48167720301,48167720301,"Census Tract 7203.01, Galveston County, Texas",2251,235,2029,244,222,148
1400000US48167720302,48167720302,"Census Tract 7203.02, Galveston County, Texas",7299,362,6309,383,990,283
1400000US48167720400,48167720400,"Census Tract 7204, Galveston County, Texas",5460,255,4909,297,551,201
1400000US48167720501,48167720501,"Census Tract 7205.01, Galveston County, Texas",4198,257,3710,327,488,188
1400000US48167720502,48167720502,"Census Tract 7205.02, Galveston County, Texas",9337,682,7732,621,1605,399
1400000US48167720503,48167720503,"Census Tract 7205.03, Galveston County, Texas",12788,804,10725,805,2063,582
1400000US48167720600,48167720600,"Census Tract 7206, Galveston County, Texas",10157,776,7905,776,2252,691
1400000US48167720700,48167720700,"Census Tract 7207, Galveston County, Texas",8422,717,6288,653,2134,587
1400000US48167720800,48167720800,"Census Tract 7208, Galveston County, Texas",3707,423,2720,355,987,305
1400000US48167720900,48167720900,"Census Tract 7209, Galveston County, Texas",5692,660,4107,559,1585,496
1400000US48167721000,48167721000,"Census Tract 7210, Galveston County, Texas",1928,311,1619,289,309,115
1400000US48167721100,48167721100,"Census Tract 7211, Galveston County, Texas",10926,921,6265,813,4661,730
1400000US48167721201,48167721201,"Census Tract 7212.01, Galveston County, Texas",14506,813,12198,759,2308,629
1400000US48167721202,48167721202,"Census Tract 7212.02, Galveston County, Texas",2907,362,2642,382,265,223
1400000US48167721300,48167721300,"Census Tract 7213, Galveston County, Texas",4679,371,3588,331,1091,344
1400000US48167721400,48167721400,"Census Tract 7214, Galveston County, Texas",7433,365,6793,418,640,215
1400000US48167721500,48167721500,"Census Tract 7215, Galveston County, Texas",7172,482,6404,497,768,295
1400000US48167721600,48167721600,"Census Tract 7216, Galveston County, Texas",1913,373,1211,300,702,332
1400000US48167721700,48167721700,"Census Tract 7217, Galveston County, Texas",6262,753,4603,717,1659,565
1400000US48167721800,48167721800,"Census Tract 7218, Galveston County, Texas",3790,519,2974,453,816,376
1400000US48167721900,48167721900,"Census Tract 7219, Galveston County, Texas",8657,885,6964,830,1693,350
1400000US48167722001,48167722001,"Census Tract 7220.01, Galveston County, Texas",5214,439,3876,453,1338,314
1400000US48167722002,48167722002,"Census Tract 7220.02, Galveston County, Texas",3852,454,2846,440,1006,457
1400000US48167722100,48167722100,"Census Tract 7221, Galveston County, Texas",6236,504,4866,440,1370,400
1400000US48167722200,48167722200,"Census Tract 7222, Galveston County, Texas",2799,346,1678,268,1121,304
1400000US48167722300,48167722300,"Census Tract 7223, Galveston County, Texas",8014,765,4213,626,3801,822
1400000US48167722600,48167722600,"Census Tract 7226, Galveston County, Texas",1704,222,1362,241,342,203
1400000US48167722700,48167722700,"Census Tract 7227, Galveston County, Texas",3984,463,3868,465,116,72
1400000US48167722800,48167722800,"Census Tract 7228, Galveston County, Texas",2341,334,1666,344,675,211
1400000US48167722900,48167722900,"Census Tract 7229, Galveston County, Texas",2928,339,2274,304,654,270
1400000US48167723000,48167723000,"Census Tract 7230, Galveston County, Texas",3064,421,2572,465,492,361
1400000US48167723100,48167723100,"Census Tract 7231, Galveston County, Texas",3200,399,2759,362,441,213
1400000US48167723200,48167723200,"Census Tract 7232, Galveston County, Texas",3462,524,2936,475,526,276
1400000US48167723300,48167723300,"Census Tract 7233, Galveston County, Texas",5422,457,4814,428,608,202
1400000US48167723400,48167723400,"Census Tract 7234, Galveston County, Texas",6042,628,5058,540,984,435
1400000US48167723501,48167723501,"Census Tract 7235.01, Galveston County, Texas",910,303,608,256,302,278
1400000US48167723502,48167723502,"Census Tract 7235.02, Galveston County, Texas",9970,681,8802,645,1168,530
1400000US48167723600,48167723600,"Census Tract 7236, Galveston County, Texas",3960,391,3208,364,752,233
1400000US48167723700,48167723700,"Census Tract 7237, Galveston County, Texas",2398,358,1979,351,419,246
1400000US48167723800,48167723800,"Census Tract 7238, Galveston County, Texas",4187,307,3852,301,335,110
1400000US48167723900,48167723900,"Census Tract 7239, Galveston County, Texas",2895,519,2606,440,289,199
1400000US48167724000,48167724000,"Census Tract 7240, Galveston County, Texas",2856,388,2280,307,576,181
1400000US48167724101,48167724101,"Census Tract 7241.01, Galveston County, Texas",1788,425,1470,335,318,283
1400000US48167724200,48167724200,"Census Tract 7242, Galveston County, Texas",2538,319,2307,295,231,139
1400000US48167724300,48167724300,"Census Tract 7243, Galveston County, Texas",3239,422,2296,370,943,296
1400000US48167724400,48167724400,"Census Tract 7244, Galveston County, Texas",2469,468,1724,378,745,289
1400000US48167724500,48167724500,"Census Tract 7245, Galveston County, Texas",676,192,493,136,183,179
1400000US48167724600,48167724600,"Census Tract 7246, Galveston County, Texas",1852,433,1515,405,337,200
1400000US48167724700,48167724700,"Census Tract 7247, Galveston County, Texas",2242,515,1373,277,869,537
1400000US48167724800,48167724800,"Census Tract 7248, Galveston County, Texas",2016,362,1147,269,869,325
1400000US48167724900,48167724900,"Census Tract 7249, Galveston County, Texas",1817,272,1385,255,432,178
1400000US48167725000,48167725000,"Census Tract 7250, Galveston County, Texas",2782,434,1657,350,1125,389
1400000US48167725100,48167725100,"Census Tract 7251, Galveston County, Texas",1699,402,1064,281,635,373
1400000US48167725200,48167725200,"Census Tract 7252, Galveston County, Texas",1727,368,636,175,1091,332
1400000US48167725300,48167725300,"Census Tract 7253, Galveston County, Texas",2055,296,1280,265,775,228
1400000US48167725400,48167725400,"Census Tract 7254, Galveston County, Texas",3998,510,1561,366,2437,429
1400000US48167725500,48167725500,"Census Tract 7255, Galveston County, Texas",960,180,790,140,170,109
1400000US48167725600,48167725600,"Census Tract 7256, Galveston County, Texas",3616,651,3168,620,448,231
1400000US48167725700,48167725700,"Census Tract 7257, Galveston County, Texas",2118,341,1781,334,337,203
1400000US48167725800,48167725800,"Census Tract 7258, Galveston County, Texas",3969,571,2036,345,1933,497
1400000US48167725900,48167725900,"Census Tract 7259, Galveston County, Texas",2302,388,1951,435,351,234
1400000US48167726000,48167726000,"Census Tract 7260, Galveston County, Texas",1473,253,1309,274,164,133
1400000US48167726100,48167726100,"Census Tract 7261, Galveston County, Texas",2593,426,2528,421,65,48
1400000US48167726200,48167726200,"Census Tract 7262, Galveston County, Texas",3523,656,2325,433,1198,665
1400000US48167990000,48167990000,"Census Tract 9900, Galveston County, Texas",0,127,0,127,0,127
1400000US48169950100,48169950100,"Census Tract 9501, Garza County, Texas",6204,,2741,374,3463,374
1400000US48171950100,48171950100,"Census Tract 9501, Gillespie County, Texas",3782,407,2858,390,924,302
1400000US48171950200,48171950200,"Census Tract 9502, Gillespie County, Texas",3720,346,3606,337,114,93
1400000US48171950300,48171950300,"Census Tract 9503, Gillespie County, Texas",7248,541,5665,411,1583,356
1400000US48171950400,48171950400,"Census Tract 9504, Gillespie County, Texas",5668,496,4481,449,1187,296
1400000US48171950500,48171950500,"Census Tract 9505, Gillespie County, Texas",3779,355,3004,289,775,245
1400000US48173950100,48173950100,"Census Tract 9501, Glasscock County, Texas",1317,157,941,125,376,101
1400000US48175960100,48175960100,"Census Tract 9601, Goliad County, Texas",4046,241,2769,234,1277,206
1400000US48175960200,48175960200,"Census Tract 9602, Goliad County, Texas",3115,241,2019,234,1096,206
1400000US48177000100,48177000100,"Census Tract 1, Gonzales County, Texas",2501,352,1478,255,1023,297
1400000US48177000200,48177000200,"Census Tract 2, Gonzales County, Texas",4632,466,3628,410,1004,273
1400000US48177000300,48177000300,"Census Tract 3, Gonzales County, Texas",3327,534,1538,337,1789,337
1400000US48177000400,48177000400,"Census Tract 4, Gonzales County, Texas",2451,601,1087,223,1364,460
1400000US48177000500,48177000500,"Census Tract 5, Gonzales County, Texas",3864,392,1363,214,2501,359
1400000US48177000600,48177000600,"Census Tract 6, Gonzales County, Texas",2860,414,1666,301,1194,418
1400000US48179950100,48179950100,"Census Tract 9501, Gray County, Texas",4757,255,4150,228,607,137
1400000US48179950300,48179950300,"Census Tract 9503, Gray County, Texas",4621,308,4276,318,345,163
1400000US48179950400,48179950400,"Census Tract 9504, Gray County, Texas",4858,525,4184,477,674,212
1400000US48179950500,48179950500,"Census Tract 9505, Gray County, Texas",2635,328,1839,282,796,308
1400000US48179950600,48179950600,"Census Tract 9506, Gray County, Texas",2263,252,1213,176,1050,226
1400000US48179950700,48179950700,"Census Tract 9507, Gray County, Texas",2039,387,1024,324,1015,254
1400000US48179950800,48179950800,"Census Tract 9508, Gray County, Texas",1324,233,962,199,362,180
1400000US48181000101,48181000101,"Census Tract 1.01, Grayson County, Texas",4769,306,4694,346,75,104
1400000US48181000102,48181000102,"Census Tract 1.02, Grayson County, Texas",2784,336,2540,404,244,231
1400000US48181000200,48181000200,"Census Tract 2, Grayson County, Texas",2265,270,2171,271,94,90
1400000US48181000302,48181000302,"Census Tract 3.02, Grayson County, Texas",4366,334,4291,337,75,50
1400000US48181000303,48181000303,"Census Tract 3.03, Grayson County, Texas",3883,451,3700,431,183,204
1400000US48181000304,48181000304,"Census Tract 3.04, Grayson County, Texas",3063,413,2948,400,115,113
1400000US48181000400,48181000400,"Census Tract 4, Grayson County, Texas",2717,346,2567,348,150,156
1400000US48181000501,48181000501,"Census Tract 5.01, Grayson County, Texas",3356,532,3138,480,218,199
1400000US48181000502,48181000502,"Census Tract 5.02, Grayson County, Texas",1481,308,991,232,490,280
1400000US48181000600,48181000600,"Census Tract 6, Grayson County, Texas",3459,446,3206,432,253,180
1400000US48181000700,48181000700,"Census Tract 7, Grayson County, Texas",4306,371,3907,347,399,224
1400000US48181000800,48181000800,"Census Tract 8, Grayson County, Texas",6052,536,5478,524,574,309
1400000US48181000901,48181000901,"Census Tract 9.01, Grayson County, Texas",4070,608,3970,590,100,84
1400000US48181000902,48181000902,"Census Tract 9.02, Grayson County, Texas",6531,684,6119,674,412,192
1400000US48181001101,48181001101,"Census Tract 11.01, Grayson County, Texas",3887,458,3466,415,421,254
1400000US48181001102,48181001102,"Census Tract 11.02, Grayson County, Texas",7083,471,6390,438,693,247
1400000US48181001200,48181001200,"Census Tract 12, Grayson County, Texas",6035,519,5531,498,504,297
1400000US48181001300,48181001300,"Census Tract 13, Grayson County, Texas",3806,512,3489,450,317,261
1400000US48181001400,48181001400,"Census Tract 14, Grayson County, Texas",5031,600,3701,580,1330,357
1400000US48181001500,48181001500,"Census Tract 15, Grayson County, Texas",6100,624,4356,557,1744,446
1400000US48181001700,48181001700,"Census Tract 17, Grayson County, Texas",4999,502,3959,470,1040,479
1400000US48181001801,48181001801,"Census Tract 18.01, Grayson County, Texas",5875,415,5469,434,406,195
1400000US48181001802,48181001802,"Census Tract 18.02, Grayson County, Texas",4347,412,4204,395,143,107
1400000US48181001803,48181001803,"Census Tract 18.03, Grayson County, Texas",5299,373,4727,442,572,279
1400000US48181001900,48181001900,"Census Tract 19, Grayson County, Texas",10341,673,9486,681,855,248
1400000US48181002000,48181002000,"Census Tract 20, Grayson County, Texas",3206,485,2128,511,1078,397
1400000US48183000200,48183000200,"Census Tract 2, Gregg County, Texas",5279,537,4376,401,903,448
1400000US48183000300,48183000300,"Census Tract 3, Gregg County, Texas",5005,448,4638,408,367,202
1400000US48183000401,48183000401,"Census Tract 4.01, Gregg County, Texas",2885,402,2333,402,552,286
1400000US48183000402,48183000402,"Census Tract 4.02, Gregg County, Texas",3983,526,3502,443,481,355
1400000US48183000501,48183000501,"Census Tract 5.01, Gregg County, Texas",5065,286,4990,289,75,60
1400000US48183000502,48183000502,"Census Tract 5.02, Gregg County, Texas",4161,378,3759,363,402,164
1400000US48183000600,48183000600,"Census Tract 6, Gregg County, Texas",7855,486,7619,519,236,140
1400000US48183000700,48183000700,"Census Tract 7, Gregg County, Texas",5482,394,4995,411,487,158
1400000US48183000800,48183000800,"Census Tract 8, Gregg County, Texas",7256,601,5394,568,1862,625
1400000US48183000900,48183000900,"Census Tract 9, Gregg County, Texas",2936,330,2063,334,873,220
1400000US48183001000,48183001000,"Census Tract 10, Gregg County, Texas",2554,388,2029,428,525,348
1400000US48183001100,48183001100,"Census Tract 11, Gregg County, Texas",2990,504,2517,426,473,225
1400000US48183001200,48183001200,"Census Tract 12, Gregg County, Texas",2852,392,1844,295,1008,272
1400000US48183001300,48183001300,"Census Tract 13, Gregg County, Texas",4809,590,2925,487,1884,416
1400000US48183001400,48183001400,"Census Tract 14, Gregg County, Texas",3951,489,3012,457,939,250
1400000US48183001500,48183001500,"Census Tract 15, Gregg County, Texas",4885,661,3989,632,896,328
1400000US48183010100,48183010100,"Census Tract 101, Gregg County, Texas",6156,584,5734,532,422,254
1400000US48183010200,48183010200,"Census Tract 102, Gregg County, Texas",7094,427,6778,451,316,115
1400000US48183010301,48183010301,"Census Tract 103.01, Gregg County, Texas",5202,449,4745,488,457,277
1400000US48183010302,48183010302,"Census Tract 103.02, Gregg County, Texas",6166,564,4916,335,1250,562
1400000US48183010400,48183010400,"Census Tract 104, Gregg County, Texas",7255,575,6417,607,838,313
1400000US48183010500,48183010500,"Census Tract 105, Gregg County, Texas",5366,548,4598,496,768,336
1400000US48183010600,48183010600,"Census Tract 106, Gregg County, Texas",5582,505,5266,518,316,172
1400000US48183010700,48183010700,"Census Tract 107, Gregg County, Texas",4756,578,3158,572,1598,355
1400000US48183980000,48183980000,"Census Tract 9800, Gregg County, Texas",0,127,0,127,0,127
1400000US48185180101,48185180101,"Census Tract 1801.01, Grimes County, Texas",5195,619,3334,488,1861,351
1400000US48185180102,48185180102,"Census Tract 1801.02, Grimes County, Texas",3839,474,2852,492,987,363
1400000US48185180200,48185180200,"Census Tract 1802, Grimes County, Texas",5988,590,4553,481,1435,354
1400000US48185180301,48185180301,"Census Tract 1803.01, Grimes County, Texas",4958,483,4709,487,249,153
1400000US48185180302,48185180302,"Census Tract 1803.02, Grimes County, Texas",4511,472,4166,472,345,170
1400000US48185180400,48185180400,"Census Tract 1804, Grimes County, Texas",1717,216,1315,208,402,82
1400000US48187210100,48187210100,"Census Tract 2101, Guadalupe County, Texas",4178,432,1561,207,2617,369
1400000US48187210200,48187210200,"Census Tract 2102, Guadalupe County, Texas",4344,449,1020,210,3324,427
1400000US48187210300,48187210300,"Census Tract 2103, Guadalupe County, Texas",6391,877,2499,557,3892,766
1400000US48187210400,48187210400,"Census Tract 2104, Guadalupe County, Texas",3855,324,2602,333,1253,225
1400000US48187210504,48187210504,"Census Tract 2105.04, Guadalupe County, Texas",5231,405,3385,374,1846,322
1400000US48187210505,48187210505,"Census Tract 2105.05, Guadalupe County, Texas",4247,609,1189,424,3058,763
1400000US48187210506,48187210506,"Census Tract 2105.06, Guadalupe County, Texas",3130,388,2151,358,979,448
1400000US48187210507,48187210507,"Census Tract 2105.07, Guadalupe County, Texas",4439,366,2825,449,1614,506
1400000US48187210508,48187210508,"Census Tract 2105.08, Guadalupe County, Texas",2019,321,1182,281,837,310
1400000US48187210603,48187210603,"Census Tract 2106.03, Guadalupe County, Texas",2046,236,1253,195,793,218
1400000US48187210604,48187210604,"Census Tract 2106.04, Guadalupe County, Texas",6761,527,4669,551,2092,637
1400000US48187210606,48187210606,"Census Tract 2106.06, Guadalupe County, Texas",3079,414,2075,314,1004,350
1400000US48187210607,48187210607,"Census Tract 2106.07, Guadalupe County, Texas",7088,332,4965,422,2123,374
1400000US48187210608,48187210608,"Census Tract 2106.08, Guadalupe County, Texas",3799,430,1727,333,2072,435
1400000US48187210705,48187210705,"Census Tract 2107.05, Guadalupe County, Texas",2577,231,1989,196,588,228
1400000US48187210706,48187210706,"Census Tract 2107.06, Guadalupe County, Texas",4826,360,3243,446,1583,361
1400000US48187210707,48187210707,"Census Tract 2107.07, Guadalupe County, Texas",3306,212,2472,244,834,241
1400000US48187210708,48187210708,"Census Tract 2107.08, Guadalupe County, Texas",5756,440,4576,393,1180,242
1400000US48187210709,48187210709,"Census Tract 2107.09, Guadalupe County, Texas",4836,355,3532,392,1304,324
1400000US48187210710,48187210710,"Census Tract 2107.10, Guadalupe County, Texas",3461,339,3105,314,356,153
1400000US48187210711,48187210711,"Census Tract 2107.11, Guadalupe County, Texas",3345,290,2687,326,658,258
1400000US48187210712,48187210712,"Census Tract 2107.12, Guadalupe County, Texas",4214,245,3553,254,661,181
1400000US48187210713,48187210713,"Census Tract 2107.13, Guadalupe County, Texas",3512,359,2485,352,1027,221
1400000US48187210714,48187210714,"Census Tract 2107.14, Guadalupe County, Texas",4714,458,3187,431,1527,343
1400000US48187210801,48187210801,"Census Tract 2108.01, Guadalupe County, Texas",5345,455,3184,436,2161,461
1400000US48187210803,48187210803,"Census Tract 2108.03, Guadalupe County, Texas",3590,395,2852,320,738,296
1400000US48187210804,48187210804,"Census Tract 2108.04, Guadalupe County, Texas",3971,397,3012,441,959,331
1400000US48187210901,48187210901,"Census Tract 2109.01, Guadalupe County, Texas",5242,463,3930,415,1312,434
1400000US48187210902,48187210902,"Census Tract 2109.02, Guadalupe County, Texas",3426,307,2531,239,895,306
1400000US48189950100,48189950100,"Census Tract 9501, Hale County, Texas",4676,669,978,241,3698,624
1400000US48189950200,48189950200,"Census Tract 9502, Hale County, Texas",4432,498,604,207,3828,494
1400000US48189950300,48189950300,"Census Tract 9503, Hale County, Texas",6545,501,4077,345,2468,445
1400000US48189950400,48189950400,"Census Tract 9504, Hale County, Texas",4437,517,2426,388,2011,425
1400000US48189950500,48189950500,"Census Tract 9505, Hale County, Texas",3406,448,1237,247,2169,396
1400000US48189950600,48189950600,"Census Tract 9506, Hale County, Texas",5897,905,4114,658,1783,381
1400000US48189950700,48189950700,"Census Tract 9507, Hale County, Texas",2917,417,1122,213,1795,341
1400000US48189950800,48189950800,"Census Tract 9508, Hale County, Texas",1205,214,426,96,779,215
1400000US48189950900,48189950900,"Census Tract 9509, Hale County, Texas",2526,432,1511,296,1015,299
1400000US48191950500,48191950500,"Census Tract 9505, Hall County, Texas",3424,,2391,,1033,
1400000US48193950100,48193950100,"Census Tract 9501, Hamilton County, Texas",2470,269,2070,235,400,143
1400000US48193950200,48193950200,"Census Tract 9502, Hamilton County, Texas",2186,287,2117,280,69,54
1400000US48193950300,48193950300,"Census Tract 9503, Hamilton County, Texas",3817,270,3497,259,320,133
1400000US48195950100,48195950100,"Census Tract 9501, Hansford County, Texas",1872,191,1377,153,495,153
1400000US48195950300,48195950300,"Census Tract 9503, Hansford County, Texas",3598,191,1865,152,1733,152
1400000US48197950100,48197950100,"Census Tract 9501, Hardeman County, Texas",4226,,3516,207,710,207
1400000US48199030100,48199030100,"Census Tract 301, Hardin County, Texas",3638,445,3626,444,12,18
1400000US48199030200,48199030200,"Census Tract 302, Hardin County, Texas",5417,403,5207,431,210,131
1400000US48199030300,48199030300,"Census Tract 303, Hardin County, Texas",9319,598,9218,596,101,98
1400000US48199030400,48199030400,"Census Tract 304, Hardin County, Texas",2534,281,2310,292,224,106
1400000US48199030501,48199030501,"Census Tract 305.01, Hardin County, Texas",4203,414,4132,398,71,67
1400000US48199030502,48199030502,"Census Tract 305.02, Hardin County, Texas",8015,436,7675,402,340,191
1400000US48199030600,48199030600,"Census Tract 306, Hardin County, Texas",3294,355,3053,350,241,127
1400000US48199030700,48199030700,"Census Tract 307, Hardin County, Texas",3442,408,3249,412,193,136
1400000US48199030800,48199030800,"Census Tract 308, Hardin County, Texas",4636,387,4285,349,351,201
1400000US48199030900,48199030900,"Census Tract 309, Hardin County, Texas",4543,479,4203,489,340,191
1400000US48199031000,48199031000,"Census Tract 310, Hardin County, Texas",4179,380,4027,422,152,125
1400000US48201100000,48201100000,"Census Tract 1000, Harris County, Texas",3853,674,3130,634,723,178
1400000US48201210100,48201210100,"Census Tract 2101, Harris County, Texas",6696,309,4522,274,2174,240
1400000US48201210400,48201210400,"Census Tract 2104, Harris County, Texas",4926,463,457,203,4469,463
1400000US48201210500,48201210500,"Census Tract 2105, Harris County, Texas",5009,594,935,302,4074,617
1400000US48201210600,48201210600,"Census Tract 2106, Harris County, Texas",5667,603,1076,253,4591,682
1400000US48201210700,48201210700,"Census Tract 2107, Harris County, Texas",2008,295,631,225,1377,282
1400000US48201210800,48201210800,"Census Tract 2108, Harris County, Texas",2276,523,809,270,1467,471
1400000US48201210900,48201210900,"Census Tract 2109, Harris County, Texas",1844,235,1400,327,444,193
1400000US48201211000,48201211000,"Census Tract 2110, Harris County, Texas",1479,306,1246,323,233,190
1400000US48201211100,48201211100,"Census Tract 2111, Harris County, Texas",6991,963,3743,824,3248,715
1400000US48201211200,48201211200,"Census Tract 2112, Harris County, Texas",2617,351,1938,394,679,165
1400000US48201211300,48201211300,"Census Tract 2113, Harris County, Texas",5280,896,4424,853,856,260
1400000US48201211400,48201211400,"Census Tract 2114, Harris County, Texas",4234,619,2924,550,1310,380
1400000US48201211500,48201211500,"Census Tract 2115, Harris County, Texas",7144,910,789,582,6355,804
1400000US48201211600,48201211600,"Census Tract 2116, Harris County, Texas",3173,386,724,230,2449,392
1400000US48201211700,48201211700,"Census Tract 2117, Harris County, Texas",3318,400,2737,374,581,250
1400000US48201211900,48201211900,"Census Tract 2119, Harris County, Texas",5143,484,199,113,4944,460
1400000US48201212300,48201212300,"Census Tract 2123, Harris County, Texas",5028,700,301,132,4727,706
1400000US48201212400,48201212400,"Census Tract 2124, Harris County, Texas",3633,617,377,173,3256,647
1400000US48201212500,48201212500,"Census Tract 2125, Harris County, Texas",4121,407,3212,339,909,292
1400000US48201220100,48201220100,"Census Tract 2201, Harris County, Texas",2541,430,922,186,1619,388
1400000US48201220200,48201220200,"Census Tract 2202, Harris County, Texas",2603,464,153,74,2450,473
1400000US48201220300,48201220300,"Census Tract 2203, Harris County, Texas",4651,620,638,243,4013,599
1400000US48201220400,48201220400,"Census Tract 2204, Harris County, Texas",4640,727,276,136,4364,727
1400000US48201220500,48201220500,"Census Tract 2205, Harris County, Texas",4842,739,1220,229,3622,794
1400000US48201220600,48201220600,"Census Tract 2206, Harris County, Texas",3630,624,354,243,3276,627
1400000US48201220700,48201220700,"Census Tract 2207, Harris County, Texas",5956,879,1645,373,4311,856
1400000US48201220800,48201220800,"Census Tract 2208, Harris County, Texas",2835,391,1545,407,1290,542
1400000US48201220900,48201220900,"Census Tract 2209, Harris County, Texas",1760,297,233,132,1527,275
1400000US48201221000,48201221000,"Census Tract 2210, Harris County, Texas",3504,613,1216,347,2288,609
1400000US48201221100,48201221100,"Census Tract 2211, Harris County, Texas",3766,563,541,207,3225,565
1400000US48201221200,48201221200,"Census Tract 2212, Harris County, Texas",5922,709,1050,330,4872,689
1400000US48201221300,48201221300,"Census Tract 2213, Harris County, Texas",8777,969,992,585,7785,897
1400000US48201221400,48201221400,"Census Tract 2214, Harris County, Texas",6526,792,702,267,5824,844
1400000US48201221500,48201221500,"Census Tract 2215, Harris County, Texas",7864,845,2141,708,5723,636
1400000US48201221600,48201221600,"Census Tract 2216, Harris County, Texas",9237,801,1638,334,7599,722
1400000US48201221700,48201221700,"Census Tract 2217, Harris County, Texas",7551,938,1337,300,6214,916
1400000US48201221800,48201221800,"Census Tract 2218, Harris County, Texas",3374,497,275,134,3099,510
1400000US48201221900,48201221900,"Census Tract 2219, Harris County, Texas",4124,777,357,180,3767,807
1400000US48201222000,48201222000,"Census Tract 2220, Harris County, Texas",2228,600,527,417,1701,374
1400000US48201222100,48201222100,"Census Tract 2221, Harris County, Texas",5358,476,762,292,4596,515
1400000US48201222200,48201222200,"Census Tract 2222, Harris County, Texas",3835,576,726,204,3109,614
1400000US48201222300,48201222300,"Census Tract 2223, Harris County, Texas",3602,363,898,302,2704,382
1400000US48201222401,48201222401,"Census Tract 2224.01, Harris County, Texas",2875,549,912,433,1963,510
1400000US48201222402,48201222402,"Census Tract 2224.02, Harris County, Texas",5686,510,1058,240,4628,548
1400000US48201222501,48201222501,"Census Tract 2225.01, Harris County, Texas",3507,694,431,93,3076,682
1400000US48201222502,48201222502,"Census Tract 2225.02, Harris County, Texas",3595,683,533,200,3062,632
1400000US48201222503,48201222503,"Census Tract 2225.03, Harris County, Texas",7454,920,892,459,6562,971
1400000US48201222600,48201222600,"Census Tract 2226, Harris County, Texas",5322,503,816,198,4506,556
1400000US48201222700,48201222700,"Census Tract 2227, Harris County, Texas",5263,533,4137,504,1126,303
1400000US48201222800,48201222800,"Census Tract 2228, Harris County, Texas",3804,695,745,201,3059,667
1400000US48201222900,48201222900,"Census Tract 2229, Harris County, Texas",7476,699,1564,306,5912,683
1400000US48201223001,48201223001,"Census Tract 2230.01, Harris County, Texas",2837,461,636,195,2201,480
1400000US48201223002,48201223002,"Census Tract 2230.02, Harris County, Texas",4252,516,705,231,3547,575
1400000US48201223100,48201223100,"Census Tract 2231, Harris County, Texas",2366,297,591,317,1775,412
1400000US48201230100,48201230100,"Census Tract 2301, Harris County, Texas",1782,467,1374,347,408,289
1400000US48201230200,48201230200,"Census Tract 2302, Harris County, Texas",5590,698,5076,690,514,326
1400000US48201230300,48201230300,"Census Tract 2303, Harris County, Texas",2679,710,2246,609,433,285
1400000US48201230400,48201230400,"Census Tract 2304, Harris County, Texas",3491,476,1957,389,1534,372
1400000US48201230500,48201230500,"Census Tract 2305, Harris County, Texas",4400,644,912,257,3488,700
1400000US48201230600,48201230600,"Census Tract 2306, Harris County, Texas",2411,354,1668,439,743,431
1400000US48201230700,48201230700,"Census Tract 2307, Harris County, Texas",2790,581,2443,528,347,320
1400000US48201230800,48201230800,"Census Tract 2308, Harris County, Texas",2434,376,1801,309,633,200
1400000US48201230900,48201230900,"Census Tract 2309, Harris County, Texas",3815,456,3193,410,622,368
1400000US48201231000,48201231000,"Census Tract 2310, Harris County, Texas",4217,636,2799,530,1418,360
1400000US48201231100,48201231100,"Census Tract 2311, Harris County, Texas",4696,706,1953,543,2743,691
1400000US48201231200,48201231200,"Census Tract 2312, Harris County, Texas",7055,739,5341,697,1714,398
1400000US48201231300,48201231300,"Census Tract 2313, Harris County, Texas",4370,495,3902,464,468,242
1400000US48201231400,48201231400,"Census Tract 2314, Harris County, Texas",2236,334,2213,324,23,25
1400000US48201231500,48201231500,"Census Tract 2315, Harris County, Texas",2747,312,2466,302,281,175
1400000US48201231600,48201231600,"Census Tract 2316, Harris County, Texas",2732,559,2421,511,311,271
1400000US48201231700,48201231700,"Census Tract 2317, Harris County, Texas",3270,581,365,151,2905,600
1400000US48201231800,48201231800,"Census Tract 2318, Harris County, Texas",2557,543,1757,683,800,339
1400000US48201231900,48201231900,"Census Tract 2319, Harris County, Texas",6833,1025,5060,642,1773,821
1400000US48201232000,48201232000,"Census Tract 2320, Harris County, Texas",4248,417,1883,239,2365,455
1400000US48201232100,48201232100,"Census Tract 2321, Harris County, Texas",3593,1364,1772,1270,1821,467
1400000US48201232200,48201232200,"Census Tract 2322, Harris County, Texas",8771,937,5003,644,3768,906
1400000US48201232301,48201232301,"Census Tract 2323.01, Harris County, Texas",8978,922,3804,544,5174,888
1400000US48201232302,48201232302,"Census Tract 2323.02, Harris County, Texas",8699,718,4687,589,4012,540
1400000US48201232401,48201232401,"Census Tract 2324.01, Harris County, Texas",7153,792,3431,540,3722,666
1400000US48201232402,48201232402,"Census Tract 2324.02, Harris County, Texas",4015,502,1886,406,2129,495
1400000US48201232403,48201232403,"Census Tract 2324.03, Harris County, Texas",4860,573,2280,471,2580,581
1400000US48201232500,48201232500,"Census Tract 2325, Harris County, Texas",2941,763,651,179,2290,738
1400000US48201232600,48201232600,"Census Tract 2326, Harris County, Texas",3159,329,623,139,2536,373
1400000US48201232701,48201232701,"Census Tract 2327.01, Harris County, Texas",7521,842,2255,492,5266,843
1400000US48201232702,48201232702,"Census Tract 2327.02, Harris County, Texas",5332,962,1468,451,3864,937
1400000US48201232800,48201232800,"Census Tract 2328, Harris County, Texas",4768,503,2630,544,2138,394
1400000US48201232900,48201232900,"Census Tract 2329, Harris County, Texas",7096,754,4932,681,2164,570
1400000US48201233001,48201233001,"Census Tract 2330.01, Harris County, Texas",3074,735,2159,649,915,462
1400000US48201233002,48201233002,"Census Tract 2330.02, Harris County, Texas",3925,333,2195,380,1730,403
1400000US48201233003,48201233003,"Census Tract 2330.03, Harris County, Texas",2345,239,1477,251,868,288
1400000US48201233101,48201233101,"Census Tract 2331.01, Harris County, Texas",3978,452,1068,219,2910,487
1400000US48201233102,48201233102,"Census Tract 2331.02, Harris County, Texas",7156,554,738,239,6418,612
1400000US48201233103,48201233103,"Census Tract 2331.03, Harris County, Texas",4352,474,947,280,3405,560
1400000US48201233200,48201233200,"Census Tract 2332, Harris County, Texas",6269,534,1741,223,4528,488
1400000US48201233300,48201233300,"Census Tract 2333, Harris County, Texas",5051,489,749,201,4302,535
1400000US48201233400,48201233400,"Census Tract 2334, Harris County, Texas",2744,298,535,224,2209,341
1400000US48201233500,48201233500,"Census Tract 2335, Harris County, Texas",7752,302,1090,281,6662,386
1400000US48201233600,48201233600,"Census Tract 2336, Harris County, Texas",1699,259,1631,253,68,78
1400000US48201233701,48201233701,"Census Tract 2337.01, Harris County, Texas",5474,488,1795,445,3679,541
1400000US48201233702,48201233702,"Census Tract 2337.02, Harris County, Texas",2862,470,393,274,2469,568
1400000US48201233703,48201233703,"Census Tract 2337.03, Harris County, Texas",2460,278,469,207,1991,325
1400000US48201240100,48201240100,"Census Tract 2401, Harris County, Texas",3441,530,1697,371,1744,544
1400000US48201240400,48201240400,"Census Tract 2404, Harris County, Texas",6994,733,3554,529,3440,835
1400000US48201240501,48201240501,"Census Tract 2405.01, Harris County, Texas",4867,502,2341,448,2526,481
1400000US48201240502,48201240502,"Census Tract 2405.02, Harris County, Texas",6041,778,3148,587,2893,674
1400000US48201240600,48201240600,"Census Tract 2406, Harris County, Texas",2805,479,939,301,1866,484
1400000US48201240701,48201240701,"Census Tract 2407.01, Harris County, Texas",12628,913,5884,917,6744,861
1400000US48201240702,48201240702,"Census Tract 2407.02, Harris County, Texas",7893,793,4031,589,3862,635
1400000US48201240801,48201240801,"Census Tract 2408.01, Harris County, Texas",5940,742,3222,475,2718,797
1400000US48201240802,48201240802,"Census Tract 2408.02, Harris County, Texas",3304,586,1727,399,1577,575
1400000US48201240901,48201240901,"Census Tract 2409.01, Harris County, Texas",6036,509,3622,441,2414,497
1400000US48201240902,48201240902,"Census Tract 2409.02, Harris County, Texas",10640,808,6801,782,3839,520
1400000US48201241000,48201241000,"Census Tract 2410, Harris County, Texas",8505,639,5833,496,2672,493
1400000US48201241101,48201241101,"Census Tract 2411.01, Harris County, Texas",4423,526,3156,481,1267,443
1400000US48201241102,48201241102,"Census Tract 2411.02, Harris County, Texas",11452,690,8092,714,3360,538
1400000US48201241103,48201241103,"Census Tract 2411.03, Harris County, Texas",3685,502,2601,463,1084,359
1400000US48201241200,48201241200,"Census Tract 2412, Harris County, Texas",6507,705,4977,627,1530,288
1400000US48201241300,48201241300,"Census Tract 2413, Harris County, Texas",10082,747,8567,754,1515,455
1400000US48201241400,48201241400,"Census Tract 2414, Harris County, Texas",8494,565,6944,664,1550,411
1400000US48201241500,48201241500,"Census Tract 2415, Harris County, Texas",9325,1383,5612,752,3713,937
1400000US48201250100,48201250100,"Census Tract 2501, Harris County, Texas",7316,770,4018,507,3298,688
1400000US48201250200,48201250200,"Census Tract 2502, Harris County, Texas",7488,723,3506,619,3982,715
1400000US48201250301,48201250301,"Census Tract 2503.01, Harris County, Texas",6714,644,4560,576,2154,351
1400000US48201250302,48201250302,"Census Tract 2503.02, Harris County, Texas",8905,659,4873,605,4032,857
1400000US48201250401,48201250401,"Census Tract 2504.01, Harris County, Texas",11450,563,8878,499,2572,516
1400000US48201250402,48201250402,"Census Tract 2504.02, Harris County, Texas",11782,570,9888,711,1894,448
1400000US48201250500,48201250500,"Census Tract 2505, Harris County, Texas",5313,398,4192,374,1121,303
1400000US48201250600,48201250600,"Census Tract 2506, Harris County, Texas",7342,769,4962,768,2380,735
1400000US48201250701,48201250701,"Census Tract 2507.01, Harris County, Texas",5685,416,4284,340,1401,370
1400000US48201250702,48201250702,"Census Tract 2507.02, Harris County, Texas",4655,206,3676,362,979,356
1400000US48201250800,48201250800,"Census Tract 2508, Harris County, Texas",8145,380,7291,364,854,215
1400000US48201250900,48201250900,"Census Tract 2509, Harris County, Texas",8713,457,8397,478,316,195
1400000US48201251000,48201251000,"Census Tract 2510, Harris County, Texas",2462,360,2238,336,224,159
1400000US48201251100,48201251100,"Census Tract 2511, Harris County, Texas",7756,667,6372,629,1384,482
1400000US48201251200,48201251200,"Census Tract 2512, Harris County, Texas",5932,503,5179,434,753,216
1400000US48201251300,48201251300,"Census Tract 2513, Harris County, Texas",7443,353,6782,277,661,337
1400000US48201251401,48201251401,"Census Tract 2514.01, Harris County, Texas",2486,234,2272,223,214,72
1400000US48201251402,48201251402,"Census Tract 2514.02, Harris County, Texas",5968,473,5053,509,915,402
1400000US48201251501,48201251501,"Census Tract 2515.01, Harris County, Texas",5055,400,4444,427,611,220
1400000US48201251502,48201251502,"Census Tract 2515.02, Harris County, Texas",10276,475,9528,469,748,430
1400000US48201251503,48201251503,"Census Tract 2515.03, Harris County, Texas",2229,155,1995,249,234,235
1400000US48201251600,48201251600,"Census Tract 2516, Harris County, Texas",5217,363,4620,340,597,176
1400000US48201251700,48201251700,"Census Tract 2517, Harris County, Texas",8145,636,7069,693,1076,381
1400000US48201251800,48201251800,"Census Tract 2518, Harris County, Texas",1672,231,1324,244,348,207
1400000US48201251901,48201251901,"Census Tract 2519.01, Harris County, Texas",8571,730,7653,797,918,306
1400000US48201251902,48201251902,"Census Tract 2519.02, Harris County, Texas",4489,430,3832,421,657,323
1400000US48201252000,48201252000,"Census Tract 2520, Harris County, Texas",8800,668,6596,623,2204,466
1400000US48201252100,48201252100,"Census Tract 2521, Harris County, Texas",1551,194,877,170,674,181
1400000US48201252200,48201252200,"Census Tract 2522, Harris County, Texas",6127,541,2210,447,3917,566
1400000US48201252301,48201252301,"Census Tract 2523.01, Harris County, Texas",8382,619,3486,694,4896,641
1400000US48201252302,48201252302,"Census Tract 2523.02, Harris County, Texas",10706,627,4945,554,5761,737
1400000US48201252400,48201252400,"Census Tract 2524, Harris County, Texas",7652,913,4246,733,3406,889
1400000US48201252500,48201252500,"Census Tract 2525, Harris County, Texas",4416,630,1873,389,2543,610
1400000US48201252600,48201252600,"Census Tract 2526, Harris County, Texas",7770,760,2862,374,4908,751
1400000US48201252700,48201252700,"Census Tract 2527, Harris County, Texas",4108,388,3306,368,802,292
1400000US48201252800,48201252800,"Census Tract 2528, Harris County, Texas",4562,685,3965,652,597,381
1400000US48201252900,48201252900,"Census Tract 2529, Harris County, Texas",8233,985,6125,844,2108,639
1400000US48201253000,48201253000,"Census Tract 2530, Harris County, Texas",3166,324,2522,365,644,200
1400000US48201253100,48201253100,"Census Tract 2531, Harris County, Texas",6926,457,4665,331,2261,403
1400000US48201253200,48201253200,"Census Tract 2532, Harris County, Texas",8535,584,6336,473,2199,446
1400000US48201253300,48201253300,"Census Tract 2533, Harris County, Texas",3618,324,2610,223,1008,315
1400000US48201253400,48201253400,"Census Tract 2534, Harris County, Texas",1085,353,905,319,180,142
1400000US48201253500,48201253500,"Census Tract 2535, Harris County, Texas",8644,680,5459,487,3185,552
1400000US48201253600,48201253600,"Census Tract 2536, Harris County, Texas",5546,563,4098,577,1448,309
1400000US48201253700,48201253700,"Census Tract 2537, Harris County, Texas",5177,582,3303,389,1874,503
1400000US48201253800,48201253800,"Census Tract 2538, Harris County, Texas",7144,677,4476,612,2668,478
1400000US48201253900,48201253900,"Census Tract 2539, Harris County, Texas",3817,400,2547,373,1270,376
1400000US48201254000,48201254000,"Census Tract 2540, Harris County, Texas",3865,642,2639,512,1226,488
1400000US48201254100,48201254100,"Census Tract 2541, Harris County, Texas",4877,605,2852,512,2025,538
1400000US48201254200,48201254200,"Census Tract 2542, Harris County, Texas",3015,303,1066,128,1949,295
1400000US48201254300,48201254300,"Census Tract 2543, Harris County, Texas",4990,594,2795,634,2195,520
1400000US48201254400,48201254400,"Census Tract 2544, Harris County, Texas",3455,532,783,222,2672,634
1400000US48201254500,48201254500,"Census Tract 2545, Harris County, Texas",2253,493,634,250,1619,448
1400000US48201254600,48201254600,"Census Tract 2546, Harris County, Texas",3814,412,1022,234,2792,378
1400000US48201254700,48201254700,"Census Tract 2547, Harris County, Texas",2473,362,1843,263,630,310
1400000US48201310100,48201310100,"Census Tract 3101, Harris County, Texas",4891,640,2395,525,2496,425
1400000US48201310200,48201310200,"Census Tract 3102, Harris County, Texas",1508,265,1055,202,453,186
1400000US48201310300,48201310300,"Census Tract 3103, Harris County, Texas",5201,571,1484,450,3717,560
1400000US48201310400,48201310400,"Census Tract 3104, Harris County, Texas",3694,420,188,83,3506,454
1400000US48201310500,48201310500,"Census Tract 3105, Harris County, Texas",4721,659,482,309,4239,624
1400000US48201310600,48201310600,"Census Tract 3106, Harris County, Texas",6379,851,1003,306,5376,792
1400000US48201310700,48201310700,"Census Tract 3107, Harris County, Texas",4646,601,767,244,3879,572
1400000US48201310800,48201310800,"Census Tract 3108, Harris County, Texas",2352,358,275,125,2077,343
1400000US48201310900,48201310900,"Census Tract 3109, Harris County, Texas",5809,595,138,76,5671,617
1400000US48201311000,48201311000,"Census Tract 3110, Harris County, Texas",8061,887,277,180,7784,918
1400000US48201311100,48201311100,"Census Tract 3111, Harris County, Texas",5729,733,89,66,5640,761
1400000US48201311200,48201311200,"Census Tract 3112, Harris County, Texas",5365,656,288,106,5077,674
1400000US48201311300,48201311300,"Census Tract 3113, Harris County, Texas",5850,511,283,172,5567,520
1400000US48201311400,48201311400,"Census Tract 3114, Harris County, Texas",2221,475,318,224,1903,475
1400000US48201311500,48201311500,"Census Tract 3115, Harris County, Texas",7855,783,813,288,7042,761
1400000US48201311600,48201311600,"Census Tract 3116, Harris County, Texas",4084,568,374,248,3710,594
1400000US48201311700,48201311700,"Census Tract 3117, Harris County, Texas",5686,544,1053,354,4633,546
1400000US48201311800,48201311800,"Census Tract 3118, Harris County, Texas",4937,573,191,122,4746,592
1400000US48201311900,48201311900,"Census Tract 3119, Harris County, Texas",2562,305,283,198,2279,381
1400000US48201312000,48201312000,"Census Tract 3120, Harris County, Texas",3005,1445,2930,1443,75,44
1400000US48201312100,48201312100,"Census Tract 3121, Harris County, Texas",1092,486,1030,453,62,48
1400000US48201312200,48201312200,"Census Tract 3122, Harris County, Texas",2069,341,1785,322,284,184
1400000US48201312300,48201312300,"Census Tract 3123, Harris County, Texas",1665,499,1138,318,527,443
1400000US48201312400,48201312400,"Census Tract 3124, Harris County, Texas",2048,552,1507,336,541,457
1400000US48201312500,48201312500,"Census Tract 3125, Harris County, Texas",3065,517,2578,499,487,127
1400000US48201312600,48201312600,"Census Tract 3126, Harris County, Texas",4728,521,3719,510,1009,379
1400000US48201312700,48201312700,"Census Tract 3127, Harris County, Texas",2115,414,1960,377,155,194
1400000US48201312800,48201312800,"Census Tract 3128, Harris County, Texas",2659,428,2378,438,281,157
1400000US48201312900,48201312900,"Census Tract 3129, Harris County, Texas",4276,529,4212,534,64,104
1400000US48201313000,48201313000,"Census Tract 3130, Harris County, Texas",1981,295,1895,294,86,64
1400000US48201313100,48201313100,"Census Tract 3131, Harris County, Texas",3018,440,2602,445,416,180
1400000US48201313200,48201313200,"Census Tract 3132, Harris County, Texas",3798,620,3551,583,247,165
1400000US48201313300,48201313300,"Census Tract 3133, Harris County, Texas",2413,342,2311,347,102,74
1400000US48201313400,48201313400,"Census Tract 3134, Harris County, Texas",2974,310,2373,227,601,185
1400000US48201313500,48201313500,"Census Tract 3135, Harris County, Texas",2248,426,1776,345,472,282
1400000US48201313600,48201313600,"Census Tract 3136, Harris County, Texas",4533,600,3781,537,752,493
1400000US48201313700,48201313700,"Census Tract 3137, Harris County, Texas",2263,293,2166,294,97,92
1400000US48201313800,48201313800,"Census Tract 3138, Harris County, Texas",4785,492,4149,468,636,270
1400000US48201313900,48201313900,"Census Tract 3139, Harris County, Texas",3780,701,3323,647,457,285
1400000US48201314001,48201314001,"Census Tract 3140.01, Harris County, Texas",3369,623,2802,605,567,301
1400000US48201314002,48201314002,"Census Tract 3140.02, Harris County, Texas",7411,636,6891,670,520,211
1400000US48201314300,48201314300,"Census Tract 3143, Harris County, Texas",4073,612,3682,599,391,217
1400000US48201314400,48201314400,"Census Tract 3144, Harris County, Texas",3033,309,2667,305,366,141
1400000US48201320100,48201320100,"Census Tract 3201, Harris County, Texas",2853,451,116,87,2737,476
1400000US48201320200,48201320200,"Census Tract 3202, Harris County, Texas",6976,748,2290,486,4686,709
1400000US48201320500,48201320500,"Census Tract 3205, Harris County, Texas",4890,285,649,142,4241,301
1400000US48201320601,48201320601,"Census Tract 3206.01, Harris County, Texas",2614,411,301,119,2313,421
1400000US48201320602,48201320602,"Census Tract 3206.02, Harris County, Texas",4568,643,451,215,4117,629
1400000US48201320700,48201320700,"Census Tract 3207, Harris County, Texas",4111,396,923,228,3188,402
1400000US48201320800,48201320800,"Census Tract 3208, Harris County, Texas",5442,455,558,166,4884,515
1400000US48201320900,48201320900,"Census Tract 3209, Harris County, Texas",7724,645,2252,448,5472,682
1400000US48201321000,48201321000,"Census Tract 3210, Harris County, Texas",7337,694,1952,328,5385,666
1400000US48201321100,48201321100,"Census Tract 3211, Harris County, Texas",7720,551,2764,370,4956,548
1400000US48201321200,48201321200,"Census Tract 3212, Harris County, Texas",3784,544,673,202,3111,555
1400000US48201321300,48201321300,"Census Tract 3213, Harris County, Texas",5725,787,1735,643,3990,724
1400000US48201321401,48201321401,"Census Tract 3214.01, Harris County, Texas",4195,399,657,314,3538,414
1400000US48201321402,48201321402,"Census Tract 3214.02, Harris County, Texas",4517,535,827,194,3690,573
1400000US48201321500,48201321500,"Census Tract 3215, Harris County, Texas",2535,344,281,92,2254,357
1400000US48201321600,48201321600,"Census Tract 3216, Harris County, Texas",6042,466,1584,251,4458,491
1400000US48201321700,48201321700,"Census Tract 3217, Harris County, Texas",3503,259,1005,232,2498,324
1400000US48201321800,48201321800,"Census Tract 3218, Harris County, Texas",4005,305,681,229,3324,362
1400000US48201321900,48201321900,"Census Tract 3219, Harris County, Texas",5539,507,1127,294,4412,582
1400000US48201322000,48201322000,"Census Tract 3220, Harris County, Texas",4940,694,807,283,4133,659
1400000US48201322100,48201322100,"Census Tract 3221, Harris County, Texas",3727,538,1090,341,2637,440
1400000US48201322200,48201322200,"Census Tract 3222, Harris County, Texas",1570,378,322,151,1248,386
1400000US48201322600,48201322600,"Census Tract 3226, Harris County, Texas",5316,499,2280,454,3036,535
1400000US48201322700,48201322700,"Census Tract 3227, Harris County, Texas",7046,642,1810,388,5236,688
1400000US48201322800,48201322800,"Census Tract 3228, Harris County, Texas",6569,706,1312,323,5257,680
1400000US48201322900,48201322900,"Census Tract 3229, Harris County, Texas",4054,489,800,145,3254,521
1400000US48201323000,48201323000,"Census Tract 3230, Harris County, Texas",6061,620,749,164,5312,645
1400000US48201323100,48201323100,"Census Tract 3231, Harris County, Texas",3024,387,616,227,2408,480
1400000US48201323200,48201323200,"Census Tract 3232, Harris County, Texas",4628,479,1574,347,3054,497
1400000US48201323300,48201323300,"Census Tract 3233, Harris County, Texas",3408,447,565,199,2843,479
1400000US48201323400,48201323400,"Census Tract 3234, Harris County, Texas",7620,575,1655,271,5965,602
1400000US48201323500,48201323500,"Census Tract 3235, Harris County, Texas",4925,588,1505,368,3420,553
1400000US48201323600,48201323600,"Census Tract 3236, Harris County, Texas",7789,634,4392,497,3397,748
1400000US48201323701,48201323701,"Census Tract 3237.01, Harris County, Texas",4103,501,2503,430,1600,398
1400000US48201323702,48201323702,"Census Tract 3237.02, Harris County, Texas",3276,574,1648,382,1628,471
1400000US48201323801,48201323801,"Census Tract 3238.01, Harris County, Texas",3978,378,1692,334,2286,369
1400000US48201323802,48201323802,"Census Tract 3238.02, Harris County, Texas",4999,418,2377,371,2622,516
1400000US48201323900,48201323900,"Census Tract 3239, Harris County, Texas",3487,473,1402,252,2085,419
1400000US48201324000,48201324000,"Census Tract 3240, Harris County, Texas",5677,354,3612,228,2065,285
1400000US48201324100,48201324100,"Census Tract 3241, Harris County, Texas",5797,634,804,334,4993,609
1400000US48201324200,48201324200,"Census Tract 3242, Harris County, Texas",1748,290,77,110,1671,300
1400000US48201330100,48201330100,"Census Tract 3301, Harris County, Texas",8904,615,3519,430,5385,621
1400000US48201330200,48201330200,"Census Tract 3302, Harris County, Texas",3117,511,1774,308,1343,380
1400000US48201330301,48201330301,"Census Tract 3303.01, Harris County, Texas",7462,543,2415,421,5047,457
1400000US48201330302,48201330302,"Census Tract 3303.02, Harris County, Texas",5989,923,2939,811,3050,564
1400000US48201330303,48201330303,"Census Tract 3303.03, Harris County, Texas",3350,542,1781,389,1569,457
1400000US48201330400,48201330400,"Census Tract 3304, Harris County, Texas",4632,476,2142,323,2490,500
1400000US48201330500,48201330500,"Census Tract 3305, Harris County, Texas",4310,753,1791,527,2519,533
1400000US48201330600,48201330600,"Census Tract 3306, Harris County, Texas",6867,632,4012,472,2855,508
1400000US48201330700,48201330700,"Census Tract 3307, Harris County, Texas",7857,626,2914,448,4943,677
1400000US48201330800,48201330800,"Census Tract 3308, Harris County, Texas",7368,713,5068,594,2300,397
1400000US48201330900,48201330900,"Census Tract 3309, Harris County, Texas",6552,674,3580,484,2972,568
1400000US48201331100,48201331100,"Census Tract 3311, Harris County, Texas",3307,469,2924,450,383,160
1400000US48201331200,48201331200,"Census Tract 3312, Harris County, Texas",2973,466,2768,519,205,159
1400000US48201331300,48201331300,"Census Tract 3313, Harris County, Texas",5021,621,4813,601,208,173
1400000US48201331400,48201331400,"Census Tract 3314, Harris County, Texas",3077,587,3012,611,65,94
1400000US48201331500,48201331500,"Census Tract 3315, Harris County, Texas",7296,660,6724,662,572,344
1400000US48201331601,48201331601,"Census Tract 3316.01, Harris County, Texas",5868,670,5605,671,263,127
1400000US48201331602,48201331602,"Census Tract 3316.02, Harris County, Texas",2392,604,2259,569,133,197
1400000US48201331700,48201331700,"Census Tract 3317, Harris County, Texas",4037,511,3568,505,469,304
1400000US48201331800,48201331800,"Census Tract 3318, Harris County, Texas",3744,589,3569,569,175,83
1400000US48201331900,48201331900,"Census Tract 3319, Harris County, Texas",3269,366,3141,394,128,224
1400000US48201332000,48201332000,"Census Tract 3320, Harris County, Texas",5917,608,4673,472,1244,398
1400000US48201332100,48201332100,"Census Tract 3321, Harris County, Texas",3349,707,2012,709,1337,575
1400000US48201332200,48201332200,"Census Tract 3322, Harris County, Texas",5578,724,3310,597,2268,559
1400000US48201332300,48201332300,"Census Tract 3323, Harris County, Texas",2984,431,2223,386,761,369
1400000US48201332400,48201332400,"Census Tract 3324, Harris County, Texas",4845,844,4663,744,182,298
1400000US48201332500,48201332500,"Census Tract 3325, Harris County, Texas",3164,400,2063,370,1101,316
1400000US48201332600,48201332600,"Census Tract 3326, Harris County, Texas",6158,637,2380,324,3778,571
1400000US48201332700,48201332700,"Census Tract 3327, Harris County, Texas",3061,398,226,92,2835,407
1400000US48201332800,48201332800,"Census Tract 3328, Harris County, Texas",5186,647,856,273,4330,621
1400000US48201332900,48201332900,"Census Tract 3329, Harris County, Texas",5511,554,882,204,4629,515
1400000US48201333000,48201333000,"Census Tract 3330, Harris County, Texas",3905,476,711,252,3194,556
1400000US48201333100,48201333100,"Census Tract 3331, Harris County, Texas",3390,465,2460,492,930,351
1400000US48201333201,48201333201,"Census Tract 3332.01, Harris County, Texas",5014,586,1752,315,3262,530
1400000US48201333202,48201333202,"Census Tract 3332.02, Harris County, Texas",5213,560,1941,434,3272,551
1400000US48201333300,48201333300,"Census Tract 3333, Harris County, Texas",9123,801,3198,802,5925,1020
1400000US48201333500,48201333500,"Census Tract 3335, Harris County, Texas",6693,707,1932,391,4761,791
1400000US48201333600,48201333600,"Census Tract 3336, Harris County, Texas",2704,324,1102,202,1602,341
1400000US48201333700,48201333700,"Census Tract 3337, Harris County, Texas",3696,412,1065,393,2631,421
1400000US48201333800,48201333800,"Census Tract 3338, Harris County, Texas",9642,721,2681,686,6961,925
1400000US48201333901,48201333901,"Census Tract 3339.01, Harris County, Texas",6928,582,3901,670,3027,634
1400000US48201333902,48201333902,"Census Tract 3339.02, Harris County, Texas",7620,628,4253,647,3367,705
1400000US48201334001,48201334001,"Census Tract 3340.01, Harris County, Texas",3240,798,1461,443,1779,717
1400000US48201334002,48201334002,"Census Tract 3340.02, Harris County, Texas",1880,524,1186,555,694,350
1400000US48201334003,48201334003,"Census Tract 3340.03, Harris County, Texas",6417,729,3605,325,2812,682
1400000US48201334100,48201334100,"Census Tract 3341, Harris County, Texas",8599,767,7118,857,1481,409
1400000US48201340100,48201340100,"Census Tract 3401, Harris County, Texas",3923,514,2283,309,1640,418
1400000US48201340201,48201340201,"Census Tract 3402.01, Harris County, Texas",1805,169,1650,200,155,136
1400000US48201340202,48201340202,"Census Tract 3402.02, Harris County, Texas",5194,257,4728,301,466,178
1400000US48201340203,48201340203,"Census Tract 3402.03, Harris County, Texas",4160,229,3772,251,388,174
1400000US48201340301,48201340301,"Census Tract 3403.01, Harris County, Texas",4227,287,3929,288,298,134
1400000US48201340302,48201340302,"Census Tract 3403.02, Harris County, Texas",7536,325,7068,401,468,248
1400000US48201340400,48201340400,"Census Tract 3404, Harris County, Texas",1490,136,1446,145,44,55
1400000US48201340500,48201340500,"Census Tract 3405, Harris County, Texas",6408,456,4775,443,1633,396
1400000US48201340600,48201340600,"Census Tract 3406, Harris County, Texas",2542,97,2291,167,251,181
1400000US48201340700,48201340700,"Census Tract 3407, Harris County, Texas",7675,600,6294,645,1381,403
1400000US48201340800,48201340800,"Census Tract 3408, Harris County, Texas",5894,317,5057,355,837,179
1400000US48201340900,48201340900,"Census Tract 3409, Harris County, Texas",4447,617,2934,459,1513,525
1400000US48201341000,48201341000,"Census Tract 3410, Harris County, Texas",6972,877,5574,801,1398,407
1400000US48201341100,48201341100,"Census Tract 3411, Harris County, Texas",3990,425,2209,429,1781,514
1400000US48201341201,48201341201,"Census Tract 3412.01, Harris County, Texas",3154,450,2238,414,916,569
1400000US48201341202,48201341202,"Census Tract 3412.02, Harris County, Texas",4877,327,4333,450,544,293
1400000US48201341301,48201341301,"Census Tract 3413.01, Harris County, Texas",5373,673,4344,466,1029,588
1400000US48201341302,48201341302,"Census Tract 3413.02, Harris County, Texas",2840,285,2092,359,748,225
1400000US48201341400,48201341400,"Census Tract 3414, Harris County, Texas",5400,436,4835,443,565,263
1400000US48201341501,48201341501,"Census Tract 3415.01, Harris County, Texas",5757,393,5219,430,538,334
1400000US48201341502,48201341502,"Census Tract 3415.02, Harris County, Texas",3974,398,3244,357,730,469
1400000US48201341600,48201341600,"Census Tract 3416, Harris County, Texas",5546,478,4853,550,693,317
1400000US48201341700,48201341700,"Census Tract 3417, Harris County, Texas",2485,412,2017,201,468,347
1400000US48201341800,48201341800,"Census Tract 3418, Harris County, Texas",1903,239,1454,301,449,233
1400000US48201342001,48201342001,"Census Tract 3420.01, Harris County, Texas",6978,441,5702,451,1276,336
1400000US48201342002,48201342002,"Census Tract 3420.02, Harris County, Texas",3351,201,1843,461,1508,519
1400000US48201342100,48201342100,"Census Tract 3421, Harris County, Texas",4180,476,2240,282,1940,489
1400000US48201342200,48201342200,"Census Tract 3422, Harris County, Texas",4567,610,2131,317,2436,625
1400000US48201342300,48201342300,"Census Tract 3423, Harris County, Texas",6345,521,3696,587,2649,445
1400000US48201342400,48201342400,"Census Tract 3424, Harris County, Texas",3524,455,1662,317,1862,419
1400000US48201342500,48201342500,"Census Tract 3425, Harris County, Texas",6055,432,4967,369,1088,327
1400000US48201342700,48201342700,"Census Tract 3427, Harris County, Texas",4877,394,3662,348,1215,258
1400000US48201342800,48201342800,"Census Tract 3428, Harris County, Texas",8402,368,6544,435,1858,378
1400000US48201342900,48201342900,"Census Tract 3429, Harris County, Texas",5591,273,4536,325,1055,272
1400000US48201343000,48201343000,"Census Tract 3430, Harris County, Texas",6857,617,4948,709,1909,367
1400000US48201343100,48201343100,"Census Tract 3431, Harris County, Texas",4915,410,3600,329,1315,377
1400000US48201343200,48201343200,"Census Tract 3432, Harris County, Texas",4749,420,3884,466,865,264
1400000US48201343301,48201343301,"Census Tract 3433.01, Harris County, Texas",4219,336,3147,464,1072,415
1400000US48201343302,48201343302,"Census Tract 3433.02, Harris County, Texas",4817,435,3354,450,1463,412
1400000US48201343600,48201343600,"Census Tract 3436, Harris County, Texas",3618,388,2271,297,1347,287
1400000US48201343700,48201343700,"Census Tract 3437, Harris County, Texas",2999,402,1968,306,1031,372
1400000US48201350100,48201350100,"Census Tract 3501, Harris County, Texas",14012,855,10329,742,3683,498
1400000US48201350200,48201350200,"Census Tract 3502, Harris County, Texas",8824,733,4808,582,4016,736
1400000US48201350300,48201350300,"Census Tract 3503, Harris County, Texas",5724,610,4341,560,1383,248
1400000US48201350400,48201350400,"Census Tract 3504, Harris County, Texas",6081,489,3057,433,3024,417
1400000US48201350500,48201350500,"Census Tract 3505, Harris County, Texas",6616,619,2948,481,3668,471
1400000US48201350601,48201350601,"Census Tract 3506.01, Harris County, Texas",3979,489,3545,409,434,195
1400000US48201350602,48201350602,"Census Tract 3506.02, Harris County, Texas",8186,654,6580,563,1606,401
1400000US48201350700,48201350700,"Census Tract 3507, Harris County, Texas",1918,146,1620,242,298,200
1400000US48201350801,48201350801,"Census Tract 3508.01, Harris County, Texas",5133,407,3634,433,1499,332
1400000US48201350802,48201350802,"Census Tract 3508.02, Harris County, Texas",5975,428,4640,423,1335,337
1400000US48201410100,48201410100,"Census Tract 4101, Harris County, Texas",3844,348,3040,324,804,271
1400000US48201410200,48201410200,"Census Tract 4102, Harris County, Texas",3882,366,3231,360,651,203
1400000US48201410300,48201410300,"Census Tract 4103, Harris County, Texas",2891,360,2580,352,311,124
1400000US48201410401,48201410401,"Census Tract 4104.01, Harris County, Texas",3861,508,3355,426,506,214
1400000US48201410402,48201410402,"Census Tract 4104.02, Harris County, Texas",2721,463,1893,326,828,308
1400000US48201410500,48201410500,"Census Tract 4105, Harris County, Texas",4173,370,3339,359,834,219
1400000US48201410600,48201410600,"Census Tract 4106, Harris County, Texas",3289,315,2752,314,537,246
1400000US48201410701,48201410701,"Census Tract 4107.01, Harris County, Texas",3308,392,2759,314,549,263
1400000US48201410702,48201410702,"Census Tract 4107.02, Harris County, Texas",2302,453,1977,374,325,152
1400000US48201410800,48201410800,"Census Tract 4108, Harris County, Texas",3687,554,2899,370,788,410
1400000US48201410900,48201410900,"Census Tract 4109, Harris County, Texas",2435,310,1996,207,439,252
1400000US48201411000,48201411000,"Census Tract 4110, Harris County, Texas",3167,377,2986,371,181,113
1400000US48201411100,48201411100,"Census Tract 4111, Harris County, Texas",3616,388,3267,355,349,214
1400000US48201411200,48201411200,"Census Tract 4112, Harris County, Texas",2162,223,2107,234,55,44
1400000US48201411300,48201411300,"Census Tract 4113, Harris County, Texas",3512,375,2933,332,579,235
1400000US48201411400,48201411400,"Census Tract 4114, Harris County, Texas",3006,324,2904,319,102,94
1400000US48201411501,48201411501,"Census Tract 4115.01, Harris County, Texas",4242,474,3467,449,775,252
1400000US48201411502,48201411502,"Census Tract 4115.02, Harris County, Texas",4396,414,3645,378,751,323
1400000US48201411600,48201411600,"Census Tract 4116, Harris County, Texas",2262,178,2184,184,78,59
1400000US48201411700,48201411700,"Census Tract 4117, Harris County, Texas",2601,257,2293,293,308,144
1400000US48201411800,48201411800,"Census Tract 4118, Harris County, Texas",5160,494,4666,546,494,169
1400000US48201411900,48201411900,"Census Tract 4119, Harris County, Texas",4382,881,3864,856,518,263
1400000US48201412000,48201412000,"Census Tract 4120, Harris County, Texas",3037,326,2829,323,208,141
1400000US48201412100,48201412100,"Census Tract 4121, Harris County, Texas",1972,748,1757,661,215,132
1400000US48201412200,48201412200,"Census Tract 4122, Harris County, Texas",5547,511,5181,404,366,301
1400000US48201412300,48201412300,"Census Tract 4123, Harris County, Texas",6704,308,6139,339,565,248
1400000US48201412400,48201412400,"Census Tract 4124, Harris County, Texas",4196,271,3908,291,288,128
1400000US48201412500,48201412500,"Census Tract 4125, Harris County, Texas",1691,76,1586,82,105,56
1400000US48201412600,48201412600,"Census Tract 4126, Harris County, Texas",3715,257,3239,276,476,175
1400000US48201412700,48201412700,"Census Tract 4127, Harris County, Texas",3331,266,3130,264,201,145
1400000US48201412800,48201412800,"Census Tract 4128, Harris County, Texas",4857,261,4290,304,567,248
1400000US48201412900,48201412900,"Census Tract 4129, Harris County, Texas",3904,444,3462,469,442,258
1400000US48201413000,48201413000,"Census Tract 4130, Harris County, Texas",3313,370,2718,348,595,258
1400000US48201413100,48201413100,"Census Tract 4131, Harris County, Texas",3047,226,2733,274,314,151
1400000US48201413201,48201413201,"Census Tract 4132.01, Harris County, Texas",2260,421,1635,305,625,351
1400000US48201413202,48201413202,"Census Tract 4132.02, Harris County, Texas",3096,566,2808,501,288,156
1400000US48201413300,48201413300,"Census Tract 4133, Harris County, Texas",6986,528,6181,550,805,244
1400000US48201420100,48201420100,"Census Tract 4201, Harris County, Texas",3213,452,1730,362,1483,422
1400000US48201420200,48201420200,"Census Tract 4202, Harris County, Texas",2586,317,1747,385,839,301
1400000US48201420300,48201420300,"Census Tract 4203, Harris County, Texas",3442,383,2900,336,542,284
1400000US48201420400,48201420400,"Census Tract 4204, Harris County, Texas",3702,269,2731,258,971,232
1400000US48201420500,48201420500,"Census Tract 4205, Harris County, Texas",3742,599,1033,298,2709,598
1400000US48201420600,48201420600,"Census Tract 4206, Harris County, Texas",2297,253,1602,186,695,261
1400000US48201420700,48201420700,"Census Tract 4207, Harris County, Texas",3202,231,2882,255,320,154
1400000US48201420800,48201420800,"Census Tract 4208, Harris County, Texas",2794,232,2610,262,184,131
1400000US48201420900,48201420900,"Census Tract 4209, Harris County, Texas",5951,280,5544,307,407,186
1400000US48201421000,48201421000,"Census Tract 4210, Harris County, Texas",2438,189,2092,253,346,266
1400000US48201421101,48201421101,"Census Tract 4211.01, Harris County, Texas",3404,665,1288,291,2116,617
1400000US48201421102,48201421102,"Census Tract 4211.02, Harris County, Texas",5552,840,1020,298,4532,880
1400000US48201421201,48201421201,"Census Tract 4212.01, Harris County, Texas",3987,600,851,290,3136,661
1400000US48201421202,48201421202,"Census Tract 4212.02, Harris County, Texas",3942,797,458,246,3484,756
1400000US48201421300,48201421300,"Census Tract 4213, Harris County, Texas",5828,863,2592,522,3236,691
1400000US48201421401,48201421401,"Census Tract 4214.01, Harris County, Texas",3281,595,392,251,2889,599
1400000US48201421402,48201421402,"Census Tract 4214.02, Harris County, Texas",3934,600,212,165,3722,604
1400000US48201421403,48201421403,"Census Tract 4214.03, Harris County, Texas",5209,931,802,157,4407,985
1400000US48201421500,48201421500,"Census Tract 4215, Harris County, Texas",5611,995,2691,676,2920,591
1400000US48201421600,48201421600,"Census Tract 4216, Harris County, Texas",6600,815,1611,363,4989,858
1400000US48201421700,48201421700,"Census Tract 4217, Harris County, Texas",4817,423,3269,295,1548,396
1400000US48201421800,48201421800,"Census Tract 4218, Harris County, Texas",4886,501,3796,523,1090,445
1400000US48201421900,48201421900,"Census Tract 4219, Harris County, Texas",2549,195,2371,212,178,131
1400000US48201422000,48201422000,"Census Tract 4220, Harris County, Texas",2647,169,2029,326,618,234
1400000US48201422100,48201422100,"Census Tract 4221, Harris County, Texas",5655,637,3549,495,2106,500
1400000US48201422200,48201422200,"Census Tract 4222, Harris County, Texas",5730,988,4524,919,1206,527
1400000US48201422301,48201422301,"Census Tract 4223.01, Harris County, Texas",6855,867,5595,965,1260,398
1400000US48201422302,48201422302,"Census Tract 4223.02, Harris County, Texas",2338,374,1626,367,712,194
1400000US48201422401,48201422401,"Census Tract 4224.01, Harris County, Texas",3852,563,2900,529,952,387
1400000US48201422402,48201422402,"Census Tract 4224.02, Harris County, Texas",5771,820,2705,553,3066,661
1400000US48201422500,48201422500,"Census Tract 4225, Harris County, Texas",6176,681,4549,500,1627,569
1400000US48201422600,48201422600,"Census Tract 4226, Harris County, Texas",6542,810,4450,813,2092,465
1400000US48201422701,48201422701,"Census Tract 4227.01, Harris County, Texas",4303,557,1134,269,3169,555
1400000US48201422702,48201422702,"Census Tract 4227.02, Harris County, Texas",3744,645,1546,334,2198,612
1400000US48201422800,48201422800,"Census Tract 4228, Harris County, Texas",4339,675,1652,393,2687,507
1400000US48201422900,48201422900,"Census Tract 4229, Harris County, Texas",4557,665,1912,310,2645,634
1400000US48201423000,48201423000,"Census Tract 4230, Harris County, Texas",6013,814,2851,688,3162,611
1400000US48201423100,48201423100,"Census Tract 4231, Harris County, Texas",2958,500,1208,317,1750,497
1400000US48201423201,48201423201,"Census Tract 4232.01, Harris County, Texas",2934,444,1625,242,1309,407
1400000US48201423202,48201423202,"Census Tract 4232.02, Harris County, Texas",7286,919,4319,803,2967,767
1400000US48201423301,48201423301,"Census Tract 4233.01, Harris County, Texas",3888,527,2659,377,1229,451
1400000US48201423302,48201423302,"Census Tract 4233.02, Harris County, Texas",4517,519,4176,544,341,223
1400000US48201423401,48201423401,"Census Tract 4234.01, Harris County, Texas",5214,659,4305,660,909,193
1400000US48201423402,48201423402,"Census Tract 4234.02, Harris County, Texas",4119,488,3392,473,727,282
1400000US48201423500,48201423500,"Census Tract 4235, Harris County, Texas",2298,310,1842,259,456,278
1400000US48201423600,48201423600,"Census Tract 4236, Harris County, Texas",6964,666,4303,733,2661,750
1400000US48201430100,48201430100,"Census Tract 4301, Harris County, Texas",5549,533,4763,504,786,290
1400000US48201430200,48201430200,"Census Tract 4302, Harris County, Texas",1372,178,1182,197,190,104
1400000US48201430300,48201430300,"Census Tract 4303, Harris County, Texas",4326,47,4226,106,100,96
1400000US48201430400,48201430400,"Census Tract 4304, Harris County, Texas",3116,29,2876,123,240,117
1400000US48201430500,48201430500,"Census Tract 4305, Harris County, Texas",2526,49,2188,181,338,174
1400000US48201430600,48201430600,"Census Tract 4306, Harris County, Texas",3624,24,3344,161,280,161
1400000US48201430700,48201430700,"Census Tract 4307, Harris County, Texas",3242,263,2965,266,277,133
1400000US48201430800,48201430800,"Census Tract 4308, Harris County, Texas",4044,331,3946,340,98,71
1400000US48201430900,48201430900,"Census Tract 4309, Harris County, Texas",5507,514,4910,478,597,367
1400000US48201431000,48201431000,"Census Tract 4310, Harris County, Texas",5258,418,4782,412,476,235
1400000US48201431101,48201431101,"Census Tract 4311.01, Harris County, Texas",2595,292,2317,318,278,212
1400000US48201431102,48201431102,"Census Tract 4311.02, Harris County, Texas",2677,326,2149,256,528,269
1400000US48201431201,48201431201,"Census Tract 4312.01, Harris County, Texas",4089,415,3217,447,872,463
1400000US48201431202,48201431202,"Census Tract 4312.02, Harris County, Texas",4840,532,3984,460,856,364
1400000US48201431301,48201431301,"Census Tract 4313.01, Harris County, Texas",4233,480,3098,389,1135,525
1400000US48201431302,48201431302,"Census Tract 4313.02, Harris County, Texas",3871,274,3452,234,419,207
1400000US48201431401,48201431401,"Census Tract 4314.01, Harris County, Texas",2442,351,1922,297,520,159
1400000US48201431402,48201431402,"Census Tract 4314.02, Harris County, Texas",3513,328,3031,335,482,192
1400000US48201431501,48201431501,"Census Tract 4315.01, Harris County, Texas",3741,483,3339,477,402,170
1400000US48201431502,48201431502,"Census Tract 4315.02, Harris County, Texas",3313,418,3002,410,311,177
1400000US48201431600,48201431600,"Census Tract 4316, Harris County, Texas",3323,276,3041,306,282,188
1400000US48201431700,48201431700,"Census Tract 4317, Harris County, Texas",4463,320,4254,320,209,131
1400000US48201431801,48201431801,"Census Tract 4318.01, Harris County, Texas",2694,424,2470,409,224,152
1400000US48201431802,48201431802,"Census Tract 4318.02, Harris County, Texas",2980,420,2274,370,706,353
1400000US48201431900,48201431900,"Census Tract 4319, Harris County, Texas",3062,332,2552,308,510,206
1400000US48201432001,48201432001,"Census Tract 4320.01, Harris County, Texas",2805,330,2116,317,689,237
1400000US48201432002,48201432002,"Census Tract 4320.02, Harris County, Texas",4478,555,2200,350,2278,600
1400000US48201432100,48201432100,"Census Tract 4321, Harris County, Texas",4592,620,3144,502,1448,534
1400000US48201432200,48201432200,"Census Tract 4322, Harris County, Texas",4418,428,2964,380,1454,458
1400000US48201432300,48201432300,"Census Tract 4323, Harris County, Texas",5949,765,3962,455,1987,742
1400000US48201432400,48201432400,"Census Tract 4324, Harris County, Texas",5300,706,3244,542,2056,561
1400000US48201432500,48201432500,"Census Tract 4325, Harris County, Texas",5682,727,2509,426,3173,851
1400000US48201432600,48201432600,"Census Tract 4326, Harris County, Texas",2144,331,1315,223,829,415
1400000US48201432701,48201432701,"Census Tract 4327.01, Harris County, Texas",6135,594,1051,374,5084,642
1400000US48201432702,48201432702,"Census Tract 4327.02, Harris County, Texas",2562,304,1504,243,1058,243
1400000US48201432801,48201432801,"Census Tract 4328.01, Harris County, Texas",4365,517,2453,504,1912,503
1400000US48201432802,48201432802,"Census Tract 4328.02, Harris County, Texas",5879,734,2112,485,3767,683
1400000US48201432901,48201432901,"Census Tract 4329.01, Harris County, Texas",3656,467,861,432,2795,593
1400000US48201432902,48201432902,"Census Tract 4329.02, Harris County, Texas",4242,658,2033,367,2209,577
1400000US48201433001,48201433001,"Census Tract 4330.01, Harris County, Texas",5505,867,2165,756,3340,626
1400000US48201433002,48201433002,"Census Tract 4330.02, Harris County, Texas",3895,549,1366,250,2529,630
1400000US48201433003,48201433003,"Census Tract 4330.03, Harris County, Texas",4295,648,2597,578,1698,676
1400000US48201433100,48201433100,"Census Tract 4331, Harris County, Texas",2240,602,1099,323,1141,541
1400000US48201433201,48201433201,"Census Tract 4332.01, Harris County, Texas",4656,493,3271,398,1385,472
1400000US48201433202,48201433202,"Census Tract 4332.02, Harris County, Texas",3332,559,1574,369,1758,386
1400000US48201433300,48201433300,"Census Tract 4333, Harris County, Texas",5356,462,3404,404,1952,393
1400000US48201433400,48201433400,"Census Tract 4334, Harris County, Texas",3982,396,2066,315,1916,400
1400000US48201433501,48201433501,"Census Tract 4335.01, Harris County, Texas",5892,900,1435,435,4457,970
1400000US48201433502,48201433502,"Census Tract 4335.02, Harris County, Texas",6178,979,2205,608,3973,1135
1400000US48201433600,48201433600,"Census Tract 4336, Harris County, Texas",4537,672,2612,478,1925,542
1400000US48201440100,48201440100,"Census Tract 4401, Harris County, Texas",5911,646,3339,452,2572,582
1400000US48201450100,48201450100,"Census Tract 4501, Harris County, Texas",1556,149,1346,161,210,139
1400000US48201450200,48201450200,"Census Tract 4502, Harris County, Texas",4901,228,4482,257,419,200
1400000US48201450300,48201450300,"Census Tract 4503, Harris County, Texas",7556,865,5582,640,1974,764
1400000US48201450400,48201450400,"Census Tract 4504, Harris County, Texas",4234,470,3140,446,1094,370
1400000US48201450500,48201450500,"Census Tract 4505, Harris County, Texas",2956,282,2699,291,257,167
1400000US48201450600,48201450600,"Census Tract 4506, Harris County, Texas",4136,494,3323,325,813,400
1400000US48201450700,48201450700,"Census Tract 4507, Harris County, Texas",6508,273,6355,284,153,128
1400000US48201450801,48201450801,"Census Tract 4508.01, Harris County, Texas",2242,270,1699,381,543,313
1400000US48201450802,48201450802,"Census Tract 4508.02, Harris County, Texas",5439,802,3640,612,1799,690
1400000US48201450900,48201450900,"Census Tract 4509, Harris County, Texas",2537,319,2436,357,101,94
1400000US48201451001,48201451001,"Census Tract 4510.01, Harris County, Texas",4914,710,3564,611,1350,579
1400000US48201451002,48201451002,"Census Tract 4510.02, Harris County, Texas",4762,671,3494,528,1268,503
1400000US48201451100,48201451100,"Census Tract 4511, Harris County, Texas",3983,440,3419,450,564,212
1400000US48201451200,48201451200,"Census Tract 4512, Harris County, Texas",2682,181,2544,201,138,85
1400000US48201451300,48201451300,"Census Tract 4513, Harris County, Texas",7159,513,6260,505,899,264
1400000US48201451401,48201451401,"Census Tract 4514.01, Harris County, Texas",2762,352,2146,298,616,266
1400000US48201451402,48201451402,"Census Tract 4514.02, Harris County, Texas",4455,621,2980,483,1475,659
1400000US48201451403,48201451403,"Census Tract 4514.03, Harris County, Texas",3479,514,2663,381,816,351
1400000US48201451500,48201451500,"Census Tract 4515, Harris County, Texas",4714,601,3935,594,779,268
1400000US48201451601,48201451601,"Census Tract 4516.01, Harris County, Texas",5240,392,4941,374,299,136
1400000US48201451602,48201451602,"Census Tract 4516.02, Harris County, Texas",7302,1420,6140,1293,1162,414
1400000US48201451700,48201451700,"Census Tract 4517, Harris County, Texas",2672,349,2132,343,540,225
1400000US48201451800,48201451800,"Census Tract 4518, Harris County, Texas",5387,592,3121,496,2266,528
1400000US48201451901,48201451901,"Census Tract 4519.01, Harris County, Texas",7438,678,4896,636,2542,522
1400000US48201451902,48201451902,"Census Tract 4519.02, Harris County, Texas",2831,281,2562,347,269,166
1400000US48201452000,48201452000,"Census Tract 4520, Harris County, Texas",6385,626,5167,669,1218,300
1400000US48201452100,48201452100,"Census Tract 4521, Harris County, Texas",7232,628,6045,544,1187,376
1400000US48201452201,48201452201,"Census Tract 4522.01, Harris County, Texas",4618,513,3303,434,1315,442
1400000US48201452202,48201452202,"Census Tract 4522.02, Harris County, Texas",2517,331,1542,288,975,352
1400000US48201452300,48201452300,"Census Tract 4523, Harris County, Texas",3087,321,1525,360,1562,368
1400000US48201452400,48201452400,"Census Tract 4524, Harris County, Texas",7739,534,3994,643,3745,662
1400000US48201452500,48201452500,"Census Tract 4525, Harris County, Texas",7955,750,3851,621,4104,779
1400000US48201452600,48201452600,"Census Tract 4526, Harris County, Texas",6065,789,4297,770,1768,595
1400000US48201452700,48201452700,"Census Tract 4527, Harris County, Texas",9407,808,7174,697,2233,510
1400000US48201452801,48201452801,"Census Tract 4528.01, Harris County, Texas",6280,713,4266,649,2014,571
1400000US48201452802,48201452802,"Census Tract 4528.02, Harris County, Texas",5371,711,3100,530,2271,460
1400000US48201452900,48201452900,"Census Tract 4529, Harris County, Texas",3797,456,1601,413,2196,383
1400000US48201453000,48201453000,"Census Tract 4530, Harris County, Texas",7625,801,3159,673,4466,609
1400000US48201453100,48201453100,"Census Tract 4531, Harris County, Texas",3352,572,1836,375,1516,453
1400000US48201453200,48201453200,"Census Tract 4532, Harris County, Texas",6633,853,3119,517,3514,821
1400000US48201453300,48201453300,"Census Tract 4533, Harris County, Texas",3539,361,2663,372,876,364
1400000US48201453401,48201453401,"Census Tract 4534.01, Harris County, Texas",2478,413,1491,398,987,312
1400000US48201453402,48201453402,"Census Tract 4534.02, Harris County, Texas",8109,838,4790,767,3319,727
1400000US48201453403,48201453403,"Census Tract 4534.03, Harris County, Texas",3473,464,2316,414,1157,358
1400000US48201453501,48201453501,"Census Tract 4535.01, Harris County, Texas",6205,531,3751,499,2454,697
1400000US48201453502,48201453502,"Census Tract 4535.02, Harris County, Texas",3365,350,2192,295,1173,145
1400000US48201453601,48201453601,"Census Tract 4536.01, Harris County, Texas",1686,268,1125,399,561,389
1400000US48201453602,48201453602,"Census Tract 4536.02, Harris County, Texas",7609,814,4315,600,3294,824
1400000US48201453700,48201453700,"Census Tract 4537, Harris County, Texas",8818,808,5105,595,3713,660
1400000US48201453800,48201453800,"Census Tract 4538, Harris County, Texas",4069,385,1820,520,2249,656
1400000US48201453900,48201453900,"Census Tract 4539, Harris County, Texas",9287,737,6322,687,2965,603
1400000US48201454000,48201454000,"Census Tract 4540, Harris County, Texas",4823,523,3536,368,1287,334
1400000US48201454100,48201454100,"Census Tract 4541, Harris County, Texas",3328,342,2471,322,857,289
1400000US48201454200,48201454200,"Census Tract 4542, Harris County, Texas",4509,431,1730,306,2779,503
1400000US48201454301,48201454301,"Census Tract 4543.01, Harris County, Texas",9779,920,6360,759,3419,827
1400000US48201454302,48201454302,"Census Tract 4543.02, Harris County, Texas",6443,452,3312,387,3131,437
1400000US48201454400,48201454400,"Census Tract 4544, Harris County, Texas",140,149,63,82,77,125
1400000US48201454501,48201454501,"Census Tract 4545.01, Harris County, Texas",8376,400,7568,318,808,308
1400000US48201454502,48201454502,"Census Tract 4545.02, Harris County, Texas",2445,192,1805,320,640,330
1400000US48201454600,48201454600,"Census Tract 4546, Harris County, Texas",3927,444,3197,264,730,442
1400000US48201454700,48201454700,"Census Tract 4547, Harris County, Texas",6958,385,6491,422,467,189
1400000US48201454800,48201454800,"Census Tract 4548, Harris County, Texas",7156,543,5333,623,1823,460
1400000US48201454900,48201454900,"Census Tract 4549, Harris County, Texas",9491,470,7766,512,1725,333
1400000US48201455000,48201455000,"Census Tract 4550, Harris County, Texas",2726,234,2502,237,224,141
1400000US48201455101,48201455101,"Census Tract 4551.01, Harris County, Texas",6922,521,5189,607,1733,456
1400000US48201455102,48201455102,"Census Tract 4551.02, Harris County, Texas",3375,314,2884,255,491,217
1400000US48201455200,48201455200,"Census Tract 4552, Harris County, Texas",3959,464,3092,370,867,376
1400000US48201455300,48201455300,"Census Tract 4553, Harris County, Texas",2025,309,1660,325,365,244
1400000US48201510100,48201510100,"Census Tract 5101, Harris County, Texas",1524,234,551,144,973,247
1400000US48201510200,48201510200,"Census Tract 5102, Harris County, Texas",4511,436,3386,393,1125,325
1400000US48201510300,48201510300,"Census Tract 5103, Harris County, Texas",5503,608,4105,570,1398,345
1400000US48201510400,48201510400,"Census Tract 5104, Harris County, Texas",4322,391,3306,396,1016,369
1400000US48201510500,48201510500,"Census Tract 5105, Harris County, Texas",2683,320,1764,202,919,299
1400000US48201510600,48201510600,"Census Tract 5106, Harris County, Texas",4030,486,2237,302,1793,500
1400000US48201510700,48201510700,"Census Tract 5107, Harris County, Texas",2946,332,2401,295,545,227
1400000US48201510800,48201510800,"Census Tract 5108, Harris County, Texas",6080,380,5112,392,968,287
1400000US48201510900,48201510900,"Census Tract 5109, Harris County, Texas",5179,963,2408,291,2771,1005
1400000US48201511001,48201511001,"Census Tract 5110.01, Harris County, Texas",2838,330,2013,244,825,386
1400000US48201511002,48201511002,"Census Tract 5110.02, Harris County, Texas",4853,491,2831,608,2022,576
1400000US48201511100,48201511100,"Census Tract 5111, Harris County, Texas",2329,291,1808,254,521,272
1400000US48201511200,48201511200,"Census Tract 5112, Harris County, Texas",3913,408,2223,272,1690,383
1400000US48201511301,48201511301,"Census Tract 5113.01, Harris County, Texas",3425,396,2409,297,1016,281
1400000US48201511302,48201511302,"Census Tract 5113.02, Harris County, Texas",4157,461,2976,443,1181,416
1400000US48201511400,48201511400,"Census Tract 5114, Harris County, Texas",3392,479,1781,255,1611,506
1400000US48201511500,48201511500,"Census Tract 5115, Harris County, Texas",6206,611,2860,310,3346,600
1400000US48201511600,48201511600,"Census Tract 5116, Harris County, Texas",4619,566,977,271,3642,574
1400000US48201520100,48201520100,"Census Tract 5201, Harris County, Texas",2175,412,820,175,1355,375
1400000US48201520200,48201520200,"Census Tract 5202, Harris County, Texas",3212,416,2399,355,813,389
1400000US48201520300,48201520300,"Census Tract 5203, Harris County, Texas",5010,543,1884,334,3126,450
1400000US48201520400,48201520400,"Census Tract 5204, Harris County, Texas",3306,506,770,142,2536,530
1400000US48201520500,48201520500,"Census Tract 5205, Harris County, Texas",6874,815,1435,308,5439,812
1400000US48201520601,48201520601,"Census Tract 5206.01, Harris County, Texas",2781,502,422,154,2359,499
1400000US48201520602,48201520602,"Census Tract 5206.02, Harris County, Texas",6285,973,1272,341,5013,951
1400000US48201520700,48201520700,"Census Tract 5207, Harris County, Texas",4042,685,3031,610,1011,347
1400000US48201521000,48201521000,"Census Tract 5210, Harris County, Texas",2611,499,841,235,1770,511
1400000US48201521100,48201521100,"Census Tract 5211, Harris County, Texas",2402,382,357,113,2045,385
1400000US48201521200,48201521200,"Census Tract 5212, Harris County, Texas",6373,830,1593,354,4780,884
1400000US48201521300,48201521300,"Census Tract 5213, Harris County, Texas",5521,501,2119,368,3402,534
1400000US48201521400,48201521400,"Census Tract 5214, Harris County, Texas",7827,886,624,200,7203,848
1400000US48201521500,48201521500,"Census Tract 5215, Harris County, Texas",6198,743,2313,406,3885,811
1400000US48201521600,48201521600,"Census Tract 5216, Harris County, Texas",3235,404,1018,263,2217,336
1400000US48201521700,48201521700,"Census Tract 5217, Harris County, Texas",5935,786,2631,489,3304,822
1400000US48201521800,48201521800,"Census Tract 5218, Harris County, Texas",5469,423,2849,261,2620,391
1400000US48201521900,48201521900,"Census Tract 5219, Harris County, Texas",6081,550,4148,529,1933,416
1400000US48201522000,48201522000,"Census Tract 5220, Harris County, Texas",4086,610,2104,272,1982,567
1400000US48201522100,48201522100,"Census Tract 5221, Harris County, Texas",7601,729,3444,544,4157,802
1400000US48201522201,48201522201,"Census Tract 5222.01, Harris County, Texas",3573,601,1158,191,2415,605
1400000US48201522202,48201522202,"Census Tract 5222.02, Harris County, Texas",3451,579,1876,328,1575,501
1400000US48201522301,48201522301,"Census Tract 5223.01, Harris County, Texas",5745,846,2854,618,2891,741
1400000US48201522302,48201522302,"Census Tract 5223.02, Harris County, Texas",4072,600,1166,398,2906,693
1400000US48201522401,48201522401,"Census Tract 5224.01, Harris County, Texas",4674,937,2074,276,2600,867
1400000US48201522402,48201522402,"Census Tract 5224.02, Harris County, Texas",3844,517,1660,244,2184,546
1400000US48201522500,48201522500,"Census Tract 5225, Harris County, Texas",4418,126,4212,180,206,112
1400000US48201530100,48201530100,"Census Tract 5301, Harris County, Texas",6950,732,1912,401,5038,755
1400000US48201530200,48201530200,"Census Tract 5302, Harris County, Texas",3991,523,2343,343,1648,642
1400000US48201530300,48201530300,"Census Tract 5303, Harris County, Texas",2528,390,2057,387,471,198
1400000US48201530400,48201530400,"Census Tract 5304, Harris County, Texas",2478,425,1314,243,1164,455
1400000US48201530500,48201530500,"Census Tract 5305, Harris County, Texas",4718,648,2742,474,1976,487
1400000US48201530600,48201530600,"Census Tract 5306, Harris County, Texas",3121,447,1323,202,1798,426
1400000US48201530700,48201530700,"Census Tract 5307, Harris County, Texas",5650,596,1847,380,3803,604
1400000US48201530800,48201530800,"Census Tract 5308, Harris County, Texas",3585,475,3153,482,432,219
1400000US48201530900,48201530900,"Census Tract 5309, Harris County, Texas",4548,567,3153,405,1395,448
1400000US48201531000,48201531000,"Census Tract 5310, Harris County, Texas",4325,302,2706,199,1619,379
1400000US48201531100,48201531100,"Census Tract 5311, Harris County, Texas",3035,238,1742,138,1293,216
1400000US48201531200,48201531200,"Census Tract 5312, Harris County, Texas",3080,514,1946,334,1134,495
1400000US48201531300,48201531300,"Census Tract 5313, Harris County, Texas",5015,617,2483,499,2532,507
1400000US48201531400,48201531400,"Census Tract 5314, Harris County, Texas",2132,259,1285,179,847,235
1400000US48201531500,48201531500,"Census Tract 5315, Harris County, Texas",2970,270,1845,243,1125,297
1400000US48201531600,48201531600,"Census Tract 5316, Harris County, Texas",2974,330,2014,310,960,403
1400000US48201531700,48201531700,"Census Tract 5317, Harris County, Texas",2923,257,2442,233,481,196
1400000US48201531800,48201531800,"Census Tract 5318, Harris County, Texas",2260,423,1966,412,294,171
1400000US48201531900,48201531900,"Census Tract 5319, Harris County, Texas",4640,598,3703,598,937,300
1400000US48201532001,48201532001,"Census Tract 5320.01, Harris County, Texas",5285,905,4210,818,1075,387
1400000US48201532002,48201532002,"Census Tract 5320.02, Harris County, Texas",1044,95,819,319,225,341
1400000US48201532100,48201532100,"Census Tract 5321, Harris County, Texas",5748,545,2967,459,2781,520
1400000US48201532200,48201532200,"Census Tract 5322, Harris County, Texas",2762,415,2163,403,599,318
1400000US48201532300,48201532300,"Census Tract 5323, Harris County, Texas",5008,524,3223,405,1785,421
1400000US48201532400,48201532400,"Census Tract 5324, Harris County, Texas",5250,594,2919,387,2331,642
1400000US48201532501,48201532501,"Census Tract 5325.01, Harris County, Texas",8196,893,3256,302,4940,841
1400000US48201532502,48201532502,"Census Tract 5325.02, Harris County, Texas",5270,749,1189,265,4081,715
1400000US48201532600,48201532600,"Census Tract 5326, Harris County, Texas",5554,672,3086,509,2468,424
1400000US48201532700,48201532700,"Census Tract 5327, Harris County, Texas",4552,687,3407,433,1145,648
1400000US48201532800,48201532800,"Census Tract 5328, Harris County, Texas",1857,420,1115,178,742,402
1400000US48201532900,48201532900,"Census Tract 5329, Harris County, Texas",4677,458,3348,608,1329,322
1400000US48201533000,48201533000,"Census Tract 5330, Harris County, Texas",1924,454,1361,405,563,319
1400000US48201533100,48201533100,"Census Tract 5331, Harris County, Texas",6713,716,5318,725,1395,253
1400000US48201533200,48201533200,"Census Tract 5332, Harris County, Texas",3769,753,3131,582,638,397
1400000US48201533300,48201533300,"Census Tract 5333, Harris County, Texas",6433,825,5053,762,1380,454
1400000US48201533400,48201533400,"Census Tract 5334, Harris County, Texas",9290,1118,4202,742,5088,1202
1400000US48201533500,48201533500,"Census Tract 5335, Harris County, Texas",4634,424,1779,313,2855,415
1400000US48201533600,48201533600,"Census Tract 5336, Harris County, Texas",5841,505,2658,441,3183,497
1400000US48201533701,48201533701,"Census Tract 5337.01, Harris County, Texas",6141,894,1552,353,4589,884
1400000US48201533702,48201533702,"Census Tract 5337.02, Harris County, Texas",3294,471,1231,378,2063,552
1400000US48201533801,48201533801,"Census Tract 5338.01, Harris County, Texas",7005,685,2524,475,4481,639
1400000US48201533802,48201533802,"Census Tract 5338.02, Harris County, Texas",5533,654,1850,479,3683,601
1400000US48201533901,48201533901,"Census Tract 5339.01, Harris County, Texas",8884,578,4333,547,4551,565
1400000US48201533902,48201533902,"Census Tract 5339.02, Harris County, Texas",4582,650,2715,820,1867,866
1400000US48201534001,48201534001,"Census Tract 5340.01, Harris County, Texas",2003,497,929,279,1074,532
1400000US48201534002,48201534002,"Census Tract 5340.02, Harris County, Texas",5831,570,2408,448,3423,505
1400000US48201534003,48201534003,"Census Tract 5340.03, Harris County, Texas",2396,409,946,294,1450,407
1400000US48201534100,48201534100,"Census Tract 5341, Harris County, Texas",7169,480,3464,468,3705,446
1400000US48201534201,48201534201,"Census Tract 5342.01, Harris County, Texas",2229,411,1238,315,991,400
1400000US48201534202,48201534202,"Census Tract 5342.02, Harris County, Texas",7989,695,6375,518,1614,460
1400000US48201534203,48201534203,"Census Tract 5342.03, Harris County, Texas",1484,356,613,214,871,289
1400000US48201540100,48201540100,"Census Tract 5401, Harris County, Texas",10770,711,8002,600,2768,521
1400000US48201540200,48201540200,"Census Tract 5402, Harris County, Texas",2602,258,1095,255,1507,274
1400000US48201540501,48201540501,"Census Tract 5405.01, Harris County, Texas",5851,973,2270,473,3581,1080
1400000US48201540502,48201540502,"Census Tract 5405.02, Harris County, Texas",5274,441,3930,315,1344,420
1400000US48201540601,48201540601,"Census Tract 5406.01, Harris County, Texas",2760,250,2040,260,720,194
1400000US48201540602,48201540602,"Census Tract 5406.02, Harris County, Texas",6994,637,4166,454,2828,601
1400000US48201540700,48201540700,"Census Tract 5407, Harris County, Texas",7539,563,4444,447,3095,619
1400000US48201540800,48201540800,"Census Tract 5408, Harris County, Texas",7708,824,3260,369,4448,919
1400000US48201540901,48201540901,"Census Tract 5409.01, Harris County, Texas",2801,527,2708,537,93,67
1400000US48201540902,48201540902,"Census Tract 5409.02, Harris County, Texas",6783,668,5291,413,1492,615
1400000US48201541001,48201541001,"Census Tract 5410.01, Harris County, Texas",8461,640,6499,615,1962,514
1400000US48201541002,48201541002,"Census Tract 5410.02, Harris County, Texas",7551,496,5543,622,2008,641
1400000US48201541003,48201541003,"Census Tract 5410.03, Harris County, Texas",11929,614,9460,622,2469,485
1400000US48201541100,48201541100,"Census Tract 5411, Harris County, Texas",6331,341,5400,484,931,333
1400000US48201541201,48201541201,"Census Tract 5412.01, Harris County, Texas",8383,484,6681,454,1702,416
1400000US48201541202,48201541202,"Census Tract 5412.02, Harris County, Texas",8888,422,5769,396,3119,404
1400000US48201541203,48201541203,"Census Tract 5412.03, Harris County, Texas",2739,369,2513,388,226,140
1400000US48201541300,48201541300,"Census Tract 5413, Harris County, Texas",11354,774,5165,791,6189,679
1400000US48201541400,48201541400,"Census Tract 5414, Harris County, Texas",12737,839,7863,731,4874,640
1400000US48201541500,48201541500,"Census Tract 5415, Harris County, Texas",5234,422,3349,344,1885,342
1400000US48201541601,48201541601,"Census Tract 5416.01, Harris County, Texas",4314,312,3418,256,896,151
1400000US48201541602,48201541602,"Census Tract 5416.02, Harris County, Texas",10001,741,3877,495,6124,860
1400000US48201541700,48201541700,"Census Tract 5417, Harris County, Texas",8727,719,5852,722,2875,741
1400000US48201541800,48201541800,"Census Tract 5418, Harris County, Texas",5447,371,3371,317,2076,322
1400000US48201541900,48201541900,"Census Tract 5419, Harris County, Texas",6176,486,4124,476,2052,425
1400000US48201542000,48201542000,"Census Tract 5420, Harris County, Texas",13863,788,8424,744,5439,683
1400000US48201542101,48201542101,"Census Tract 5421.01, Harris County, Texas",13823,1094,7391,857,6432,824
1400000US48201542102,48201542102,"Census Tract 5421.02, Harris County, Texas",12298,745,6947,635,5351,595
1400000US48201542200,48201542200,"Census Tract 5422, Harris County, Texas",15078,1013,7900,545,7178,959
1400000US48201542301,48201542301,"Census Tract 5423.01, Harris County, Texas",12023,624,7034,457,4989,658
1400000US48201542302,48201542302,"Census Tract 5423.02, Harris County, Texas",5032,495,3385,500,1647,356
1400000US48201542400,48201542400,"Census Tract 5424, Harris County, Texas",7892,734,4274,704,3618,644
1400000US48201542500,48201542500,"Census Tract 5425, Harris County, Texas",2262,197,2065,250,197,107
1400000US48201542600,48201542600,"Census Tract 5426, Harris County, Texas",3741,494,2585,516,1156,316
1400000US48201542700,48201542700,"Census Tract 5427, Harris County, Texas",4420,345,3070,430,1350,442
1400000US48201542800,48201542800,"Census Tract 5428, Harris County, Texas",6646,334,4496,406,2150,448
1400000US48201542900,48201542900,"Census Tract 5429, Harris County, Texas",9671,797,6257,530,3414,774
1400000US48201543001,48201543001,"Census Tract 5430.01, Harris County, Texas",3948,419,2847,389,1101,260
1400000US48201543002,48201543002,"Census Tract 5430.02, Harris County, Texas",7199,529,5752,490,1447,324
1400000US48201543003,48201543003,"Census Tract 5430.03, Harris County, Texas",12812,897,7001,680,5811,893
1400000US48201543100,48201543100,"Census Tract 5431, Harris County, Texas",2085,524,1070,307,1015,541
1400000US48201543200,48201543200,"Census Tract 5432, Harris County, Texas",6040,743,4261,717,1779,534
1400000US48201550100,48201550100,"Census Tract 5501, Harris County, Texas",4576,600,2580,485,1996,507
1400000US48201550200,48201550200,"Census Tract 5502, Harris County, Texas",3208,410,2323,407,885,354
1400000US48201550301,48201550301,"Census Tract 5503.01, Harris County, Texas",7303,632,5606,677,1697,465
1400000US48201550302,48201550302,"Census Tract 5503.02, Harris County, Texas",7329,642,4973,702,2356,616
1400000US48201550401,48201550401,"Census Tract 5504.01, Harris County, Texas",8938,727,5759,667,3179,619
1400000US48201550402,48201550402,"Census Tract 5504.02, Harris County, Texas",9841,860,7417,767,2424,652
1400000US48201550500,48201550500,"Census Tract 5505, Harris County, Texas",4283,414,2212,297,2071,355
1400000US48201550601,48201550601,"Census Tract 5506.01, Harris County, Texas",7337,505,3729,477,3608,500
1400000US48201550602,48201550602,"Census Tract 5506.02, Harris County, Texas",3617,450,1832,353,1785,404
1400000US48201550603,48201550603,"Census Tract 5506.03, Harris County, Texas",5722,555,2382,421,3340,578
1400000US48201550700,48201550700,"Census Tract 5507, Harris County, Texas",2832,264,1483,237,1349,209
1400000US48201550800,48201550800,"Census Tract 5508, Harris County, Texas",2804,273,1886,261,918,283
1400000US48201550900,48201550900,"Census Tract 5509, Harris County, Texas",8755,794,3919,616,4836,889
1400000US48201551000,48201551000,"Census Tract 5510, Harris County, Texas",3000,359,1382,346,1618,420
1400000US48201551100,48201551100,"Census Tract 5511, Harris County, Texas",10129,948,5840,636,4289,927
1400000US48201551200,48201551200,"Census Tract 5512, Harris County, Texas",6041,670,4565,487,1476,634
1400000US48201551300,48201551300,"Census Tract 5513, Harris County, Texas",3841,243,2887,280,954,168
1400000US48201551400,48201551400,"Census Tract 5514, Harris County, Texas",3732,542,2698,545,1034,387
1400000US48201551500,48201551500,"Census Tract 5515, Harris County, Texas",6523,519,3929,354,2594,455
1400000US48201551600,48201551600,"Census Tract 5516, Harris County, Texas",8350,688,4465,513,3885,646
1400000US48201551701,48201551701,"Census Tract 5517.01, Harris County, Texas",8705,555,6911,601,1794,537
1400000US48201551702,48201551702,"Census Tract 5517.02, Harris County, Texas",4043,286,3752,301,291,116
1400000US48201551703,48201551703,"Census Tract 5517.03, Harris County, Texas",7702,553,5582,572,2120,423
1400000US48201551800,48201551800,"Census Tract 5518, Harris County, Texas",4461,346,4088,345,373,117
1400000US48201551900,48201551900,"Census Tract 5519, Harris County, Texas",4964,490,3522,405,1442,486
1400000US48201552001,48201552001,"Census Tract 5520.01, Harris County, Texas",8354,697,6892,653,1462,431
1400000US48201552002,48201552002,"Census Tract 5520.02, Harris County, Texas",1430,298,1259,321,171,213
1400000US48201552101,48201552101,"Census Tract 5521.01, Harris County, Texas",4398,837,3577,792,821,452
1400000US48201552102,48201552102,"Census Tract 5521.02, Harris County, Texas",6729,461,5414,548,1315,466
1400000US48201552103,48201552103,"Census Tract 5521.03, Harris County, Texas",3009,278,2173,406,836,453
1400000US48201552200,48201552200,"Census Tract 5522, Harris County, Texas",6747,463,4855,449,1892,460
1400000US48201552301,48201552301,"Census Tract 5523.01, Harris County, Texas",3824,313,3286,423,538,300
1400000US48201552302,48201552302,"Census Tract 5523.02, Harris County, Texas",4572,583,3972,496,600,332
1400000US48201552400,48201552400,"Census Tract 5524, Harris County, Texas",6096,481,4438,433,1658,460
1400000US48201552500,48201552500,"Census Tract 5525, Harris County, Texas",9957,536,6606,638,3351,507
1400000US48201552601,48201552601,"Census Tract 5526.01, Harris County, Texas",4178,536,2885,441,1293,472
1400000US48201552602,48201552602,"Census Tract 5526.02, Harris County, Texas",5296,524,4640,555,656,231
1400000US48201552700,48201552700,"Census Tract 5527, Harris County, Texas",7574,727,5852,697,1722,631
1400000US48201552800,48201552800,"Census Tract 5528, Harris County, Texas",8170,504,7204,508,966,449
1400000US48201552900,48201552900,"Census Tract 5529, Harris County, Texas",6202,439,5548,481,654,219
1400000US48201553001,48201553001,"Census Tract 5530.01, Harris County, Texas",4989,608,4070,527,919,394
1400000US48201553002,48201553002,"Census Tract 5530.02, Harris County, Texas",4239,503,3196,596,1043,463
1400000US48201553100,48201553100,"Census Tract 5531, Harris County, Texas",6774,613,4924,466,1850,457
1400000US48201553200,48201553200,"Census Tract 5532, Harris County, Texas",7408,1457,5242,1321,2166,648
1400000US48201553300,48201553300,"Census Tract 5533, Harris County, Texas",3371,611,2612,672,759,258
1400000US48201553401,48201553401,"Census Tract 5534.01, Harris County, Texas",3598,459,2853,379,745,358
1400000US48201553402,48201553402,"Census Tract 5534.02, Harris County, Texas",6621,438,5600,452,1021,179
1400000US48201553403,48201553403,"Census Tract 5534.03, Harris County, Texas",6080,532,4685,564,1395,391
1400000US48201553500,48201553500,"Census Tract 5535, Harris County, Texas",6079,495,4903,511,1176,284
1400000US48201553600,48201553600,"Census Tract 5536, Harris County, Texas",6302,489,5087,406,1215,548
1400000US48201553700,48201553700,"Census Tract 5537, Harris County, Texas",3737,271,3434,248,303,153
1400000US48201553801,48201553801,"Census Tract 5538.01, Harris County, Texas",2595,301,2196,220,399,366
1400000US48201553802,48201553802,"Census Tract 5538.02, Harris County, Texas",7085,613,5709,337,1376,555
1400000US48201553900,48201553900,"Census Tract 5539, Harris County, Texas",7837,435,7218,435,619,285
1400000US48201554001,48201554001,"Census Tract 5540.01, Harris County, Texas",3177,305,2843,314,334,128
1400000US48201554002,48201554002,"Census Tract 5540.02, Harris County, Texas",4112,316,3773,336,339,149
1400000US48201554101,48201554101,"Census Tract 5541.01, Harris County, Texas",890,181,787,170,103,166
1400000US48201554102,48201554102,"Census Tract 5541.02, Harris County, Texas",10079,663,8134,609,1945,660
1400000US48201554200,48201554200,"Census Tract 5542, Harris County, Texas",5614,591,3433,394,2181,510
1400000US48201554301,48201554301,"Census Tract 5543.01, Harris County, Texas",6964,422,6447,415,517,211
1400000US48201554302,48201554302,"Census Tract 5543.02, Harris County, Texas",4861,460,4033,583,828,439
1400000US48201554401,48201554401,"Census Tract 5544.01, Harris County, Texas",12456,826,11244,862,1212,257
1400000US48201554402,48201554402,"Census Tract 5544.02, Harris County, Texas",11975,911,10309,768,1666,480
1400000US48201554403,48201554403,"Census Tract 5544.03, Harris County, Texas",7696,455,5639,464,2057,394
1400000US48201554501,48201554501,"Census Tract 5545.01, Harris County, Texas",5043,495,3849,445,1194,482
1400000US48201554502,48201554502,"Census Tract 5545.02, Harris County, Texas",6443,295,5739,341,704,303
1400000US48201554600,48201554600,"Census Tract 5546, Harris County, Texas",4851,312,4114,380,737,522
1400000US48201554700,48201554700,"Census Tract 5547, Harris County, Texas",6733,448,5620,395,1113,469
1400000US48201554801,48201554801,"Census Tract 5548.01, Harris County, Texas",12229,670,8486,595,3743,574
1400000US48201554802,48201554802,"Census Tract 5548.02, Harris County, Texas",12863,971,10479,653,2384,774
1400000US48201554901,48201554901,"Census Tract 5549.01, Harris County, Texas",7429,748,5789,749,1640,525
1400000US48201554902,48201554902,"Census Tract 5549.02, Harris County, Texas",5936,621,4864,624,1072,475
1400000US48201554903,48201554903,"Census Tract 5549.03, Harris County, Texas",10951,570,8771,607,2180,527
1400000US48201555000,48201555000,"Census Tract 5550, Harris County, Texas",7804,489,6190,460,1614,417
1400000US48201555100,48201555100,"Census Tract 5551, Harris County, Texas",7134,443,5223,372,1911,450
1400000US48201555200,48201555200,"Census Tract 5552, Harris County, Texas",5804,409,3832,325,1972,408
1400000US48201555301,48201555301,"Census Tract 5553.01, Harris County, Texas",1295,172,1078,270,217,170
1400000US48201555302,48201555302,"Census Tract 5553.02, Harris County, Texas",6819,513,5745,497,1074,398
1400000US48201555303,48201555303,"Census Tract 5553.03, Harris County, Texas",3301,446,2612,406,689,174
1400000US48201555401,48201555401,"Census Tract 5554.01, Harris County, Texas",2396,242,1920,393,476,370
1400000US48201555402,48201555402,"Census Tract 5554.02, Harris County, Texas",8177,408,6724,561,1453,444
1400000US48201555501,48201555501,"Census Tract 5555.01, Harris County, Texas",3960,500,3381,417,579,272
1400000US48201555502,48201555502,"Census Tract 5555.02, Harris County, Texas",15076,1023,11195,631,3881,973
1400000US48201555600,48201555600,"Census Tract 5556, Harris County, Texas",4058,477,3000,316,1058,461
1400000US48201555701,48201555701,"Census Tract 5557.01, Harris County, Texas",5812,332,4921,333,891,269
1400000US48201555702,48201555702,"Census Tract 5557.02, Harris County, Texas",7918,401,7167,453,751,248
1400000US48201556000,48201556000,"Census Tract 5560, Harris County, Texas",6862,623,4518,566,2344,667
1400000US48201980000,48201980000,"Census Tract 9800, Harris County, Texas",78,85,10,15,68,76
1400000US48201980100,48201980100,"Census Tract 9801, Harris County, Texas",204,164,126,163,78,93
1400000US48203020102,48203020102,"Census Tract 201.02, Harrison County, Texas",4786,607,4385,550,401,245
1400000US48203020103,48203020103,"Census Tract 201.03, Harrison County, Texas",4353,555,4252,550,101,153
1400000US48203020104,48203020104,"Census Tract 201.04, Harrison County, Texas",3717,379,3402,347,315,275
1400000US48203020200,48203020200,"Census Tract 202, Harrison County, Texas",7023,596,6740,548,283,209
1400000US48203020301,48203020301,"Census Tract 203.01, Harrison County, Texas",4165,384,3738,427,427,269
1400000US48203020302,48203020302,"Census Tract 203.02, Harrison County, Texas",3475,531,2208,494,1267,492
1400000US48203020401,48203020401,"Census Tract 204.01, Harrison County, Texas",4725,566,3907,508,818,313
1400000US48203020402,48203020402,"Census Tract 204.02, Harrison County, Texas",5100,843,4725,802,375,171
1400000US48203020501,48203020501,"Census Tract 205.01, Harrison County, Texas",2618,580,1968,400,650,315
1400000US48203020502,48203020502,"Census Tract 205.02, Harrison County, Texas",5079,631,4455,614,624,291
1400000US48203020603,48203020603,"Census Tract 206.03, Harrison County, Texas",5820,625,5321,640,499,262
1400000US48203020604,48203020604,"Census Tract 206.04, Harrison County, Texas",4116,629,4011,636,105,94
1400000US48203020605,48203020605,"Census Tract 206.05, Harrison County, Texas",5416,496,5021,467,395,266
1400000US48203020606,48203020606,"Census Tract 206.06, Harrison County, Texas",4091,448,3939,455,152,126
1400000US48205950200,48205950200,"Census Tract 9502, Hartley County, Texas",5963,,4694,,1269,
1400000US48207950300,48207950300,"Census Tract 9503, Haskell County, Texas",3801,139,2844,166,957,99
1400000US48207950400,48207950400,"Census Tract 9504, Haskell County, Texas",2041,139,1671,166,370,99
1400000US48209010100,48209010100,"Census Tract 101, Hays County, Texas",2282,348,1698,365,584,258
1400000US48209010200,48209010200,"Census Tract 102, Hays County, Texas",6995,973,5525,794,1470,322
1400000US48209010302,48209010302,"Census Tract 103.02, Hays County, Texas",3875,479,1337,282,2538,429
1400000US48209010303,48209010303,"Census Tract 103.03, Hays County, Texas",7146,770,4426,594,2720,566
1400000US48209010304,48209010304,"Census Tract 103.04, Hays County, Texas",5211,574,2723,382,2488,505
1400000US48209010400,48209010400,"Census Tract 104, Hays County, Texas",7000,695,2701,393,4299,625
1400000US48209010500,48209010500,"Census Tract 105, Hays County, Texas",3202,330,1038,247,2164,324
1400000US48209010600,48209010600,"Census Tract 106, Hays County, Texas",8435,572,6348,544,2087,353
1400000US48209010701,48209010701,"Census Tract 107.01, Hays County, Texas",6885,728,5610,621,1275,343
1400000US48209010702,48209010702,"Census Tract 107.02, Hays County, Texas",2320,392,1946,373,374,112
1400000US48209010803,48209010803,"Census Tract 108.03, Hays County, Texas",4064,481,3729,493,335,163
1400000US48209010804,48209010804,"Census Tract 108.04, Hays County, Texas",9262,566,8647,557,615,185
1400000US48209010805,48209010805,"Census Tract 108.05, Hays County, Texas",4969,394,4557,385,412,196
1400000US48209010806,48209010806,"Census Tract 108.06, Hays County, Texas",3366,292,3115,263,251,176
1400000US48209010807,48209010807,"Census Tract 108.07, Hays County, Texas",2073,402,1602,369,471,266
1400000US48209010808,48209010808,"Census Tract 108.08, Hays County, Texas",5698,501,4364,603,1334,502
1400000US48209010809,48209010809,"Census Tract 108.09, Hays County, Texas",5288,590,4921,601,367,153
1400000US48209010901,48209010901,"Census Tract 109.01, Hays County, Texas",7780,381,6467,376,1313,306
1400000US48209010902,48209010902,"Census Tract 109.02, Hays County, Texas",8875,505,6538,450,2337,364
1400000US48209010905,48209010905,"Census Tract 109.05, Hays County, Texas",4935,518,3089,418,1846,467
1400000US48209010906,48209010906,"Census Tract 109.06, Hays County, Texas",9670,646,4125,379,5545,683
1400000US48209010907,48209010907,"Census Tract 109.07, Hays County, Texas",9627,870,2922,435,6705,830
1400000US48209010908,48209010908,"Census Tract 109.08, Hays County, Texas",5494,628,2207,406,3287,724
1400000US48209010909,48209010909,"Census Tract 109.09, Hays County, Texas",4199,358,3050,307,1149,272
1400000US48209010910,48209010910,"Census Tract 109.10, Hays County, Texas",7788,630,3722,423,4066,550
1400000US48211950300,48211950300,"Census Tract 9503, Hemphill County, Texas",3668,,2860,191,808,191
1400000US48213950100,48213950100,"Census Tract 9501, Henderson County, Texas",7149,661,6753,738,396,281
1400000US48213950200,48213950200,"Census Tract 9502, Henderson County, Texas",4841,521,4434,518,407,171
1400000US48213950300,48213950300,"Census Tract 9503, Henderson County, Texas",7529,749,6680,706,849,428
1400000US48213950400,48213950400,"Census Tract 9504, Henderson County, Texas",4694,563,4073,484,621,417
1400000US48213950500,48213950500,"Census Tract 9505, Henderson County, Texas",2609,360,2529,361,80,78
1400000US48213950601,48213950601,"Census Tract 9506.01, Henderson County, Texas",3217,567,2927,548,290,176
1400000US48213950602,48213950602,"Census Tract 9506.02, Henderson County, Texas",5231,441,5096,421,135,103
1400000US48213950700,48213950700,"Census Tract 9507, Henderson County, Texas",4169,434,3865,387,304,159
1400000US48213950800,48213950800,"Census Tract 9508, Henderson County, Texas",5026,607,4588,547,438,325
1400000US48213950901,48213950901,"Census Tract 9509.01, Henderson County, Texas",4580,518,4369,533,211,128
1400000US48213950902,48213950902,"Census Tract 9509.02, Henderson County, Texas",1794,212,1746,210,48,39
1400000US48213950903,48213950903,"Census Tract 9509.03, Henderson County, Texas",2581,311,2477,307,104,106
1400000US48213951000,48213951000,"Census Tract 9510, Henderson County, Texas",2047,289,1708,284,339,171
1400000US48213951100,48213951100,"Census Tract 9511, Henderson County, Texas",4242,468,3871,472,371,221
1400000US48213951200,48213951200,"Census Tract 9512, Henderson County, Texas",6277,573,3787,533,2490,490
1400000US48213951300,48213951300,"Census Tract 9513, Henderson County, Texas",5909,666,5166,564,743,514
1400000US48213951400,48213951400,"Census Tract 9514, Henderson County, Texas",6404,626,6281,619,123,108
1400000US48215020101,48215020101,"Census Tract 201.01, Hidalgo County, Texas",5476,661,225,128,5251,671
1400000US48215020102,48215020102,"Census Tract 201.02, Hidalgo County, Texas",7164,1125,1091,270,6073,1075
1400000US48215020201,48215020201,"Census Tract 202.01, Hidalgo County, Texas",7274,692,218,115,7056,699
1400000US48215020202,48215020202,"Census Tract 202.02, Hidalgo County, Texas",7777,620,204,92,7573,628
1400000US48215020204,48215020204,"Census Tract 202.04, Hidalgo County, Texas",6673,732,963,281,5710,759
1400000US48215020205,48215020205,"Census Tract 202.05, Hidalgo County, Texas",5497,830,228,133,5269,840
1400000US48215020301,48215020301,"Census Tract 203.01, Hidalgo County, Texas",9970,977,2196,462,7774,1006
1400000US48215020302,48215020302,"Census Tract 203.02, Hidalgo County, Texas",8992,774,1184,292,7808,689
1400000US48215020402,48215020402,"Census Tract 204.02, Hidalgo County, Texas",7173,711,2033,394,5140,686
1400000US48215020403,48215020403,"Census Tract 204.03, Hidalgo County, Texas",5986,766,333,212,5653,784
1400000US48215020404,48215020404,"Census Tract 204.04, Hidalgo County, Texas",4697,516,2112,257,2585,527
1400000US48215020501,48215020501,"Census Tract 205.01, Hidalgo County, Texas",4958,748,257,116,4701,738
1400000US48215020503,48215020503,"Census Tract 205.03, Hidalgo County, Texas",9765,775,208,126,9557,788
1400000US48215020504,48215020504,"Census Tract 205.04, Hidalgo County, Texas",6422,663,226,107,6196,661
1400000US48215020600,48215020600,"Census Tract 206, Hidalgo County, Texas",3201,494,13,15,3188,492
1400000US48215020701,48215020701,"Census Tract 207.01, Hidalgo County, Texas",8753,597,1295,340,7458,685
1400000US48215020721,48215020721,"Census Tract 207.21, Hidalgo County, Texas",8056,703,1004,266,7052,729
1400000US48215020723,48215020723,"Census Tract 207.23, Hidalgo County, Texas",5512,633,183,126,5329,645
1400000US48215020724,48215020724,"Census Tract 207.24, Hidalgo County, Texas",3790,382,726,216,3064,344
1400000US48215020725,48215020725,"Census Tract 207.25, Hidalgo County, Texas",4323,475,322,245,4001,507
1400000US48215020726,48215020726,"Census Tract 207.26, Hidalgo County, Texas",5740,718,1116,363,4624,707
1400000US48215020802,48215020802,"Census Tract 208.02, Hidalgo County, Texas",6580,752,1278,351,5302,709
1400000US48215020803,48215020803,"Census Tract 208.03, Hidalgo County, Texas",5529,549,1638,489,3891,504
1400000US48215020804,48215020804,"Census Tract 208.04, Hidalgo County, Texas",3408,511,1062,249,2346,452
1400000US48215020901,48215020901,"Census Tract 209.01, Hidalgo County, Texas",5092,676,1854,340,3238,643
1400000US48215020903,48215020903,"Census Tract 209.03, Hidalgo County, Texas",4579,566,987,315,3592,551
1400000US48215020904,48215020904,"Census Tract 209.04, Hidalgo County, Texas",4428,471,1258,284,3170,529
1400000US48215021000,48215021000,"Census Tract 210, Hidalgo County, Texas",7136,860,899,337,6237,873
1400000US48215021100,48215021100,"Census Tract 211, Hidalgo County, Texas",2721,655,167,84,2554,644
1400000US48215021201,48215021201,"Census Tract 212.01, Hidalgo County, Texas",3088,566,821,258,2267,575
1400000US48215021202,48215021202,"Census Tract 212.02, Hidalgo County, Texas",4067,582,1126,238,2941,579
1400000US48215021302,48215021302,"Census Tract 213.02, Hidalgo County, Texas",15068,1091,264,222,14804,1106
1400000US48215021303,48215021303,"Census Tract 213.03, Hidalgo County, Texas",8202,887,139,168,8063,910
1400000US48215021304,48215021304,"Census Tract 213.04, Hidalgo County, Texas",5753,537,141,106,5612,549
1400000US48215021305,48215021305,"Census Tract 213.05, Hidalgo County, Texas",6594,569,26,43,6568,569
1400000US48215021401,48215021401,"Census Tract 214.01, Hidalgo County, Texas",5148,662,252,125,4896,675
1400000US48215021403,48215021403,"Census Tract 214.03, Hidalgo County, Texas",4181,537,462,225,3719,498
1400000US48215021404,48215021404,"Census Tract 214.04, Hidalgo County, Texas",6652,816,1709,253,4943,864
1400000US48215021500,48215021500,"Census Tract 215, Hidalgo County, Texas",3527,441,14,23,3513,442
1400000US48215021600,48215021600,"Census Tract 216, Hidalgo County, Texas",3821,558,77,72,3744,541
1400000US48215021701,48215021701,"Census Tract 217.01, Hidalgo County, Texas",8542,824,924,338,7618,856
1400000US48215021702,48215021702,"Census Tract 217.02, Hidalgo County, Texas",11713,1122,636,225,11077,1154
1400000US48215021803,48215021803,"Census Tract 218.03, Hidalgo County, Texas",4217,535,103,82,4114,535
1400000US48215021804,48215021804,"Census Tract 218.04, Hidalgo County, Texas",5512,712,354,448,5158,701
1400000US48215021805,48215021805,"Census Tract 218.05, Hidalgo County, Texas",8755,722,123,156,8632,739
1400000US48215021806,48215021806,"Census Tract 218.06, Hidalgo County, Texas",8557,1011,136,91,8421,1022
1400000US48215021901,48215021901,"Census Tract 219.01, Hidalgo County, Texas",10042,1114,1547,300,8495,1121
1400000US48215021903,48215021903,"Census Tract 219.03, Hidalgo County, Texas",3669,671,316,225,3353,711
1400000US48215021904,48215021904,"Census Tract 219.04, Hidalgo County, Texas",4360,669,916,259,3444,669
1400000US48215022001,48215022001,"Census Tract 220.01, Hidalgo County, Texas",10105,811,690,271,9415,837
1400000US48215022003,48215022003,"Census Tract 220.03, Hidalgo County, Texas",6481,849,1320,436,5161,772
1400000US48215022004,48215022004,"Census Tract 220.04, Hidalgo County, Texas",10576,1286,1331,285,9245,1328
1400000US48215022103,48215022103,"Census Tract 221.03, Hidalgo County, Texas",4467,509,987,311,3480,536
1400000US48215022104,48215022104,"Census Tract 221.04, Hidalgo County, Texas",8182,1116,133,94,8049,1118
1400000US48215022105,48215022105,"Census Tract 221.05, Hidalgo County, Texas",4943,927,300,327,4643,991
1400000US48215022106,48215022106,"Census Tract 221.06, Hidalgo County, Texas",4998,821,434,193,4564,842
1400000US48215022201,48215022201,"Census Tract 222.01, Hidalgo County, Texas",6864,984,964,239,5900,1028
1400000US48215022203,48215022203,"Census Tract 222.03, Hidalgo County, Texas",3803,541,206,121,3597,542
1400000US48215022204,48215022204,"Census Tract 222.04, Hidalgo County, Texas",5116,696,103,106,5013,694
1400000US48215022300,48215022300,"Census Tract 223, Hidalgo County, Texas",9798,752,3337,605,6461,718
1400000US48215022401,48215022401,"Census Tract 224.01, Hidalgo County, Texas",4670,690,371,195,4299,689
1400000US48215022402,48215022402,"Census Tract 224.02, Hidalgo County, Texas",5499,654,131,109,5368,660
1400000US48215022501,48215022501,"Census Tract 225.01, Hidalgo County, Texas",6464,785,156,161,6308,716
1400000US48215022502,48215022502,"Census Tract 225.02, Hidalgo County, Texas",5398,597,437,146,4961,585
1400000US48215022600,48215022600,"Census Tract 226, Hidalgo County, Texas",2472,463,45,44,2427,465
1400000US48215022701,48215022701,"Census Tract 227.01, Hidalgo County, Texas",5326,659,1909,354,3417,577
1400000US48215022702,48215022702,"Census Tract 227.02, Hidalgo County, Texas",5478,760,1210,276,4268,734
1400000US48215022800,48215022800,"Census Tract 228, Hidalgo County, Texas",7478,564,224,100,7254,552
1400000US48215022900,48215022900,"Census Tract 229, Hidalgo County, Texas",4670,561,657,161,4013,542
1400000US48215023000,48215023000,"Census Tract 230, Hidalgo County, Texas",3795,434,206,98,3589,434
1400000US48215023102,48215023102,"Census Tract 231.02, Hidalgo County, Texas",7084,891,186,119,6898,914
1400000US48215023103,48215023103,"Census Tract 231.03, Hidalgo County, Texas",6018,842,212,146,5806,813
1400000US48215023104,48215023104,"Census Tract 231.04, Hidalgo County, Texas",5241,763,173,140,5068,791
1400000US48215023503,48215023503,"Census Tract 235.03, Hidalgo County, Texas",7287,771,218,131,7069,752
1400000US48215023504,48215023504,"Census Tract 235.04, Hidalgo County, Texas",7925,766,904,251,7021,794
1400000US48215023507,48215023507,"Census Tract 235.07, Hidalgo County, Texas",8842,1075,339,221,8503,1020
1400000US48215023509,48215023509,"Census Tract 235.09, Hidalgo County, Texas",8974,805,2511,582,6463,528
1400000US48215023510,48215023510,"Census Tract 235.10, Hidalgo County, Texas",9446,887,2787,351,6659,861
1400000US48215023511,48215023511,"Census Tract 235.11, Hidalgo County, Texas",6653,931,160,130,6493,962
1400000US48215023512,48215023512,"Census Tract 235.12, Hidalgo County, Texas",2915,235,1362,162,1553,159
1400000US48215023513,48215023513,"Census Tract 235.13, Hidalgo County, Texas",6147,1080,237,128,5910,1097
1400000US48215023514,48215023514,"Census Tract 235.14, Hidalgo County, Texas",8111,1071,273,163,7838,1056
1400000US48215023515,48215023515,"Census Tract 235.15, Hidalgo County, Texas",8801,918,111,107,8690,917
1400000US48215023600,48215023600,"Census Tract 236, Hidalgo County, Texas",8073,710,407,176,7666,669
1400000US48215023700,48215023700,"Census Tract 237, Hidalgo County, Texas",4705,529,307,164,4398,544
1400000US48215023801,48215023801,"Census Tract 238.01, Hidalgo County, Texas",8745,1008,491,222,8254,1022
1400000US48215023802,48215023802,"Census Tract 238.02, Hidalgo County, Texas",8140,790,1226,366,6914,729
1400000US48215023902,48215023902,"Census Tract 239.02, Hidalgo County, Texas",10557,732,1922,319,8635,792
1400000US48215023903,48215023903,"Census Tract 239.03, Hidalgo County, Texas",4402,615,308,112,4094,637
1400000US48215023904,48215023904,"Census Tract 239.04, Hidalgo County, Texas",6507,707,872,270,5635,720
1400000US48215024000,48215024000,"Census Tract 240, Hidalgo County, Texas",15579,995,1605,424,13974,1010
1400000US48215024105,48215024105,"Census Tract 241.05, Hidalgo County, Texas",9841,1057,648,287,9193,1123
1400000US48215024106,48215024106,"Census Tract 241.06, Hidalgo County, Texas",11465,1263,1239,380,10226,1159
1400000US48215024107,48215024107,"Census Tract 241.07, Hidalgo County, Texas",5700,772,277,130,5423,780
1400000US48215024108,48215024108,"Census Tract 241.08, Hidalgo County, Texas",5674,779,43,49,5631,776
1400000US48215024109,48215024109,"Census Tract 241.09, Hidalgo County, Texas",6625,1102,21,33,6604,1103
1400000US48215024110,48215024110,"Census Tract 241.10, Hidalgo County, Texas",8930,975,246,264,8684,992
1400000US48215024111,48215024111,"Census Tract 241.11, Hidalgo County, Texas",5825,869,173,112,5652,875
1400000US48215024112,48215024112,"Census Tract 241.12, Hidalgo County, Texas",10534,1450,181,154,10353,1471
1400000US48215024113,48215024113,"Census Tract 241.13, Hidalgo County, Texas",7673,1214,173,189,7500,1210
1400000US48215024114,48215024114,"Census Tract 241.14, Hidalgo County, Texas",8609,1373,37,86,8572,1386
1400000US48215024201,48215024201,"Census Tract 242.01, Hidalgo County, Texas",13924,1131,26,43,13898,1132
1400000US48215024203,48215024203,"Census Tract 242.03, Hidalgo County, Texas",4379,672,964,251,3415,606
1400000US48215024204,48215024204,"Census Tract 242.04, Hidalgo County, Texas",4133,745,170,88,3963,741
1400000US48215024205,48215024205,"Census Tract 242.05, Hidalgo County, Texas",7873,793,58,46,7815,791
1400000US48215024301,48215024301,"Census Tract 243.01, Hidalgo County, Texas",1002,474,116,88,886,475
1400000US48215024302,48215024302,"Census Tract 243.02, Hidalgo County, Texas",1277,292,365,88,912,285
1400000US48215024402,48215024402,"Census Tract 244.02, Hidalgo County, Texas",8120,935,125,92,7995,948
1400000US48215024403,48215024403,"Census Tract 244.03, Hidalgo County, Texas",4847,611,0,127,4847,611
1400000US48215024404,48215024404,"Census Tract 244.04, Hidalgo County, Texas",2985,584,0,127,2985,584
1400000US48215024500,48215024500,"Census Tract 245, Hidalgo County, Texas",7111,811,166,131,6945,815
1400000US48215024600,48215024600,"Census Tract 246, Hidalgo County, Texas",5571,514,50,27,5521,519
1400000US48215980000,48215980000,"Census Tract 9800, Hidalgo County, Texas",0,127,0,127,0,127
1400000US48217960100,48217960100,"Census Tract 9601, Hill County, Texas",4021,348,3214,318,807,206
1400000US48217960200,48217960200,"Census Tract 9602, Hill County, Texas",4339,394,4277,387,62,40
1400000US48217960400,48217960400,"Census Tract 9604, Hill County, Texas",1748,295,1688,287,60,44
1400000US48217960500,48217960500,"Census Tract 9605, Hill County, Texas",5620,464,5187,476,433,257
1400000US48217960600,48217960600,"Census Tract 9606, Hill County, Texas",1453,225,1173,227,280,102
1400000US48217960700,48217960700,"Census Tract 9607, Hill County, Texas",2107,240,1765,242,342,178
1400000US48217960800,48217960800,"Census Tract 9608, Hill County, Texas",3196,365,2682,352,514,187
1400000US48217960900,48217960900,"Census Tract 9609, Hill County, Texas",2563,286,503,209,2060,259
1400000US48217961000,48217961000,"Census Tract 9610, Hill County, Texas",1851,332,1250,280,601,207
1400000US48217961100,48217961100,"Census Tract 9611, Hill County, Texas",3830,542,3231,459,599,223
1400000US48217961400,48217961400,"Census Tract 9614, Hill County, Texas",4126,340,3758,335,368,127
1400000US48219950100,48219950100,"Census Tract 9501, Hockley County, Texas",1506,190,825,145,681,182
1400000US48219950200,48219950200,"Census Tract 9502, Hockley County, Texas",4223,333,3073,309,1150,220
1400000US48219950300,48219950300,"Census Tract 9503, Hockley County, Texas",4226,366,2585,329,1641,365
1400000US48219950400,48219950400,"Census Tract 9504, Hockley County, Texas",4568,470,1351,257,3217,389
1400000US48219950500,48219950500,"Census Tract 9505, Hockley County, Texas",5123,477,3625,463,1498,343
1400000US48219950600,48219950600,"Census Tract 9506, Hockley County, Texas",1688,210,1045,139,643,168
1400000US48219950700,48219950700,"Census Tract 9507, Hockley County, Texas",1599,226,778,151,821,224
1400000US48221160100,48221160100,"Census Tract 1601, Hood County, Texas",4619,400,4199,423,420,277
1400000US48221160204,48221160204,"Census Tract 1602.04, Hood County, Texas",3119,335,3057,348,62,59
1400000US48221160205,48221160205,"Census Tract 1602.05, Hood County, Texas",6384,675,5568,683,816,339
1400000US48221160206,48221160206,"Census Tract 1602.06, Hood County, Texas",3853,392,3494,366,359,229
1400000US48221160207,48221160207,"Census Tract 1602.07, Hood County, Texas",5647,431,5429,417,218,108
1400000US48221160208,48221160208,"Census Tract 1602.08, Hood County, Texas",5007,410,3937,360,1070,304
1400000US48221160209,48221160209,"Census Tract 1602.09, Hood County, Texas",6819,542,6139,511,680,377
1400000US48221160210,48221160210,"Census Tract 1602.10, Hood County, Texas",4915,266,4700,301,215,196
1400000US48221160301,48221160301,"Census Tract 1603.01, Hood County, Texas",5540,422,4818,424,722,223
1400000US48221160302,48221160302,"Census Tract 1603.02, Hood County, Texas",3913,377,3611,390,302,126
1400000US48223950100,48223950100,"Census Tract 9501, Hopkins County, Texas",3195,270,3008,251,187,110
1400000US48223950200,48223950200,"Census Tract 9502, Hopkins County, Texas",4116,387,3905,387,211,119
1400000US48223950300,48223950300,"Census Tract 9503, Hopkins County, Texas",5500,482,4294,438,1206,383
1400000US48223950401,48223950401,"Census Tract 9504.01, Hopkins County, Texas",3909,363,3214,368,695,415
1400000US48223950402,48223950402,"Census Tract 9504.02, Hopkins County, Texas",4031,393,3460,415,571,300
1400000US48223950500,48223950500,"Census Tract 9505, Hopkins County, Texas",3211,476,2893,430,318,170
1400000US48223950600,48223950600,"Census Tract 9506, Hopkins County, Texas",3673,392,3248,405,425,242
1400000US48223950700,48223950700,"Census Tract 9507, Hopkins County, Texas",4460,397,3575,340,885,350
1400000US48223950800,48223950800,"Census Tract 9508, Hopkins County, Texas",2445,384,2060,318,385,248
1400000US48225950100,48225950100,"Census Tract 9501, Houston County, Texas",6079,647,5899,636,180,138
1400000US48225950200,48225950200,"Census Tract 9502, Houston County, Texas",1825,311,1613,268,212,207
1400000US48225950300,48225950300,"Census Tract 9503, Houston County, Texas",2629,447,2297,441,332,215
1400000US48225950400,48225950400,"Census Tract 9504, Houston County, Texas",4047,455,3065,395,982,351
1400000US48225950500,48225950500,"Census Tract 9505, Houston County, Texas",4568,699,4299,674,269,213
1400000US48225950600,48225950600,"Census Tract 9506, Houston County, Texas",1668,340,1490,251,178,208
1400000US48225950700,48225950700,"Census Tract 9507, Houston County, Texas",2826,451,2765,457,61,45
1400000US48227950100,48227950100,"Census Tract 9501, Howard County, Texas",2420,262,1900,281,520,171
1400000US48227950200,48227950200,"Census Tract 9502, Howard County, Texas",1861,237,1383,265,478,137
1400000US48227950300,48227950300,"Census Tract 9503, Howard County, Texas",1916,429,644,266,1272,348
1400000US48227950400,48227950400,"Census Tract 9504, Howard County, Texas",3252,411,2511,377,741,268
1400000US48227950500,48227950500,"Census Tract 9505, Howard County, Texas",3193,492,1475,400,1718,379
1400000US48227950600,48227950600,"Census Tract 9506, Howard County, Texas",3942,362,3165,365,777,164
1400000US48227950700,48227950700,"Census Tract 9507, Howard County, Texas",3204,348,2144,353,1060,256
1400000US48227950801,48227950801,"Census Tract 9508.01, Howard County, Texas",4575,464,3123,459,1452,339
1400000US48227950802,48227950802,"Census Tract 9508.02, Howard County, Texas",6360,449,1961,333,4399,348
1400000US48227950900,48227950900,"Census Tract 9509, Howard County, Texas",3562,271,3065,301,497,161
1400000US48229950300,48229950300,"Census Tract 9503, Hudspeth County, Texas",3441,,721,171,2720,171
1400000US48231960100,48231960100,"Census Tract 9601, Hunt County, Texas",2836,461,2674,421,162,152
1400000US48231960200,48231960200,"Census Tract 9602, Hunt County, Texas",2660,341,2352,233,308,297
1400000US48231960300,48231960300,"Census Tract 9603, Hunt County, Texas",4031,305,3870,290,161,194
1400000US48231960400,48231960400,"Census Tract 9604, Hunt County, Texas",4799,530,3793,509,1006,336
1400000US48231960500,48231960500,"Census Tract 9605, Hunt County, Texas",3961,421,3585,480,376,259
1400000US48231960600,48231960600,"Census Tract 9606, Hunt County, Texas",3621,442,3456,428,165,135
1400000US48231960700,48231960700,"Census Tract 9607, Hunt County, Texas",5436,530,4973,487,463,229
1400000US48231960800,48231960800,"Census Tract 9608, Hunt County, Texas",4341,538,2229,429,2112,430
1400000US48231960900,48231960900,"Census Tract 9609, Hunt County, Texas",4649,854,3254,848,1395,401
1400000US48231961000,48231961000,"Census Tract 9610, Hunt County, Texas",4458,520,3402,410,1056,345
1400000US48231961100,48231961100,"Census Tract 9611, Hunt County, Texas",6313,578,5713,574,600,296
1400000US48231961200,48231961200,"Census Tract 9612, Hunt County, Texas",4095,421,3965,423,130,91
1400000US48231961300,48231961300,"Census Tract 9613, Hunt County, Texas",6103,681,5637,678,466,142
1400000US48231961400,48231961400,"Census Tract 9614, Hunt County, Texas",6757,385,5864,448,893,312
1400000US48231961501,48231961501,"Census Tract 9615.01, Hunt County, Texas",2937,317,2793,362,144,143
1400000US48231961502,48231961502,"Census Tract 9615.02, Hunt County, Texas",4226,508,3630,572,596,346
1400000US48231961503,48231961503,"Census Tract 9615.03, Hunt County, Texas",4502,357,4003,390,499,297
1400000US48231961600,48231961600,"Census Tract 9616, Hunt County, Texas",6185,547,5857,535,328,145
1400000US48231961700,48231961700,"Census Tract 9617, Hunt County, Texas",2926,449,2850,439,76,60
1400000US48233950200,48233950200,"Census Tract 9502, Hutchinson County, Texas",2512,260,2335,260,177,85
1400000US48233950500,48233950500,"Census Tract 9505, Hutchinson County, Texas",5150,366,4705,445,445,244
1400000US48233950600,48233950600,"Census Tract 9506, Hutchinson County, Texas",3865,406,2469,430,1396,337
1400000US48233950700,48233950700,"Census Tract 9507, Hutchinson County, Texas",1870,320,1067,344,803,304
1400000US48233950800,48233950800,"Census Tract 9508, Hutchinson County, Texas",855,330,546,273,309,136
1400000US48233950900,48233950900,"Census Tract 9509, Hutchinson County, Texas",4440,467,3702,426,738,196
1400000US48233951000,48233951000,"Census Tract 9510, Hutchinson County, Texas",3402,453,3139,407,263,185
1400000US48235950100,48235950100,"Census Tract 9501, Irion County, Texas",1673,235,1311,207,362,120
1400000US48237950100,48237950100,"Census Tract 9501, Jack County, Texas",2549,265,2244,261,305,99
1400000US48237950300,48237950300,"Census Tract 9503, Jack County, Texas",3237,211,2692,237,545,172
1400000US48237950500,48237950500,"Census Tract 9505, Jack County, Texas",3286,273,3002,293,284,140
1400000US48239950100,48239950100,"Census Tract 9501, Jackson County, Texas",5002,394,3618,379,1384,311
1400000US48239950200,48239950200,"Census Tract 9502, Jackson County, Texas",3782,458,2552,303,1230,336
1400000US48239950300,48239950300,"Census Tract 9503, Jackson County, Texas",5203,486,3929,400,1274,311
1400000US48241950100,48241950100,"Census Tract 9501, Jasper County, Texas",5691,496,5606,507,85,59
1400000US48241950200,48241950200,"Census Tract 9502, Jasper County, Texas",3722,333,3551,362,171,138
1400000US48241950300,48241950300,"Census Tract 9503, Jasper County, Texas",3387,379,2700,403,687,228
1400000US48241950400,48241950400,"Census Tract 9504, Jasper County, Texas",5085,560,4614,511,471,183
1400000US48241950500,48241950500,"Census Tract 9505, Jasper County, Texas",5024,536,4948,519,76,88
1400000US48241950600,48241950600,"Census Tract 9506, Jasper County, Texas",2335,331,2157,336,178,97
1400000US48241950700,48241950700,"Census Tract 9507, Jasper County, Texas",7615,611,7438,635,177,119
1400000US48241950800,48241950800,"Census Tract 9508, Jasper County, Texas",2389,357,2349,353,40,33
1400000US48243950100,48243950100,"Census Tract 9501, Jeff Davis County, Texas",2340,31,1509,121,831,109
1400000US48245000101,48245000101,"Census Tract 1.01, Jefferson County, Texas",5078,440,4755,391,323,187
1400000US48245000102,48245000102,"Census Tract 1.02, Jefferson County, Texas",1591,261,1534,250,57,60
1400000US48245000103,48245000103,"Census Tract 1.03, Jefferson County, Texas",3203,459,3141,431,62,99
1400000US48245000200,48245000200,"Census Tract 2, Jefferson County, Texas",4664,372,4442,377,222,159
1400000US48245000302,48245000302,"Census Tract 3.02, Jefferson County, Texas",6875,481,6613,494,262,181
1400000US48245000304,48245000304,"Census Tract 3.04, Jefferson County, Texas",6415,610,5285,505,1130,402
1400000US48245000306,48245000306,"Census Tract 3.06, Jefferson County, Texas",4363,276,4064,331,299,181
1400000US48245000307,48245000307,"Census Tract 3.07, Jefferson County, Texas",2747,406,2514,369,233,140
1400000US48245000308,48245000308,"Census Tract 3.08, Jefferson County, Texas",5642,474,4996,429,646,359
1400000US48245000309,48245000309,"Census Tract 3.09, Jefferson County, Texas",2370,193,2305,202,65,82
1400000US48245000310,48245000310,"Census Tract 3.10, Jefferson County, Texas",5011,523,4425,544,586,413
1400000US48245000400,48245000400,"Census Tract 4, Jefferson County, Texas",5258,466,5076,498,182,124
1400000US48245000500,48245000500,"Census Tract 5, Jefferson County, Texas",2031,359,1541,187,490,352
1400000US48245000600,48245000600,"Census Tract 6, Jefferson County, Texas",7128,727,5808,756,1320,530
1400000US48245000700,48245000700,"Census Tract 7, Jefferson County, Texas",2822,509,2816,517,6,53
1400000US48245000900,48245000900,"Census Tract 9, Jefferson County, Texas",1787,263,1640,233,147,163
1400000US48245001100,48245001100,"Census Tract 11, Jefferson County, Texas",2511,320,2066,318,445,211
1400000US48245001200,48245001200,"Census Tract 12, Jefferson County, Texas",2251,346,1545,302,706,264
1400000US48245001301,48245001301,"Census Tract 13.01, Jefferson County, Texas",5253,413,4749,474,504,257
1400000US48245001302,48245001302,"Census Tract 13.02, Jefferson County, Texas",2869,334,2520,326,349,145
1400000US48245001303,48245001303,"Census Tract 13.03, Jefferson County, Texas",3021,352,2644,364,377,250
1400000US48245001700,48245001700,"Census Tract 17, Jefferson County, Texas",1815,253,1762,247,53,49
1400000US48245001900,48245001900,"Census Tract 19, Jefferson County, Texas",3069,354,1942,395,1127,374
1400000US48245002000,48245002000,"Census Tract 20, Jefferson County, Texas",2446,420,1571,260,875,342
1400000US48245002100,48245002100,"Census Tract 21, Jefferson County, Texas",3581,550,3020,444,561,298
1400000US48245002200,48245002200,"Census Tract 22, Jefferson County, Texas",2758,264,2758,264,0,127
1400000US48245002300,48245002300,"Census Tract 23, Jefferson County, Texas",3043,395,2996,386,47,55
1400000US48245002400,48245002400,"Census Tract 24, Jefferson County, Texas",2595,347,2112,315,483,244
1400000US48245002500,48245002500,"Census Tract 25, Jefferson County, Texas",3964,543,3382,468,582,306
1400000US48245002600,48245002600,"Census Tract 26, Jefferson County, Texas",6345,1895,5803,1715,542,252
1400000US48245005100,48245005100,"Census Tract 51, Jefferson County, Texas",1153,206,1153,206,0,127
1400000US48245005400,48245005400,"Census Tract 54, Jefferson County, Texas",1454,303,1243,294,211,197
1400000US48245005500,48245005500,"Census Tract 55, Jefferson County, Texas",2344,335,1778,312,566,242
1400000US48245005600,48245005600,"Census Tract 56, Jefferson County, Texas",4078,469,2064,322,2014,434
1400000US48245005900,48245005900,"Census Tract 59, Jefferson County, Texas",1657,305,1642,309,15,18
1400000US48245006100,48245006100,"Census Tract 61, Jefferson County, Texas",1406,262,1179,310,227,239
1400000US48245006300,48245006300,"Census Tract 63, Jefferson County, Texas",2100,336,1958,300,142,179
1400000US48245006400,48245006400,"Census Tract 64, Jefferson County, Texas",1350,388,984,326,366,263
1400000US48245006500,48245006500,"Census Tract 65, Jefferson County, Texas",3387,397,2114,256,1273,386
1400000US48245006600,48245006600,"Census Tract 66, Jefferson County, Texas",4419,593,2968,413,1451,498
1400000US48245006700,48245006700,"Census Tract 67, Jefferson County, Texas",3076,429,1402,245,1674,324
1400000US48245006800,48245006800,"Census Tract 68, Jefferson County, Texas",1557,369,868,314,689,199
1400000US48245006900,48245006900,"Census Tract 69, Jefferson County, Texas",2903,294,2892,293,11,18
1400000US48245007001,48245007001,"Census Tract 70.01, Jefferson County, Texas",5012,508,4135,539,877,395
1400000US48245007002,48245007002,"Census Tract 70.02, Jefferson County, Texas",3999,353,3693,358,306,152
1400000US48245007100,48245007100,"Census Tract 71, Jefferson County, Texas",3327,319,2717,265,610,158
1400000US48245010100,48245010100,"Census Tract 101, Jefferson County, Texas",2928,317,1290,342,1638,397
1400000US48245010200,48245010200,"Census Tract 102, Jefferson County, Texas",1680,274,1333,313,347,114
1400000US48245010300,48245010300,"Census Tract 103, Jefferson County, Texas",3285,369,1609,238,1676,377
1400000US48245010400,48245010400,"Census Tract 104, Jefferson County, Texas",3118,267,2967,275,151,83
1400000US48245010500,48245010500,"Census Tract 105, Jefferson County, Texas",3882,414,2860,445,1022,300
1400000US48245010600,48245010600,"Census Tract 106, Jefferson County, Texas",5904,400,5075,495,829,301
1400000US48245010700,48245010700,"Census Tract 107, Jefferson County, Texas",3030,264,2820,273,210,134
1400000US48245010800,48245010800,"Census Tract 108, Jefferson County, Texas",4626,324,4372,320,254,154
1400000US48245010901,48245010901,"Census Tract 109.01, Jefferson County, Texas",3495,285,3241,274,254,156
1400000US48245010902,48245010902,"Census Tract 109.02, Jefferson County, Texas",4900,295,4404,358,496,323
1400000US48245011001,48245011001,"Census Tract 110.01, Jefferson County, Texas",5399,424,4870,403,529,301
1400000US48245011002,48245011002,"Census Tract 110.02, Jefferson County, Texas",3813,331,3398,318,415,237
1400000US48245011101,48245011101,"Census Tract 111.01, Jefferson County, Texas",4557,292,3950,270,607,218
1400000US48245011102,48245011102,"Census Tract 111.02, Jefferson County, Texas",2810,259,2594,277,216,181
1400000US48245011201,48245011201,"Census Tract 112.01, Jefferson County, Texas",8565,1234,7473,1060,1092,540
1400000US48245011202,48245011202,"Census Tract 112.02, Jefferson County, Texas",3688,303,2618,288,1070,151
1400000US48245011203,48245011203,"Census Tract 112.03, Jefferson County, Texas",3373,629,2439,277,934,448
1400000US48245011302,48245011302,"Census Tract 113.02, Jefferson County, Texas",3998,377,2518,255,1480,185
1400000US48245011303,48245011303,"Census Tract 113.03, Jefferson County, Texas",2513,252,2283,286,230,111
1400000US48245011304,48245011304,"Census Tract 113.04, Jefferson County, Texas",3544,378,3315,326,229,177
1400000US48245011400,48245011400,"Census Tract 114, Jefferson County, Texas",6911,581,6347,510,564,218
1400000US48245011500,48245011500,"Census Tract 115, Jefferson County, Texas",1905,232,1809,224,96,78
1400000US48245011600,48245011600,"Census Tract 116, Jefferson County, Texas",1922,316,1641,235,281,266
1400000US48245011700,48245011700,"Census Tract 117, Jefferson County, Texas",1631,449,580,187,1051,454
1400000US48245011800,48245011800,"Census Tract 118, Jefferson County, Texas",2090,334,1963,321,127,132
1400000US48245980000,48245980000,"Census Tract 9800, Jefferson County, Texas",54,74,54,74,0,127
1400000US48245990000,48245990000,"Census Tract 9900, Jefferson County, Texas",0,127,0,127,0,127
1400000US48247950200,48247950200,"Census Tract 9502, Jim Hogg County, Texas",2220,403,90,88,2130,395
1400000US48247950400,48247950400,"Census Tract 9504, Jim Hogg County, Texas",2991,403,313,123,2678,400
1400000US48249950100,48249950100,"Census Tract 9501, Jim Wells County, Texas",7323,605,3560,499,3763,654
1400000US48249950200,48249950200,"Census Tract 9502, Jim Wells County, Texas",8509,693,1722,458,6787,707
1400000US48249950300,48249950300,"Census Tract 9503, Jim Wells County, Texas",6475,572,1581,308,4894,498
1400000US48249950400,48249950400,"Census Tract 9504, Jim Wells County, Texas",4911,885,813,290,4098,851
1400000US48249950500,48249950500,"Census Tract 9505, Jim Wells County, Texas",5565,604,433,169,5132,604
1400000US48249950600,48249950600,"Census Tract 9506, Jim Wells County, Texas",4195,532,172,100,4023,521
1400000US48249950700,48249950700,"Census Tract 9507, Jim Wells County, Texas",3653,285,640,215,3013,357
1400000US48251130100,48251130100,"Census Tract 1301, Johnson County, Texas",3949,499,3699,466,250,245
1400000US48251130204,48251130204,"Census Tract 1302.04, Johnson County, Texas",9507,470,8265,497,1242,300
1400000US48251130205,48251130205,"Census Tract 1302.05, Johnson County, Texas",3745,283,3355,296,390,204
1400000US48251130207,48251130207,"Census Tract 1302.07, Johnson County, Texas",5657,306,5406,319,251,117
1400000US48251130208,48251130208,"Census Tract 1302.08, Johnson County, Texas",5227,339,4805,352,422,155
1400000US48251130210,48251130210,"Census Tract 1302.10, Johnson County, Texas",4298,424,3947,419,351,182
1400000US48251130211,48251130211,"Census Tract 1302.11, Johnson County, Texas",5756,573,5064,613,692,384
1400000US48251130212,48251130212,"Census Tract 1302.12, Johnson County, Texas",5781,905,4613,929,1168,508
1400000US48251130213,48251130213,"Census Tract 1302.13, Johnson County, Texas",4589,568,3560,425,1029,429
1400000US48251130214,48251130214,"Census Tract 1302.14, Johnson County, Texas",4313,462,3710,456,603,198
1400000US48251130215,48251130215,"Census Tract 1302.15, Johnson County, Texas",2948,299,2655,252,293,151
1400000US48251130302,48251130302,"Census Tract 1303.02, Johnson County, Texas",5317,601,4361,628,956,376
1400000US48251130303,48251130303,"Census Tract 1303.03, Johnson County, Texas",4240,427,2983,499,1257,452
1400000US48251130304,48251130304,"Census Tract 1303.04, Johnson County, Texas",5501,633,4178,623,1323,411
1400000US48251130405,48251130405,"Census Tract 1304.05, Johnson County, Texas",5507,457,5101,421,406,257
1400000US48251130406,48251130406,"Census Tract 1304.06, Johnson County, Texas",6191,494,5436,464,755,386
1400000US48251130407,48251130407,"Census Tract 1304.07, Johnson County, Texas",7822,713,4477,590,3345,680
1400000US48251130408,48251130408,"Census Tract 1304.08, Johnson County, Texas",7090,548,5481,520,1609,492
1400000US48251130409,48251130409,"Census Tract 1304.09, Johnson County, Texas",6043,566,5332,628,711,321
1400000US48251130410,48251130410,"Census Tract 1304.10, Johnson County, Texas",6409,742,5065,591,1344,531
1400000US48251130500,48251130500,"Census Tract 1305, Johnson County, Texas",7283,624,6553,582,730,188
1400000US48251130601,48251130601,"Census Tract 1306.01, Johnson County, Texas",6792,600,6356,623,436,212
1400000US48251130602,48251130602,"Census Tract 1306.02, Johnson County, Texas",1644,239,1519,244,125,132
1400000US48251130700,48251130700,"Census Tract 1307, Johnson County, Texas",4397,374,3418,318,979,326
1400000US48251130800,48251130800,"Census Tract 1308, Johnson County, Texas",4131,414,2648,360,1483,318
1400000US48251130900,48251130900,"Census Tract 1309, Johnson County, Texas",3126,409,1891,379,1235,417
1400000US48251131000,48251131000,"Census Tract 1310, Johnson County, Texas",4880,378,4743,389,137,103
1400000US48251131100,48251131100,"Census Tract 1311, Johnson County, Texas",5468,542,3842,426,1626,613
1400000US48253020101,48253020101,"Census Tract 201.01, Jones County, Texas",1433,197,1378,194,55,43
1400000US48253020102,48253020102,"Census Tract 201.02, Jones County, Texas",5453,227,3501,204,1952,194
1400000US48253020200,48253020200,"Census Tract 202, Jones County, Texas",2640,303,1940,285,700,201
1400000US48253020300,48253020300,"Census Tract 203, Jones County, Texas",2073,290,1685,280,388,168
1400000US48253020400,48253020400,"Census Tract 204, Jones County, Texas",3728,178,2534,305,1194,317
1400000US48253020500,48253020500,"Census Tract 205, Jones County, Texas",4830,377,4299,356,531,258
1400000US48255970100,48255970100,"Census Tract 9701, Karnes County, Texas",2031,357,1914,307,117,88
1400000US48255970200,48255970200,"Census Tract 9702, Karnes County, Texas",4540,950,1516,224,3024,972
1400000US48255970300,48255970300,"Census Tract 9703, Karnes County, Texas",7408,397,3815,390,3593,630
1400000US48255970400,48255970400,"Census Tract 9704, Karnes County, Texas",901,427,421,141,480,342
1400000US48257050201,48257050201,"Census Tract 502.01, Kaufman County, Texas",5106,309,4531,321,575,189
1400000US48257050203,48257050203,"Census Tract 502.03, Kaufman County, Texas",5898,441,5469,440,429,146
1400000US48257050204,48257050204,"Census Tract 502.04, Kaufman County, Texas",5102,554,4075,484,1027,281
1400000US48257050205,48257050205,"Census Tract 502.05, Kaufman County, Texas",3959,285,3482,340,477,131
1400000US48257050206,48257050206,"Census Tract 502.06, Kaufman County, Texas",9603,398,8465,390,1138,277
1400000US48257050300,48257050300,"Census Tract 503, Kaufman County, Texas",3363,308,2341,251,1022,282
1400000US48257050400,48257050400,"Census Tract 504, Kaufman County, Texas",6901,448,4080,456,2821,580
1400000US48257050500,48257050500,"Census Tract 505, Kaufman County, Texas",5337,470,4210,457,1127,474
1400000US48257050600,48257050600,"Census Tract 506, Kaufman County, Texas",6611,740,6088,789,523,253
1400000US48257050701,48257050701,"Census Tract 507.01, Kaufman County, Texas",4715,440,3991,470,724,194
1400000US48257050703,48257050703,"Census Tract 507.03, Kaufman County, Texas",3232,365,2578,357,654,240
1400000US48257050704,48257050704,"Census Tract 507.04, Kaufman County, Texas",5390,561,4692,463,698,293
1400000US48257050800,48257050800,"Census Tract 508, Kaufman County, Texas",9640,517,9016,474,624,240
1400000US48257051000,48257051000,"Census Tract 510, Kaufman County, Texas",1564,291,910,263,654,258
1400000US48257051100,48257051100,"Census Tract 511, Kaufman County, Texas",4478,436,2985,379,1493,306
1400000US48257051201,48257051201,"Census Tract 512.01, Kaufman County, Texas",2774,669,1956,454,818,601
1400000US48257051202,48257051202,"Census Tract 512.02, Kaufman County, Texas",5347,466,4919,467,428,152
1400000US48257051300,48257051300,"Census Tract 513, Kaufman County, Texas",9382,688,8759,700,623,262
1400000US48259970100,48259970100,"Census Tract 9701, Kendall County, Texas",5570,605,3733,481,1837,422
1400000US48259970301,48259970301,"Census Tract 9703.01, Kendall County, Texas",5079,656,3895,576,1184,368
1400000US48259970302,48259970302,"Census Tract 9703.02, Kendall County, Texas",4091,307,3694,322,397,276
1400000US48259970401,48259970401,"Census Tract 9704.01, Kendall County, Texas",5747,475,4784,409,963,261
1400000US48259970402,48259970402,"Census Tract 9704.02, Kendall County, Texas",5952,487,5282,471,670,248
1400000US48259970500,48259970500,"Census Tract 9705, Kendall County, Texas",5076,336,3885,347,1191,248
1400000US48261950100,48261950100,"Census Tract 9501, Kenedy County, Texas",241,85,90,62,151,66
1400000US48261990000,48261990000,"Census Tract 9900, Kenedy County, Texas",0,127,0,127,0,127
1400000US48263950100,48263950100,"Census Tract 9501, Kent County, Texas",772,103,679,98,93,42
1400000US48265960100,48265960100,"Census Tract 9601, Kerr County, Texas",5197,485,4410,465,787,352
1400000US48265960200,48265960200,"Census Tract 9602, Kerr County, Texas",3520,310,3240,300,280,174
1400000US48265960301,48265960301,"Census Tract 9603.01, Kerr County, Texas",4177,503,2951,392,1226,402
1400000US48265960302,48265960302,"Census Tract 9603.02, Kerr County, Texas",7953,484,6727,484,1226,407
1400000US48265960401,48265960401,"Census Tract 9604.01, Kerr County, Texas",1741,327,1216,214,525,316
1400000US48265960402,48265960402,"Census Tract 9604.02, Kerr County, Texas",5760,645,4223,597,1537,552
1400000US48265960500,48265960500,"Census Tract 9605, Kerr County, Texas",4972,495,3001,461,1971,356
1400000US48265960600,48265960600,"Census Tract 9606, Kerr County, Texas",7640,529,5087,499,2553,431
1400000US48265960700,48265960700,"Census Tract 9607, Kerr County, Texas",4433,393,3871,339,562,251
1400000US48265960800,48265960800,"Census Tract 9608, Kerr County, Texas",3433,424,2760,448,673,298
1400000US48267950100,48267950100,"Census Tract 9501, Kimble County, Texas",1957,251,1675,266,282,131
1400000US48267950200,48267950200,"Census Tract 9502, Kimble County, Texas",2611,251,1823,272,788,237
1400000US48269950100,48269950100,"Census Tract 9501, King County, Texas",219,72,197,65,22,17
1400000US48271950100,48271950100,"Census Tract 9501, Kinney County, Texas",3555,236,1737,128,1818,209
1400000US48273020100,48273020100,"Census Tract 201, Kleberg County, Texas",5428,202,2144,252,3284,237
1400000US48273020200,48273020200,"Census Tract 202, Kleberg County, Texas",6035,608,663,259,5372,646
1400000US48273020300,48273020300,"Census Tract 203, Kleberg County, Texas",7564,613,2308,312,5256,557
1400000US48273020400,48273020400,"Census Tract 204, Kleberg County, Texas",6389,594,2581,385,3808,568
1400000US48273020500,48273020500,"Census Tract 205, Kleberg County, Texas",6195,544,2085,288,4110,542
1400000US48273990000,48273990000,"Census Tract 9900, Kleberg County, Texas",0,127,0,127,0,127
1400000US48275950100,48275950100,"Census Tract 9501, Knox County, Texas",1606,123,1240,108,366,93
1400000US48275950200,48275950200,"Census Tract 9502, Knox County, Texas",2102,123,1467,108,635,93
1400000US48277000101,48277000101,"Census Tract 1.01, Lamar County, Texas",4814,424,4344,417,470,323
1400000US48277000102,48277000102,"Census Tract 1.02, Lamar County, Texas",4536,497,4463,504,73,68
1400000US48277000200,48277000200,"Census Tract 2, Lamar County, Texas",3221,360,3019,331,202,119
1400000US48277000300,48277000300,"Census Tract 3, Lamar County, Texas",6003,484,5726,477,277,131
1400000US48277000401,48277000401,"Census Tract 4.01, Lamar County, Texas",3242,326,3156,335,86,111
1400000US48277000402,48277000402,"Census Tract 4.02, Lamar County, Texas",5949,472,5721,442,228,121
1400000US48277000500,48277000500,"Census Tract 5, Lamar County, Texas",4215,420,3721,397,494,198
1400000US48277000600,48277000600,"Census Tract 6, Lamar County, Texas",2585,463,2358,442,227,238
1400000US48277000700,48277000700,"Census Tract 7, Lamar County, Texas",3005,335,2818,329,187,130
1400000US48277000800,48277000800,"Census Tract 8, Lamar County, Texas",3378,385,3292,369,86,99
1400000US48277000900,48277000900,"Census Tract 9, Lamar County, Texas",4469,379,4357,392,112,86
1400000US48277001000,48277001000,"Census Tract 10, Lamar County, Texas",4119,550,3579,547,540,225
1400000US48279950100,48279950100,"Census Tract 9501, Lamb County, Texas",2782,264,942,157,1840,253
1400000US48279950200,48279950200,"Census Tract 9502, Lamb County, Texas",1684,228,863,161,821,220
1400000US48279950300,48279950300,"Census Tract 9503, Lamb County, Texas",2215,255,1527,229,688,195
1400000US48279950500,48279950500,"Census Tract 9505, Lamb County, Texas",4025,376,1373,206,2652,348
1400000US48279950600,48279950600,"Census Tract 9506, Lamb County, Texas",3386,354,2424,255,962,314
1400000US48281950100,48281950100,"Census Tract 9501, Lampasas County, Texas",2814,562,2301,501,513,221
1400000US48281950301,48281950301,"Census Tract 9503.01, Lampasas County, Texas",5898,759,5395,725,503,224
1400000US48281950302,48281950302,"Census Tract 9503.02, Lampasas County, Texas",3645,645,3278,664,367,221
1400000US48281950400,48281950400,"Census Tract 9504, Lampasas County, Texas",4027,447,2844,470,1183,217
1400000US48281950500,48281950500,"Census Tract 9505, Lampasas County, Texas",3293,468,2517,418,776,239
1400000US48283950300,48283950300,"Census Tract 9503, La Salle County, Texas",6709,,1416,252,5293,252
1400000US48285000100,48285000100,"Census Tract 1, Lavaca County, Texas",3088,334,2954,340,134,101
1400000US48285000200,48285000200,"Census Tract 2, Lavaca County, Texas",3643,257,3355,271,288,140
1400000US48285000300,48285000300,"Census Tract 3, Lavaca County, Texas",2514,313,2047,270,467,210
1400000US48285000400,48285000400,"Census Tract 4, Lavaca County, Texas",4065,412,3789,424,276,213
1400000US48285000500,48285000500,"Census Tract 5, Lavaca County, Texas",2888,337,2641,318,247,131
1400000US48285000600,48285000600,"Census Tract 6, Lavaca County, Texas",3019,187,1553,224,1466,232
1400000US48287000100,48287000100,"Census Tract 1, Lee County, Texas",5218,436,4548,510,670,398
1400000US48287000200,48287000200,"Census Tract 2, Lee County, Texas",2599,311,2343,274,256,147
1400000US48287000300,48287000300,"Census Tract 3, Lee County, Texas",2968,331,2740,327,228,195
1400000US48287000400,48287000400,"Census Tract 4, Lee County, Texas",5714,289,3360,410,2354,379
1400000US48289950100,48289950100,"Census Tract 9501, Leon County, Texas",6909,567,5726,518,1183,279
1400000US48289950200,48289950200,"Census Tract 9502, Leon County, Texas",4886,504,4597,497,289,157
1400000US48289950300,48289950300,"Census Tract 9503, Leon County, Texas",4845,509,4280,440,565,239
1400000US48291700100,48291700100,"Census Tract 7001, Liberty County, Texas",4916,471,3480,400,1436,390
1400000US48291700200,48291700200,"Census Tract 7002, Liberty County, Texas",2871,466,2739,448,132,125
1400000US48291700300,48291700300,"Census Tract 7003, Liberty County, Texas",9743,845,7286,673,2457,504
1400000US48291700400,48291700400,"Census Tract 7004, Liberty County, Texas",5933,578,5456,527,477,392
1400000US48291700500,48291700500,"Census Tract 7005, Liberty County, Texas",2376,256,2296,270,80,57
1400000US48291700600,48291700600,"Census Tract 7006, Liberty County, Texas",2765,460,2561,440,204,260
1400000US48291700700,48291700700,"Census Tract 7007, Liberty County, Texas",2905,495,2485,388,420,520
1400000US48291700800,48291700800,"Census Tract 7008, Liberty County, Texas",8950,742,8060,762,890,359
1400000US48291700900,48291700900,"Census Tract 7009, Liberty County, Texas",6254,468,4704,486,1550,273
1400000US48291701000,48291701000,"Census Tract 7010, Liberty County, Texas",5507,596,3734,523,1773,413
1400000US48291701100,48291701100,"Census Tract 7011, Liberty County, Texas",6377,638,6065,594,312,227
1400000US48291701200,48291701200,"Census Tract 7012, Liberty County, Texas",5345,738,4233,597,1112,461
1400000US48291701300,48291701300,"Census Tract 7013, Liberty County, Texas",3059,393,2909,382,150,91
1400000US48291701400,48291701400,"Census Tract 7014, Liberty County, Texas",7921,691,6550,634,1371,410
1400000US48293970100,48293970100,"Census Tract 9701, Limestone County, Texas",1993,325,1856,347,137,120
1400000US48293970200,48293970200,"Census Tract 9702, Limestone County, Texas",4199,596,3779,467,420,300
1400000US48293970300,48293970300,"Census Tract 9703, Limestone County, Texas",2314,372,1915,388,399,348
1400000US48293970400,48293970400,"Census Tract 9704, Limestone County, Texas",1503,328,1062,257,441,274
1400000US48293970500,48293970500,"Census Tract 9705, Limestone County, Texas",2695,401,1744,317,951,388
1400000US48293970600,48293970600,"Census Tract 9706, Limestone County, Texas",6016,344,4398,667,1618,608
1400000US48293970700,48293970700,"Census Tract 9707, Limestone County, Texas",1581,304,1516,316,65,91
1400000US48293970800,48293970800,"Census Tract 9708, Limestone County, Texas",2869,417,2780,418,89,62
1400000US48295950200,48295950200,"Census Tract 9502, Lipscomb County, Texas",1938,116,1181,92,757,69
1400000US48295950300,48295950300,"Census Tract 9503, Lipscomb County, Texas",1280,116,1155,91,125,69
1400000US48297950100,48297950100,"Census Tract 9501, Live Oak County, Texas",4861,398,2897,336,1964,242
1400000US48297950200,48297950200,"Census Tract 9502, Live Oak County, Texas",2057,268,883,230,1174,223
1400000US48297950300,48297950300,"Census Tract 9503, Live Oak County, Texas",2362,394,1735,339,627,265
1400000US48297950400,48297950400,"Census Tract 9504, Live Oak County, Texas",2227,371,1912,341,315,153
1400000US48299970100,48299970100,"Census Tract 9701, Llano County, Texas",2346,306,2251,297,95,91
1400000US48299970200,48299970200,"Census Tract 9702, Llano County, Texas",3725,189,3176,305,549,228
1400000US48299970300,48299970300,"Census Tract 9703, Llano County, Texas",2096,293,2026,287,70,46
1400000US48299970400,48299970400,"Census Tract 9704, Llano County, Texas",3494,203,3352,207,142,88
1400000US48299970500,48299970500,"Census Tract 9705, Llano County, Texas",5521,529,5072,488,449,301
1400000US48299970600,48299970600,"Census Tract 9706, Llano County, Texas",1810,324,1669,296,141,133
1400000US48301950100,48301950100,"Census Tract 9501, Loving County, Texas",41,31,41,31,0,127
1400000US48303000100,48303000100,"Census Tract 1, Lubbock County, Texas",2525,353,1078,180,1447,295
1400000US48303000201,48303000201,"Census Tract 2.01, Lubbock County, Texas",2131,409,995,218,1136,340
1400000US48303000202,48303000202,"Census Tract 2.02, Lubbock County, Texas",1725,348,251,139,1474,385
1400000US48303000301,48303000301,"Census Tract 3.01, Lubbock County, Texas",4212,371,2189,336,2023,278
1400000US48303000302,48303000302,"Census Tract 3.02, Lubbock County, Texas",6497,570,1414,343,5083,569
1400000US48303000402,48303000402,"Census Tract 4.02, Lubbock County, Texas",4843,409,3397,407,1446,254
1400000US48303000403,48303000403,"Census Tract 4.03, Lubbock County, Texas",3782,322,3296,360,486,166
1400000US48303000404,48303000404,"Census Tract 4.04, Lubbock County, Texas",6898,387,5125,427,1773,287
1400000US48303000405,48303000405,"Census Tract 4.05, Lubbock County, Texas",9993,865,6636,753,3357,688
1400000US48303000500,48303000500,"Census Tract 5, Lubbock County, Texas",7649,1028,6549,899,1100,286
1400000US48303000603,48303000603,"Census Tract 6.03, Lubbock County, Texas",1919,594,1676,496,243,163
1400000US48303000605,48303000605,"Census Tract 6.05, Lubbock County, Texas",478,277,441,284,37,48
1400000US48303000607,48303000607,"Census Tract 6.07, Lubbock County, Texas",2260,288,1683,288,577,180
1400000US48303000700,48303000700,"Census Tract 7, Lubbock County, Texas",1274,287,215,129,1059,266
1400000US48303000900,48303000900,"Census Tract 9, Lubbock County, Texas",4356,520,3228,436,1128,341
1400000US48303001000,48303001000,"Census Tract 10, Lubbock County, Texas",2966,477,1656,298,1310,363
1400000US48303001200,48303001200,"Census Tract 12, Lubbock County, Texas",2554,398,1708,351,846,390
1400000US48303001300,48303001300,"Census Tract 13, Lubbock County, Texas",3056,457,871,197,2185,476
1400000US48303001400,48303001400,"Census Tract 14, Lubbock County, Texas",4826,667,2519,387,2307,583
1400000US48303001501,48303001501,"Census Tract 15.01, Lubbock County, Texas",2007,264,1744,280,263,147
1400000US48303001502,48303001502,"Census Tract 15.02, Lubbock County, Texas",2055,391,1571,412,484,173
1400000US48303001601,48303001601,"Census Tract 16.01, Lubbock County, Texas",2743,413,1918,333,825,267
1400000US48303001602,48303001602,"Census Tract 16.02, Lubbock County, Texas",3355,413,2307,431,1048,349
1400000US48303001702,48303001702,"Census Tract 17.02, Lubbock County, Texas",6102,648,4404,504,1698,657
1400000US48303001705,48303001705,"Census Tract 17.05, Lubbock County, Texas",5788,321,5350,321,438,225
1400000US48303001706,48303001706,"Census Tract 17.06, Lubbock County, Texas",5775,549,3344,555,2431,736
1400000US48303001707,48303001707,"Census Tract 17.07, Lubbock County, Texas",3599,213,3243,254,356,191
1400000US48303001708,48303001708,"Census Tract 17.08, Lubbock County, Texas",2376,238,1754,322,622,318
1400000US48303001709,48303001709,"Census Tract 17.09, Lubbock County, Texas",4530,530,3341,544,1189,406
1400000US48303001801,48303001801,"Census Tract 18.01, Lubbock County, Texas",5680,565,3985,562,1695,530
1400000US48303001803,48303001803,"Census Tract 18.03, Lubbock County, Texas",5371,391,4056,358,1315,337
1400000US48303001804,48303001804,"Census Tract 18.04, Lubbock County, Texas",4000,409,3557,413,443,161
1400000US48303001901,48303001901,"Census Tract 19.01, Lubbock County, Texas",4751,383,3729,371,1022,252
1400000US48303001903,48303001903,"Census Tract 19.03, Lubbock County, Texas",5263,352,4734,282,529,211
1400000US48303001904,48303001904,"Census Tract 19.04, Lubbock County, Texas",1379,85,1271,119,108,78
1400000US48303002001,48303002001,"Census Tract 20.01, Lubbock County, Texas",1943,267,1690,257,253,121
1400000US48303002002,48303002002,"Census Tract 20.02, Lubbock County, Texas",2931,365,1576,244,1355,302
1400000US48303002101,48303002101,"Census Tract 21.01, Lubbock County, Texas",5871,655,4175,614,1696,633
1400000US48303002102,48303002102,"Census Tract 21.02, Lubbock County, Texas",2840,216,2097,251,743,280
1400000US48303002202,48303002202,"Census Tract 22.02, Lubbock County, Texas",5068,519,2972,469,2096,383
1400000US48303002203,48303002203,"Census Tract 22.03, Lubbock County, Texas",3052,415,2268,353,784,219
1400000US48303002204,48303002204,"Census Tract 22.04, Lubbock County, Texas",4378,528,2003,382,2375,397
1400000US48303002300,48303002300,"Census Tract 23, Lubbock County, Texas",4396,538,1775,412,2621,512
1400000US48303002400,48303002400,"Census Tract 24, Lubbock County, Texas",6077,738,1439,432,4638,707
1400000US48303002500,48303002500,"Census Tract 25, Lubbock County, Texas",2446,338,673,181,1773,394
1400000US48303010101,48303010101,"Census Tract 101.01, Lubbock County, Texas",1563,295,1368,319,195,166
1400000US48303010102,48303010102,"Census Tract 101.02, Lubbock County, Texas",2756,271,1426,189,1330,264
1400000US48303010200,48303010200,"Census Tract 102, Lubbock County, Texas",8297,813,4794,668,3503,754
1400000US48303010301,48303010301,"Census Tract 103.01, Lubbock County, Texas",3350,354,2962,382,388,233
1400000US48303010302,48303010302,"Census Tract 103.02, Lubbock County, Texas",3157,311,2295,271,862,288
1400000US48303010402,48303010402,"Census Tract 104.02, Lubbock County, Texas",1807,304,1216,229,591,212
1400000US48303010403,48303010403,"Census Tract 104.03, Lubbock County, Texas",5588,428,4964,435,624,294
1400000US48303010404,48303010404,"Census Tract 104.04, Lubbock County, Texas",2925,325,2103,350,822,267
1400000US48303010405,48303010405,"Census Tract 104.05, Lubbock County, Texas",4766,858,3074,521,1692,827
1400000US48303010406,48303010406,"Census Tract 104.06, Lubbock County, Texas",3892,572,2832,397,1060,527
1400000US48303010407,48303010407,"Census Tract 104.07, Lubbock County, Texas",6864,472,5762,502,1102,367
1400000US48303010408,48303010408,"Census Tract 104.08, Lubbock County, Texas",7443,545,6294,588,1149,300
1400000US48303010502,48303010502,"Census Tract 105.02, Lubbock County, Texas",3181,282,2979,242,202,227
1400000US48303010504,48303010504,"Census Tract 105.04, Lubbock County, Texas",4020,354,3920,351,100,77
1400000US48303010505,48303010505,"Census Tract 105.05, Lubbock County, Texas",4321,298,3170,332,1151,366
1400000US48303010506,48303010506,"Census Tract 105.06, Lubbock County, Texas",4059,300,3242,280,817,244
1400000US48303010508,48303010508,"Census Tract 105.08, Lubbock County, Texas",7186,680,5149,571,2037,501
1400000US48303010509,48303010509,"Census Tract 105.09, Lubbock County, Texas",2297,223,2175,248,122,127
1400000US48303010510,48303010510,"Census Tract 105.10, Lubbock County, Texas",1849,143,1746,176,103,117
1400000US48303010511,48303010511,"Census Tract 105.11, Lubbock County, Texas",3046,324,2550,334,496,197
1400000US48303010600,48303010600,"Census Tract 106, Lubbock County, Texas",6027,61,3255,509,2772,511
1400000US48303010700,48303010700,"Census Tract 107, Lubbock County, Texas",3818,430,2976,405,842,344
1400000US48303980000,48303980000,"Census Tract 9800, Lubbock County, Texas",0,127,0,127,0,127
1400000US48305950400,48305950400,"Census Tract 9504, Lynn County, Texas",2084,177,1184,154,900,172
1400000US48305950500,48305950500,"Census Tract 9505, Lynn County, Texas",2715,37,1486,134,1229,135
1400000US48305950600,48305950600,"Census Tract 9506, Lynn County, Texas",1189,173,621,120,568,140
1400000US48307950300,48307950300,"Census Tract 9503, McCulloch County, Texas",5211,175,3365,242,1846,188
1400000US48307950400,48307950400,"Census Tract 9504, McCulloch County, Texas",1616,272,1395,271,221,173
1400000US48307950500,48307950500,"Census Tract 9505, McCulloch County, Texas",1393,240,1141,237,252,119
1400000US48309000100,48309000100,"Census Tract 1, McLennan County, Texas",1362,336,836,266,526,282
1400000US48309000200,48309000200,"Census Tract 2, McLennan County, Texas",2889,453,2403,420,486,195
1400000US48309000300,48309000300,"Census Tract 3, McLennan County, Texas",4122,835,3655,768,467,172
1400000US48309000400,48309000400,"Census Tract 4, McLennan County, Texas",6365,760,3677,573,2688,567
1400000US48309000598,48309000598,"Census Tract 5.98, McLennan County, Texas",5709,562,1097,291,4612,504
1400000US48309000700,48309000700,"Census Tract 7, McLennan County, Texas",2666,336,1280,339,1386,277
1400000US48309000800,48309000800,"Census Tract 8, McLennan County, Texas",2685,481,1216,301,1469,410
1400000US48309000900,48309000900,"Census Tract 9, McLennan County, Texas",4814,485,2520,349,2294,455
1400000US48309001000,48309001000,"Census Tract 10, McLennan County, Texas",2839,375,1229,223,1610,316
1400000US48309001100,48309001100,"Census Tract 11, McLennan County, Texas",6398,544,3586,511,2812,586
1400000US48309001200,48309001200,"Census Tract 12, McLennan County, Texas",3844,601,2540,463,1304,447
1400000US48309001300,48309001300,"Census Tract 13, McLennan County, Texas",2378,382,1338,334,1040,228
1400000US48309001400,48309001400,"Census Tract 14, McLennan County, Texas",6748,680,5978,643,770,394
1400000US48309001500,48309001500,"Census Tract 15, McLennan County, Texas",2736,310,2327,277,409,187
1400000US48309001600,48309001600,"Census Tract 16, McLennan County, Texas",5936,473,3611,580,2325,686
1400000US48309001700,48309001700,"Census Tract 17, McLennan County, Texas",5223,602,3759,465,1464,328
1400000US48309001800,48309001800,"Census Tract 18, McLennan County, Texas",1777,278,1521,280,256,86
1400000US48309001900,48309001900,"Census Tract 19, McLennan County, Texas",4069,556,3250,511,819,224
1400000US48309002000,48309002000,"Census Tract 20, McLennan County, Texas",3325,259,2904,243,421,190
1400000US48309002100,48309002100,"Census Tract 21, McLennan County, Texas",4099,461,2819,427,1280,215
1400000US48309002302,48309002302,"Census Tract 23.02, McLennan County, Texas",5351,574,4217,569,1134,571
1400000US48309002498,48309002498,"Census Tract 24.98, McLennan County, Texas",4979,486,3854,459,1125,399
1400000US48309002501,48309002501,"Census Tract 25.01, McLennan County, Texas",5480,658,4495,656,985,377
1400000US48309002503,48309002503,"Census Tract 25.03, McLennan County, Texas",5681,511,5253,529,428,168
1400000US48309002504,48309002504,"Census Tract 25.04, McLennan County, Texas",3361,282,3137,292,224,207
1400000US48309002600,48309002600,"Census Tract 26, McLennan County, Texas",5587,534,5218,542,369,162
1400000US48309002700,48309002700,"Census Tract 27, McLennan County, Texas",4097,412,2278,276,1819,379
1400000US48309002800,48309002800,"Census Tract 28, McLennan County, Texas",3734,327,3417,330,317,170
1400000US48309002900,48309002900,"Census Tract 29, McLennan County, Texas",2923,184,2743,193,180,87
1400000US48309003000,48309003000,"Census Tract 30, McLennan County, Texas",4081,351,3160,289,921,351
1400000US48309003200,48309003200,"Census Tract 32, McLennan County, Texas",4574,426,3500,400,1074,346
1400000US48309003300,48309003300,"Census Tract 33, McLennan County, Texas",1854,415,1731,410,123,93
1400000US48309003400,48309003400,"Census Tract 34, McLennan County, Texas",6533,632,6171,612,362,259
1400000US48309003500,48309003500,"Census Tract 35, McLennan County, Texas",4071,439,3603,361,468,289
1400000US48309003601,48309003601,"Census Tract 36.01, McLennan County, Texas",3582,475,3105,467,477,200
1400000US48309003602,48309003602,"Census Tract 36.02, McLennan County, Texas",2524,241,2317,264,207,112
1400000US48309003701,48309003701,"Census Tract 37.01, McLennan County, Texas",2975,370,2481,371,494,210
1400000US48309003703,48309003703,"Census Tract 37.03, McLennan County, Texas",4894,297,4497,313,397,154
1400000US48309003706,48309003706,"Census Tract 37.06, McLennan County, Texas",8572,400,7567,507,1005,335
1400000US48309003707,48309003707,"Census Tract 37.07, McLennan County, Texas",8704,679,7287,687,1417,525
1400000US48309003708,48309003708,"Census Tract 37.08, McLennan County, Texas",5811,481,5095,520,716,162
1400000US48309003801,48309003801,"Census Tract 38.01, McLennan County, Texas",6249,555,5819,520,430,170
1400000US48309003802,48309003802,"Census Tract 38.02, McLennan County, Texas",6112,402,5161,365,951,230
1400000US48309003900,48309003900,"Census Tract 39, McLennan County, Texas",7868,429,6197,497,1671,391
1400000US48309004000,48309004000,"Census Tract 40, McLennan County, Texas",5395,520,5193,513,202,95
1400000US48309004102,48309004102,"Census Tract 41.02, McLennan County, Texas",5369,353,4886,371,483,153
1400000US48309004103,48309004103,"Census Tract 41.03, McLennan County, Texas",6038,416,5219,421,819,237
1400000US48309004201,48309004201,"Census Tract 42.01, McLennan County, Texas",3426,164,2744,334,682,275
1400000US48309004202,48309004202,"Census Tract 42.02, McLennan County, Texas",3088,297,2734,313,354,170
1400000US48309004300,48309004300,"Census Tract 43, McLennan County, Texas",6690,590,3121,407,3569,588
1400000US48309980000,48309980000,"Census Tract 9800, McLennan County, Texas",0,127,0,127,0,127
1400000US48311950100,48311950100,"Census Tract 9501, McMullen County, Texas",897,206,429,117,468,187
1400000US48313000100,48313000100,"Census Tract 1, Madison County, Texas",4323,348,3585,360,738,149
1400000US48313000200,48313000200,"Census Tract 2, Madison County, Texas",1676,381,1305,368,371,247
1400000US48313000300,48313000300,"Census Tract 3, Madison County, Texas",2714,382,2662,371,52,52
1400000US48313000400,48313000400,"Census Tract 4, Madison County, Texas",4720,196,3363,355,1357,269
1400000US48315950100,48315950100,"Census Tract 9501, Marion County, Texas",2563,358,2525,362,38,46
1400000US48315950200,48315950200,"Census Tract 9502, Marion County, Texas",3052,381,2970,386,82,81
1400000US48315950300,48315950300,"Census Tract 9503, Marion County, Texas",3125,367,2941,361,184,71
1400000US48315950400,48315950400,"Census Tract 9504, Marion County, Texas",2031,266,2016,268,15,18
1400000US48317950100,48317950100,"Census Tract 9501, Martin County, Texas",921,169,722,154,199,109
1400000US48317950200,48317950200,"Census Tract 9502, Martin County, Texas",3685,169,1874,331,1811,350
1400000US48319950100,48319950100,"Census Tract 9501, Mason County, Texas",2212,264,1643,300,569,226
1400000US48319950200,48319950200,"Census Tract 9502, Mason County, Texas",1716,264,1655,262,61,53
1400000US48321730100,48321730100,"Census Tract 7301, Matagorda County, Texas",2735,328,1375,275,1360,272
1400000US48321730201,48321730201,"Census Tract 7302.01, Matagorda County, Texas",6934,727,4290,594,2644,599
1400000US48321730202,48321730202,"Census Tract 7302.02, Matagorda County, Texas",2016,544,1524,473,492,379
1400000US48321730301,48321730301,"Census Tract 7303.01, Matagorda County, Texas",4445,704,2861,396,1584,722
1400000US48321730302,48321730302,"Census Tract 7303.02, Matagorda County, Texas",4016,448,2570,433,1446,405
1400000US48321730303,48321730303,"Census Tract 7303.03, Matagorda County, Texas",381,66,338,81,43,75
1400000US48321730400,48321730400,"Census Tract 7304, Matagorda County, Texas",2654,383,1841,257,813,323
1400000US48321730501,48321730501,"Census Tract 7305.01, Matagorda County, Texas",3682,558,3359,510,323,208
1400000US48321730600,48321730600,"Census Tract 7306, Matagorda County, Texas",6035,377,2775,560,3260,472
1400000US48321730700,48321730700,"Census Tract 7307, Matagorda County, Texas",3749,459,2225,397,1524,406
1400000US48321990000,48321990000,"Census Tract 9900, Matagorda County, Texas",0,127,0,127,0,127
1400000US48323950201,48323950201,"Census Tract 9502.01, Maverick County, Texas",6292,917,634,84,5658,926
1400000US48323950204,48323950204,"Census Tract 9502.04, Maverick County, Texas",4061,703,14,28,4047,702
1400000US48323950205,48323950205,"Census Tract 9502.05, Maverick County, Texas",8044,998,82,97,7962,1008
1400000US48323950300,48323950300,"Census Tract 9503, Maverick County, Texas",7379,677,517,181,6862,687
1400000US48323950400,48323950400,"Census Tract 9504, Maverick County, Texas",3655,379,193,109,3462,398
1400000US48323950500,48323950500,"Census Tract 9505, Maverick County, Texas",5820,670,358,144,5462,682
1400000US48323950601,48323950601,"Census Tract 9506.01, Maverick County, Texas",3044,471,24,32,3020,470
1400000US48323950602,48323950602,"Census Tract 9506.02, Maverick County, Texas",6104,693,14,23,6090,693
1400000US48323950700,48323950700,"Census Tract 9507, Maverick County, Texas",8094,892,615,265,7479,930
1400000US48325000101,48325000101,"Census Tract 1.01, Medina County, Texas",6382,634,3660,515,2722,582
1400000US48325000102,48325000102,"Census Tract 1.02, Medina County, Texas",7281,711,4588,509,2693,644
1400000US48325000200,48325000200,"Census Tract 2, Medina County, Texas",1651,276,1042,219,609,233
1400000US48325000300,48325000300,"Census Tract 3, Medina County, Texas",8451,658,4811,614,3640,566
1400000US48325000401,48325000401,"Census Tract 4.01, Medina County, Texas",5262,727,1464,392,3798,814
1400000US48325000402,48325000402,"Census Tract 4.02, Medina County, Texas",3864,570,1969,454,1895,561
1400000US48325000500,48325000500,"Census Tract 5, Medina County, Texas",5083,476,2530,459,2553,507
1400000US48325000800,48325000800,"Census Tract 8, Medina County, Texas",7099,639,3025,620,4074,601
1400000US48327950300,48327950300,"Census Tract 9503, Menard County, Texas",2212,,1549,123,663,123
1400000US48329000100,48329000100,"Census Tract 1, Midland County, Texas",4715,440,2783,417,1932,330
1400000US48329000200,48329000200,"Census Tract 2, Midland County, Texas",4637,526,3488,501,1149,309
1400000US48329000302,48329000302,"Census Tract 3.02, Midland County, Texas",5227,421,4007,539,1220,494
1400000US48329000303,48329000303,"Census Tract 3.03, Midland County, Texas",4362,235,3913,252,449,125
1400000US48329000304,48329000304,"Census Tract 3.04, Midland County, Texas",3936,260,3263,206,673,198
1400000US48329000305,48329000305,"Census Tract 3.05, Midland County, Texas",4707,386,4340,414,367,186
1400000US48329000401,48329000401,"Census Tract 4.01, Midland County, Texas",3596,273,1875,191,1721,336
1400000US48329000402,48329000402,"Census Tract 4.02, Midland County, Texas",4927,479,3353,445,1574,344
1400000US48329000500,48329000500,"Census Tract 5, Midland County, Texas",5030,467,3627,379,1403,441
1400000US48329000600,48329000600,"Census Tract 6, Midland County, Texas",4574,388,2894,396,1680,269
1400000US48329001100,48329001100,"Census Tract 11, Midland County, Texas",5621,467,2209,346,3412,451
1400000US48329001200,48329001200,"Census Tract 12, Midland County, Texas",6771,533,2955,384,3816,620
1400000US48329001300,48329001300,"Census Tract 13, Midland County, Texas",5668,445,2540,295,3128,446
1400000US48329001400,48329001400,"Census Tract 14, Midland County, Texas",4177,494,588,210,3589,473
1400000US48329001500,48329001500,"Census Tract 15, Midland County, Texas",3658,551,1470,358,2188,522
1400000US48329001700,48329001700,"Census Tract 17, Midland County, Texas",3339,396,842,191,2497,407
1400000US48329010104,48329010104,"Census Tract 101.04, Midland County, Texas",6496,527,5267,391,1229,449
1400000US48329010105,48329010105,"Census Tract 101.05, Midland County, Texas",2939,337,1976,266,963,336
1400000US48329010106,48329010106,"Census Tract 101.06, Midland County, Texas",5873,632,3974,570,1899,669
1400000US48329010107,48329010107,"Census Tract 101.07, Midland County, Texas",4123,382,3184,403,939,309
1400000US48329010108,48329010108,"Census Tract 101.08, Midland County, Texas",3686,336,3155,265,531,327
1400000US48329010109,48329010109,"Census Tract 101.09, Midland County, Texas",6607,807,3093,610,3514,709
1400000US48329010112,48329010112,"Census Tract 101.12, Midland County, Texas",9914,807,7607,649,2307,636
1400000US48329010113,48329010113,"Census Tract 101.13, Midland County, Texas",9059,907,6503,685,2556,695
1400000US48329010114,48329010114,"Census Tract 101.14, Midland County, Texas",5680,601,4588,561,1092,359
1400000US48329010200,48329010200,"Census Tract 102, Midland County, Texas",2781,525,532,216,2249,416
1400000US48329980000,48329980000,"Census Tract 9800, Midland County, Texas",0,127,0,127,0,127
1400000US48331950100,48331950100,"Census Tract 9501, Milam County, Texas",2321,332,1775,258,546,306
1400000US48331950300,48331950300,"Census Tract 9503, Milam County, Texas",3892,457,3170,417,722,272
1400000US48331950401,48331950401,"Census Tract 9504.01, Milam County, Texas",3589,455,2503,431,1086,426
1400000US48331950402,48331950402,"Census Tract 9504.02, Milam County, Texas",3594,423,2610,344,984,352
1400000US48331950500,48331950500,"Census Tract 9505, Milam County, Texas",2836,266,2701,262,135,66
1400000US48331950700,48331950700,"Census Tract 9507, Milam County, Texas",5646,175,3997,417,1649,423
1400000US48331950800,48331950800,"Census Tract 9508, Milam County, Texas",3056,318,2639,299,417,170
1400000US48333950100,48333950100,"Census Tract 9501, Mills County, Texas",1856,235,1629,223,227,103
1400000US48333950200,48333950200,"Census Tract 9502, Mills County, Texas",3031,235,2328,243,703,220
1400000US48335950200,48335950200,"Census Tract 9502, Mitchell County, Texas",7680,238,4798,212,2882,130
1400000US48335950400,48335950400,"Census Tract 9504, Mitchell County, Texas",1662,238,1303,212,359,130
1400000US48337950100,48337950100,"Census Tract 9501, Montague County, Texas",2422,230,2339,232,83,66
1400000US48337950200,48337950200,"Census Tract 9502, Montague County, Texas",1533,251,1444,240,89,85
1400000US48337950300,48337950300,"Census Tract 9503, Montague County, Texas",2833,156,2284,244,549,227
1400000US48337950400,48337950400,"Census Tract 9504, Montague County, Texas",5370,388,5066,387,304,144
1400000US48337950500,48337950500,"Census Tract 9505, Montague County, Texas",5571,185,5001,350,570,275
1400000US48337950600,48337950600,"Census Tract 9506, Montague County, Texas",2060,267,1932,237,128,97
1400000US48339690100,48339690100,"Census Tract 6901, Montgomery County, Texas",10131,847,7712,734,2419,901
1400000US48339690201,48339690201,"Census Tract 6902.01, Montgomery County, Texas",8404,797,7334,730,1070,655
1400000US48339690202,48339690202,"Census Tract 6902.02, Montgomery County, Texas",6778,774,5988,764,790,424
1400000US48339690300,48339690300,"Census Tract 6903, Montgomery County, Texas",5038,560,3845,337,1193,546
1400000US48339690401,48339690401,"Census Tract 6904.01, Montgomery County, Texas",5114,247,4693,317,421,190
1400000US48339690402,48339690402,"Census Tract 6904.02, Montgomery County, Texas",15201,787,11755,716,3446,737
1400000US48339690500,48339690500,"Census Tract 6905, Montgomery County, Texas",6939,419,6327,482,612,295
1400000US48339690601,48339690601,"Census Tract 6906.01, Montgomery County, Texas",20468,839,18077,736,2391,478
1400000US48339690602,48339690602,"Census Tract 6906.02, Montgomery County, Texas",15868,694,13467,700,2401,466
1400000US48339690700,48339690700,"Census Tract 6907, Montgomery County, Texas",7669,639,6830,605,839,217
1400000US48339690800,48339690800,"Census Tract 6908, Montgomery County, Texas",4311,273,4023,251,288,185
1400000US48339690900,48339690900,"Census Tract 6909, Montgomery County, Texas",4708,237,4356,249,352,237
1400000US48339691000,48339691000,"Census Tract 6910, Montgomery County, Texas",4458,292,4044,300,414,185
1400000US48339691100,48339691100,"Census Tract 6911, Montgomery County, Texas",4421,230,3972,201,449,267
1400000US48339691200,48339691200,"Census Tract 6912, Montgomery County, Texas",7620,420,7063,439,557,262
1400000US48339691301,48339691301,"Census Tract 6913.01, Montgomery County, Texas",4854,389,4246,323,608,364
1400000US48339691302,48339691302,"Census Tract 6913.02, Montgomery County, Texas",5579,386,4589,455,990,330
1400000US48339691400,48339691400,"Census Tract 6914, Montgomery County, Texas",7987,630,7098,502,889,367
1400000US48339691500,48339691500,"Census Tract 6915, Montgomery County, Texas",4095,413,3585,329,510,274
1400000US48339691601,48339691601,"Census Tract 6916.01, Montgomery County, Texas",4020,480,3577,501,443,221
1400000US48339691602,48339691602,"Census Tract 6916.02, Montgomery County, Texas",5159,595,3757,436,1402,482
1400000US48339691700,48339691700,"Census Tract 6917, Montgomery County, Texas",650,222,609,202,41,72
1400000US48339691800,48339691800,"Census Tract 6918, Montgomery County, Texas",7839,608,6154,626,1685,524
1400000US48339691900,48339691900,"Census Tract 6919, Montgomery County, Texas",5940,411,4954,367,986,317
1400000US48339692001,48339692001,"Census Tract 6920.01, Montgomery County, Texas",23115,1036,19696,1014,3419,510
1400000US48339692002,48339692002,"Census Tract 6920.02, Montgomery County, Texas",4509,266,4031,271,478,163
1400000US48339692100,48339692100,"Census Tract 6921, Montgomery County, Texas",9703,669,8196,668,1507,372
1400000US48339692200,48339692200,"Census Tract 6922, Montgomery County, Texas",8045,767,6033,708,2012,611
1400000US48339692300,48339692300,"Census Tract 6923, Montgomery County, Texas",14918,1004,10290,921,4628,759
1400000US48339692400,48339692400,"Census Tract 6924, Montgomery County, Texas",7701,809,6117,728,1584,478
1400000US48339692500,48339692500,"Census Tract 6925, Montgomery County, Texas",7747,643,6267,654,1480,397
1400000US48339692601,48339692601,"Census Tract 6926.01, Montgomery County, Texas",3994,624,3002,431,992,502
1400000US48339692602,48339692602,"Census Tract 6926.02, Montgomery County, Texas",8709,937,6211,846,2498,891
1400000US48339692700,48339692700,"Census Tract 6927, Montgomery County, Texas",7294,663,6555,686,739,352
1400000US48339692801,48339692801,"Census Tract 6928.01, Montgomery County, Texas",7797,686,6874,599,923,353
1400000US48339692802,48339692802,"Census Tract 6928.02, Montgomery County, Texas",3636,408,3004,354,632,235
1400000US48339692900,48339692900,"Census Tract 6929, Montgomery County, Texas",3755,451,3310,433,445,188
1400000US48339693000,48339693000,"Census Tract 6930, Montgomery County, Texas",9421,919,5018,687,4403,693
1400000US48339693101,48339693101,"Census Tract 6931.01, Montgomery County, Texas",6307,737,3047,484,3260,657
1400000US48339693102,48339693102,"Census Tract 6931.02, Montgomery County, Texas",3993,466,1899,324,2094,487
1400000US48339693200,48339693200,"Census Tract 6932, Montgomery County, Texas",7295,496,6487,503,808,244
1400000US48339693300,48339693300,"Census Tract 6933, Montgomery County, Texas",6150,490,4701,448,1449,437
1400000US48339693400,48339693400,"Census Tract 6934, Montgomery County, Texas",4633,642,2020,391,2613,641
1400000US48339693500,48339693500,"Census Tract 6935, Montgomery County, Texas",5623,596,4116,476,1507,428
1400000US48339693600,48339693600,"Census Tract 6936, Montgomery County, Texas",3377,444,2677,498,700,301
1400000US48339693700,48339693700,"Census Tract 6937, Montgomery County, Texas",6456,553,5527,532,929,285
1400000US48339693800,48339693800,"Census Tract 6938, Montgomery County, Texas",3187,318,1869,301,1318,321
1400000US48339693900,48339693900,"Census Tract 6939, Montgomery County, Texas",9961,1015,3935,504,6026,946
1400000US48339694000,48339694000,"Census Tract 6940, Montgomery County, Texas",8534,786,7401,806,1133,361
1400000US48339694101,48339694101,"Census Tract 6941.01, Montgomery County, Texas",10444,1033,7132,801,3312,869
1400000US48339694102,48339694102,"Census Tract 6941.02, Montgomery County, Texas",4853,539,3193,418,1660,429
1400000US48339694201,48339694201,"Census Tract 6942.01, Montgomery County, Texas",5919,708,5296,683,623,258
1400000US48339694202,48339694202,"Census Tract 6942.02, Montgomery County, Texas",9154,549,8619,551,535,204
1400000US48339694301,48339694301,"Census Tract 6943.01, Montgomery County, Texas",10367,941,9324,732,1043,399
1400000US48339694302,48339694302,"Census Tract 6943.02, Montgomery County, Texas",7615,592,7093,666,522,313
1400000US48339694400,48339694400,"Census Tract 6944, Montgomery County, Texas",6157,735,5245,682,912,357
1400000US48339694500,48339694500,"Census Tract 6945, Montgomery County, Texas",5240,414,4820,391,420,124
1400000US48339694600,48339694600,"Census Tract 6946, Montgomery County, Texas",5560,685,4966,654,594,299
1400000US48339694700,48339694700,"Census Tract 6947, Montgomery County, Texas",3297,455,2796,403,501,278
1400000US48341950100,48341950100,"Census Tract 9501, Moore County, Texas",2204,274,1319,258,885,242
1400000US48341950200,48341950200,"Census Tract 9502, Moore County, Texas",6364,421,3102,350,3262,391
1400000US48341950300,48341950300,"Census Tract 9503, Moore County, Texas",7934,467,4102,345,3832,460
1400000US48341950400,48341950400,"Census Tract 9504, Moore County, Texas",4600,382,1665,243,2935,377
1400000US48343950100,48343950100,"Census Tract 9501, Morris County, Texas",4822,347,4554,349,268,103
1400000US48343950200,48343950200,"Census Tract 9502, Morris County, Texas",5784,350,5471,353,313,162
1400000US48343950300,48343950300,"Census Tract 9503, Morris County, Texas",2471,117,2139,183,332,136
1400000US48345950100,48345950100,"Census Tract 9501, Motley County, Texas",1123,137,1014,129,109,59
1400000US48347950100,48347950100,"Census Tract 9501, Nacogdoches County, Texas",2710,371,2582,371,128,110
1400000US48347950200,48347950200,"Census Tract 9502, Nacogdoches County, Texas",4730,444,4415,479,315,222
1400000US48347950301,48347950301,"Census Tract 9503.01, Nacogdoches County, Texas",6311,568,4996,454,1315,456
1400000US48347950302,48347950302,"Census Tract 9503.02, Nacogdoches County, Texas",6879,647,3856,487,3023,537
1400000US48347950400,48347950400,"Census Tract 9504, Nacogdoches County, Texas",8089,495,7603,513,486,244
1400000US48347950501,48347950501,"Census Tract 9505.01, Nacogdoches County, Texas",2452,393,2336,393,116,117
1400000US48347950502,48347950502,"Census Tract 9505.02, Nacogdoches County, Texas",4870,487,4694,488,176,136
1400000US48347950600,48347950600,"Census Tract 9506, Nacogdoches County, Texas",6390,918,5657,810,733,298
1400000US48347950700,48347950700,"Census Tract 9507, Nacogdoches County, Texas",4517,592,2955,536,1562,419
1400000US48347950800,48347950800,"Census Tract 9508, Nacogdoches County, Texas",4163,502,2537,456,1626,445
1400000US48347950900,48347950900,"Census Tract 9509, Nacogdoches County, Texas",3176,459,2930,449,246,240
1400000US48347951000,48347951000,"Census Tract 9510, Nacogdoches County, Texas",3845,513,3371,535,474,307
1400000US48347951100,48347951100,"Census Tract 9511, Nacogdoches County, Texas",5009,362,4856,363,153,142
1400000US48349970100,48349970100,"Census Tract 9701, Navarro County, Texas",3923,415,2941,319,982,337
1400000US48349970200,48349970200,"Census Tract 9702, Navarro County, Texas",5776,482,4461,603,1315,387
1400000US48349970300,48349970300,"Census Tract 9703, Navarro County, Texas",8543,676,6309,601,2234,453
1400000US48349970400,48349970400,"Census Tract 9704, Navarro County, Texas",4483,351,4151,334,332,153
1400000US48349970500,48349970500,"Census Tract 9705, Navarro County, Texas",3840,410,3302,397,538,218
1400000US48349970600,48349970600,"Census Tract 9706, Navarro County, Texas",3446,332,3077,359,369,179
1400000US48349970700,48349970700,"Census Tract 9707, Navarro County, Texas",5403,528,4906,552,497,184
1400000US48349970800,48349970800,"Census Tract 9708, Navarro County, Texas",1708,316,891,303,817,289
1400000US48349970900,48349970900,"Census Tract 9709, Navarro County, Texas",7116,521,3931,377,3185,537
1400000US48349971000,48349971000,"Census Tract 9710, Navarro County, Texas",3245,307,2935,296,310,205
1400000US48351950100,48351950100,"Census Tract 9501, Newton County, Texas",2349,393,2334,389,15,27
1400000US48351950200,48351950200,"Census Tract 9502, Newton County, Texas",5536,567,5246,548,290,106
1400000US48351950300,48351950300,"Census Tract 9503, Newton County, Texas",2354,366,2354,366,0,127
1400000US48351950400,48351950400,"Census Tract 9504, Newton County, Texas",4150,573,4030,558,120,112
1400000US48353950100,48353950100,"Census Tract 9501, Nolan County, Texas",1931,244,1683,210,248,133
1400000US48353950200,48353950200,"Census Tract 9502, Nolan County, Texas",3828,338,2943,302,885,221
1400000US48353950300,48353950300,"Census Tract 9503, Nolan County, Texas",2061,316,1121,199,940,305
1400000US48353950400,48353950400,"Census Tract 9504, Nolan County, Texas",4590,403,2395,321,2195,310
1400000US48353950500,48353950500,"Census Tract 9505, Nolan County, Texas",2580,268,2017,239,563,161
1400000US48355000500,48355000500,"Census Tract 5, Nueces County, Texas",1074,318,623,273,451,182
1400000US48355000600,48355000600,"Census Tract 6, Nueces County, Texas",7336,939,1304,344,6032,891
1400000US48355000700,48355000700,"Census Tract 7, Nueces County, Texas",4185,519,1001,306,3184,407
1400000US48355000800,48355000800,"Census Tract 8, Nueces County, Texas",4956,594,1194,366,3762,563
1400000US48355000900,48355000900,"Census Tract 9, Nueces County, Texas",3772,642,81,69,3691,651
1400000US48355001000,48355001000,"Census Tract 10, Nueces County, Texas",3097,587,225,137,2872,541
1400000US48355001100,48355001100,"Census Tract 11, Nueces County, Texas",1929,327,274,141,1655,339
1400000US48355001200,48355001200,"Census Tract 12, Nueces County, Texas",3991,560,1344,291,2647,421
1400000US48355001300,48355001300,"Census Tract 13, Nueces County, Texas",3849,448,188,125,3661,486
1400000US48355001400,48355001400,"Census Tract 14, Nueces County, Texas",4409,353,2648,335,1761,367
1400000US48355001500,48355001500,"Census Tract 15, Nueces County, Texas",4229,414,665,229,3564,339
1400000US48355001601,48355001601,"Census Tract 16.01, Nueces County, Texas",4760,578,705,314,4055,581
1400000US48355001602,48355001602,"Census Tract 16.02, Nueces County, Texas",4097,386,265,154,3832,369
1400000US48355001701,48355001701,"Census Tract 17.01, Nueces County, Texas",6246,679,1082,388,5164,807
1400000US48355001702,48355001702,"Census Tract 17.02, Nueces County, Texas",2112,461,330,164,1782,492
1400000US48355001801,48355001801,"Census Tract 18.01, Nueces County, Texas",5516,602,578,157,4938,606
1400000US48355001802,48355001802,"Census Tract 18.02, Nueces County, Texas",2306,296,280,149,2026,300
1400000US48355001902,48355001902,"Census Tract 19.02, Nueces County, Texas",7786,798,1225,275,6561,806
1400000US48355001903,48355001903,"Census Tract 19.03, Nueces County, Texas",3764,400,404,163,3360,412
1400000US48355001904,48355001904,"Census Tract 19.04, Nueces County, Texas",4567,518,353,187,4214,508
1400000US48355002001,48355002001,"Census Tract 20.01, Nueces County, Texas",4108,491,554,249,3554,490
1400000US48355002002,48355002002,"Census Tract 20.02, Nueces County, Texas",4221,505,397,163,3824,517
1400000US48355002101,48355002101,"Census Tract 21.01, Nueces County, Texas",4067,392,1478,476,2589,428
1400000US48355002102,48355002102,"Census Tract 21.02, Nueces County, Texas",3127,413,2152,274,975,384
1400000US48355002200,48355002200,"Census Tract 22, Nueces County, Texas",5613,521,1387,295,4226,444
1400000US48355002301,48355002301,"Census Tract 23.01, Nueces County, Texas",4093,391,863,190,3230,397
1400000US48355002303,48355002303,"Census Tract 23.03, Nueces County, Texas",4176,377,1172,290,3004,458
1400000US48355002304,48355002304,"Census Tract 23.04, Nueces County, Texas",5401,510,1663,389,3738,517
1400000US48355002400,48355002400,"Census Tract 24, Nueces County, Texas",6349,475,2215,323,4134,445
1400000US48355002500,48355002500,"Census Tract 25, Nueces County, Texas",4157,432,2789,286,1368,377
1400000US48355002601,48355002601,"Census Tract 26.01, Nueces County, Texas",2158,224,1679,267,479,229
1400000US48355002602,48355002602,"Census Tract 26.02, Nueces County, Texas",2063,329,549,233,1514,372
1400000US48355002603,48355002603,"Census Tract 26.03, Nueces County, Texas",3130,287,1526,242,1604,292
1400000US48355002703,48355002703,"Census Tract 27.03, Nueces County, Texas",5317,429,2539,379,2778,417
1400000US48355002704,48355002704,"Census Tract 27.04, Nueces County, Texas",4556,468,2993,428,1563,324
1400000US48355002705,48355002705,"Census Tract 27.05, Nueces County, Texas",5031,533,3621,514,1410,392
1400000US48355002706,48355002706,"Census Tract 27.06, Nueces County, Texas",1300,258,850,216,450,88
1400000US48355002900,48355002900,"Census Tract 29, Nueces County, Texas",1947,1837,1932,1837,15,24
1400000US48355003001,48355003001,"Census Tract 30.01, Nueces County, Texas",4535,582,3107,408,1428,376
1400000US48355003002,48355003002,"Census Tract 30.02, Nueces County, Texas",5129,642,3283,533,1846,471
1400000US48355003101,48355003101,"Census Tract 31.01, Nueces County, Texas",6392,646,5158,604,1234,443
1400000US48355003102,48355003102,"Census Tract 31.02, Nueces County, Texas",5268,531,3301,293,1967,527
1400000US48355003202,48355003202,"Census Tract 32.02, Nueces County, Texas",5263,473,2407,422,2856,406
1400000US48355003203,48355003203,"Census Tract 32.03, Nueces County, Texas",5055,373,1527,316,3528,372
1400000US48355003204,48355003204,"Census Tract 32.04, Nueces County, Texas",4443,444,2253,320,2190,497
1400000US48355003303,48355003303,"Census Tract 33.03, Nueces County, Texas",995,304,203,142,792,271
1400000US48355003304,48355003304,"Census Tract 33.04, Nueces County, Texas",6096,529,3058,463,3038,561
1400000US48355003305,48355003305,"Census Tract 33.05, Nueces County, Texas",4654,509,1323,336,3331,534
1400000US48355003306,48355003306,"Census Tract 33.06, Nueces County, Texas",4199,535,1817,310,2382,550
1400000US48355003401,48355003401,"Census Tract 34.01, Nueces County, Texas",4128,441,1712,301,2416,386
1400000US48355003402,48355003402,"Census Tract 34.02, Nueces County, Texas",5901,499,2669,355,3232,477
1400000US48355003500,48355003500,"Census Tract 35, Nueces County, Texas",2276,432,695,270,1581,376
1400000US48355003601,48355003601,"Census Tract 36.01, Nueces County, Texas",6068,723,3459,443,2609,729
1400000US48355003602,48355003602,"Census Tract 36.02, Nueces County, Texas",6588,613,3260,442,3328,648
1400000US48355003603,48355003603,"Census Tract 36.03, Nueces County, Texas",3359,336,1739,287,1620,445
1400000US48355003700,48355003700,"Census Tract 37, Nueces County, Texas",3391,424,1516,304,1875,430
1400000US48355005102,48355005102,"Census Tract 51.02, Nueces County, Texas",3082,185,2662,253,420,236
1400000US48355005404,48355005404,"Census Tract 54.04, Nueces County, Texas",2034,267,1191,229,843,173
1400000US48355005406,48355005406,"Census Tract 54.06, Nueces County, Texas",2633,397,1357,192,1276,352
1400000US48355005407,48355005407,"Census Tract 54.07, Nueces County, Texas",2226,252,915,239,1311,263
1400000US48355005408,48355005408,"Census Tract 54.08, Nueces County, Texas",3761,474,1869,252,1892,503
1400000US48355005409,48355005409,"Census Tract 54.09, Nueces County, Texas",3977,269,2029,286,1948,296
1400000US48355005410,48355005410,"Census Tract 54.10, Nueces County, Texas",4259,424,1740,534,2519,608
1400000US48355005411,48355005411,"Census Tract 54.11, Nueces County, Texas",4146,491,1691,400,2455,533
1400000US48355005412,48355005412,"Census Tract 54.12, Nueces County, Texas",5031,396,3304,478,1727,366
1400000US48355005413,48355005413,"Census Tract 54.13, Nueces County, Texas",2299,315,1309,215,990,231
1400000US48355005414,48355005414,"Census Tract 54.14, Nueces County, Texas",1613,190,945,95,668,182
1400000US48355005415,48355005415,"Census Tract 54.15, Nueces County, Texas",4267,328,2324,309,1943,276
1400000US48355005416,48355005416,"Census Tract 54.16, Nueces County, Texas",3384,200,2429,171,955,148
1400000US48355005417,48355005417,"Census Tract 54.17, Nueces County, Texas",3945,351,2025,238,1920,304
1400000US48355005601,48355005601,"Census Tract 56.01, Nueces County, Texas",6688,504,505,205,6183,519
1400000US48355005602,48355005602,"Census Tract 56.02, Nueces County, Texas",6672,685,602,306,6070,698
1400000US48355005801,48355005801,"Census Tract 58.01, Nueces County, Texas",6485,495,4797,415,1688,498
1400000US48355005802,48355005802,"Census Tract 58.02, Nueces County, Texas",5638,626,2567,412,3071,513
1400000US48355005900,48355005900,"Census Tract 59, Nueces County, Texas",3367,386,604,294,2763,471
1400000US48355006000,48355006000,"Census Tract 60, Nueces County, Texas",2439,370,590,241,1849,365
1400000US48355006100,48355006100,"Census Tract 61, Nueces County, Texas",3374,96,1141,193,2233,215
1400000US48355006200,48355006200,"Census Tract 62, Nueces County, Texas",9483,837,7707,635,1776,616
1400000US48355006300,48355006300,"Census Tract 63, Nueces County, Texas",2756,345,1283,228,1473,328
1400000US48355006400,48355006400,"Census Tract 64, Nueces County, Texas",2276,690,1239,363,1037,382
1400000US48355980000,48355980000,"Census Tract 9800, Nueces County, Texas",0,127,0,127,0,127
1400000US48355990000,48355990000,"Census Tract 9900, Nueces County, Texas",0,127,0,127,0,127
1400000US48357950100,48357950100,"Census Tract 9501, Ochiltree County, Texas",1509,322,1163,313,346,263
1400000US48357950300,48357950300,"Census Tract 9503, Ochiltree County, Texas",3919,373,1598,287,2321,279
1400000US48357950400,48357950400,"Census Tract 9504, Ochiltree County, Texas",4525,342,2724,296,1801,238
1400000US48359950100,48359950100,"Census Tract 9501, Oldham County, Texas",2020,,1810,79,210,79
1400000US48361020200,48361020200,"Census Tract 202, Orange County, Texas",3609,391,3578,384,31,39
1400000US48361020300,48361020300,"Census Tract 203, Orange County, Texas",2569,408,2454,421,115,89
1400000US48361020500,48361020500,"Census Tract 205, Orange County, Texas",3389,188,3185,252,204,195
1400000US48361020700,48361020700,"Census Tract 207, Orange County, Texas",5017,364,4809,379,208,128
1400000US48361020800,48361020800,"Census Tract 208, Orange County, Texas",1810,252,1724,249,86,105
1400000US48361020900,48361020900,"Census Tract 209, Orange County, Texas",3531,353,3139,351,392,341
1400000US48361021000,48361021000,"Census Tract 210, Orange County, Texas",2212,236,2110,210,102,77
1400000US48361021100,48361021100,"Census Tract 211, Orange County, Texas",1921,194,1840,199,81,73
1400000US48361021200,48361021200,"Census Tract 212, Orange County, Texas",4394,411,4221,414,173,114
1400000US48361021300,48361021300,"Census Tract 213, Orange County, Texas",5811,439,5551,378,260,169
1400000US48361021400,48361021400,"Census Tract 214, Orange County, Texas",3505,331,3409,325,96,128
1400000US48361021501,48361021501,"Census Tract 215.01, Orange County, Texas",2626,311,2144,306,482,296
1400000US48361021502,48361021502,"Census Tract 215.02, Orange County, Texas",7496,555,7261,593,235,158
1400000US48361021600,48361021600,"Census Tract 216, Orange County, Texas",3602,417,3492,412,110,68
1400000US48361021700,48361021700,"Census Tract 217, Orange County, Texas",2604,388,2467,410,137,135
1400000US48361021800,48361021800,"Census Tract 218, Orange County, Texas",2799,282,2689,285,110,120
1400000US48361021900,48361021900,"Census Tract 219, Orange County, Texas",6303,675,6130,690,173,136
1400000US48361022000,48361022000,"Census Tract 220, Orange County, Texas",3859,437,3493,466,366,211
1400000US48361022200,48361022200,"Census Tract 222, Orange County, Texas",3190,346,3115,348,75,80
1400000US48361022300,48361022300,"Census Tract 223, Orange County, Texas",6473,577,5788,524,685,280
1400000US48361022400,48361022400,"Census Tract 224, Orange County, Texas",5294,603,4965,564,329,244
1400000US48363000100,48363000100,"Census Tract 1, Palo Pinto County, Texas",2598,335,2428,358,170,150
1400000US48363000200,48363000200,"Census Tract 2, Palo Pinto County, Texas",1968,205,1669,214,299,120
1400000US48363000300,48363000300,"Census Tract 3, Palo Pinto County, Texas",3893,305,3695,304,198,133
1400000US48363000400,48363000400,"Census Tract 4, Palo Pinto County, Texas",5988,458,5665,466,323,179
1400000US48363000500,48363000500,"Census Tract 5, Palo Pinto County, Texas",1661,266,1539,256,122,121
1400000US48363000600,48363000600,"Census Tract 6, Palo Pinto County, Texas",3309,354,2522,255,787,194
1400000US48363000700,48363000700,"Census Tract 7, Palo Pinto County, Texas",3037,338,2244,254,793,207
1400000US48363000800,48363000800,"Census Tract 8, Palo Pinto County, Texas",3121,329,1820,287,1301,250
1400000US48363000900,48363000900,"Census Tract 9, Palo Pinto County, Texas",2352,358,1608,285,744,254
1400000US48365950100,48365950100,"Census Tract 9501, Panola County, Texas",3763,451,3763,451,0,127
1400000US48365950200,48365950200,"Census Tract 9502, Panola County, Texas",2988,374,2861,358,127,109
1400000US48365950300,48365950300,"Census Tract 9503, Panola County, Texas",5259,482,4171,508,1088,315
1400000US48365950400,48365950400,"Census Tract 9504, Panola County, Texas",7040,377,6610,345,430,241
1400000US48365950500,48365950500,"Census Tract 9505, Panola County, Texas",2517,341,2509,340,8,12
1400000US48365950600,48365950600,"Census Tract 9506, Panola County, Texas",2002,263,1929,277,73,86
1400000US48367140101,48367140101,"Census Tract 1401.01, Parker County, Texas",4178,460,3249,423,929,268
1400000US48367140102,48367140102,"Census Tract 1401.02, Parker County, Texas",5022,543,4217,653,805,465
1400000US48367140200,48367140200,"Census Tract 1402, Parker County, Texas",6466,1161,5779,1029,687,271
1400000US48367140300,48367140300,"Census Tract 1403, Parker County, Texas",5705,616,4891,570,814,381
1400000US48367140403,48367140403,"Census Tract 1404.03, Parker County, Texas",5391,470,4990,495,401,125
1400000US48367140405,48367140405,"Census Tract 1404.05, Parker County, Texas",6172,520,5839,505,333,232
1400000US48367140407,48367140407,"Census Tract 1404.07, Parker County, Texas",9766,564,8710,593,1056,290
1400000US48367140408,48367140408,"Census Tract 1404.08, Parker County, Texas",4044,363,3876,377,168,118
1400000US48367140409,48367140409,"Census Tract 1404.09, Parker County, Texas",3494,425,3022,443,472,339
1400000US48367140410,48367140410,"Census Tract 1404.10, Parker County, Texas",3427,463,2919,358,508,415
1400000US48367140411,48367140411,"Census Tract 1404.11, Parker County, Texas",4493,738,4133,685,360,386
1400000US48367140501,48367140501,"Census Tract 1405.01, Parker County, Texas",6656,457,6029,393,627,242
1400000US48367140502,48367140502,"Census Tract 1405.02, Parker County, Texas",6779,487,5964,418,815,189
1400000US48367140601,48367140601,"Census Tract 1406.01, Parker County, Texas",6403,551,5909,492,494,276
1400000US48367140602,48367140602,"Census Tract 1406.02, Parker County, Texas",8286,684,7542,655,744,330
1400000US48367140703,48367140703,"Census Tract 1407.03, Parker County, Texas",6463,468,5990,435,473,188
1400000US48367140704,48367140704,"Census Tract 1407.04, Parker County, Texas",6733,405,6283,424,450,185
1400000US48367140705,48367140705,"Census Tract 1407.05, Parker County, Texas",6780,439,6007,414,773,281
1400000US48367140706,48367140706,"Census Tract 1407.06, Parker County, Texas",5900,313,5540,280,360,166
1400000US48369950200,48369950200,"Census Tract 9502, Parmer County, Texas",4849,299,1820,253,3029,224
1400000US48369950300,48369950300,"Census Tract 9503, Parmer County, Texas",5249,299,2508,253,2741,224
1400000US48371950100,48371950100,"Census Tract 9501, Pecos County, Texas",1794,417,933,252,861,237
1400000US48371950300,48371950300,"Census Tract 9503, Pecos County, Texas",3108,337,238,118,2870,318
1400000US48371950400,48371950400,"Census Tract 9504, Pecos County, Texas",4447,365,1424,251,3023,329
1400000US48371950500,48371950500,"Census Tract 9505, Pecos County, Texas",6051,432,2789,335,3262,342
1400000US48373210101,48373210101,"Census Tract 2101.01, Polk County, Texas",4230,408,3767,441,463,243
1400000US48373210102,48373210102,"Census Tract 2101.02, Polk County, Texas",7098,681,6669,672,429,165
1400000US48373210203,48373210203,"Census Tract 2102.03, Polk County, Texas",6102,501,4944,461,1158,306
1400000US48373210204,48373210204,"Census Tract 2102.04, Polk County, Texas",4368,626,3657,554,711,219
1400000US48373210205,48373210205,"Census Tract 2102.05, Polk County, Texas",2675,523,2505,508,170,111
1400000US48373210206,48373210206,"Census Tract 2102.06, Polk County, Texas",4159,477,4075,487,84,61
1400000US48373210301,48373210301,"Census Tract 2103.01, Polk County, Texas",3546,505,3410,470,136,107
1400000US48373210302,48373210302,"Census Tract 2103.02, Polk County, Texas",4469,526,4085,484,384,222
1400000US48373210400,48373210400,"Census Tract 2104, Polk County, Texas",4589,551,3322,449,1267,348
1400000US48373210500,48373210500,"Census Tract 2105, Polk County, Texas",4354,457,3623,426,731,234
1400000US48375010100,48375010100,"Census Tract 101, Potter County, Texas",1532,250,1372,266,160,88
1400000US48375010200,48375010200,"Census Tract 102, Potter County, Texas",1999,186,1838,199,161,117
1400000US48375010300,48375010300,"Census Tract 103, Potter County, Texas",1142,220,880,217,262,149
1400000US48375010400,48375010400,"Census Tract 104, Potter County, Texas",3224,284,2908,291,316,213
1400000US48375010600,48375010600,"Census Tract 106, Potter County, Texas",2277,351,427,143,1850,406
1400000US48375010700,48375010700,"Census Tract 107, Potter County, Texas",3402,475,1522,309,1880,366
1400000US48375011000,48375011000,"Census Tract 110, Potter County, Texas",2446,298,645,188,1801,248
1400000US48375011500,48375011500,"Census Tract 115, Potter County, Texas",4012,579,3424,498,588,250
1400000US48375011600,48375011600,"Census Tract 116, Potter County, Texas",3895,389,3070,358,825,291
1400000US48375011700,48375011700,"Census Tract 117, Potter County, Texas",3893,385,2878,348,1015,322
1400000US48375011800,48375011800,"Census Tract 118, Potter County, Texas",4145,388,3341,335,804,308
1400000US48375011900,48375011900,"Census Tract 119, Potter County, Texas",3204,492,2152,380,1052,348
1400000US48375012000,48375012000,"Census Tract 120, Potter County, Texas",1659,316,1099,172,560,295
1400000US48375012200,48375012200,"Census Tract 122, Potter County, Texas",3771,402,1124,280,2647,413
1400000US48375012600,48375012600,"Census Tract 126, Potter County, Texas",3303,492,836,184,2467,518
1400000US48375012800,48375012800,"Census Tract 128, Potter County, Texas",4348,549,1599,336,2749,491
1400000US48375013000,48375013000,"Census Tract 130, Potter County, Texas",1740,310,1710,308,30,47
1400000US48375013200,48375013200,"Census Tract 132, Potter County, Texas",1891,342,1646,332,245,179
1400000US48375013300,48375013300,"Census Tract 133, Potter County, Texas",4793,335,4410,330,383,155
1400000US48375013400,48375013400,"Census Tract 134, Potter County, Texas",4780,423,4576,415,204,120
1400000US48375013900,48375013900,"Census Tract 139, Potter County, Texas",3507,323,2465,304,1042,227
1400000US48375014100,48375014100,"Census Tract 141, Potter County, Texas",2791,419,1904,377,887,216
1400000US48375014300,48375014300,"Census Tract 143, Potter County, Texas",6932,538,6709,549,223,168
1400000US48375014401,48375014401,"Census Tract 144.01, Potter County, Texas",3579,391,2634,291,945,218
1400000US48375014500,48375014500,"Census Tract 145, Potter County, Texas",5479,661,1799,319,3680,637
1400000US48375014700,48375014700,"Census Tract 147, Potter County, Texas",4780,591,3552,496,1228,372
1400000US48375014800,48375014800,"Census Tract 148, Potter County, Texas",3292,495,1968,373,1324,502
1400000US48375014900,48375014900,"Census Tract 149, Potter County, Texas",6226,554,4111,626,2115,399
1400000US48375015000,48375015000,"Census Tract 150, Potter County, Texas",7170,704,3268,458,3902,702
1400000US48375015100,48375015100,"Census Tract 151, Potter County, Texas",3589,322,2944,341,645,283
1400000US48375015200,48375015200,"Census Tract 152, Potter County, Texas",2909,272,2486,335,423,191
1400000US48375015300,48375015300,"Census Tract 153, Potter County, Texas",5454,596,2993,474,2461,589
1400000US48375015400,48375015400,"Census Tract 154, Potter County, Texas",2960,356,809,276,2151,344
1400000US48375980000,48375980000,"Census Tract 9800, Potter County, Texas",0,127,0,127,0,127
1400000US48377950100,48377950100,"Census Tract 9501, Presidio County, Texas",2842,242,1087,247,1755,278
1400000US48377950200,48377950200,"Census Tract 9502, Presidio County, Texas",4861,242,235,188,4626,300
1400000US48379950100,48379950100,"Census Tract 9501, Rains County, Texas",6264,407,5570,418,694,83
1400000US48379950200,48379950200,"Census Tract 9502, Rains County, Texas",4678,407,4565,418,113,83
1400000US48381020100,48381020100,"Census Tract 201, Randall County, Texas",2196,146,2096,168,100,93
1400000US48381020200,48381020200,"Census Tract 202, Randall County, Texas",2017,186,1644,213,373,156
1400000US48381020300,48381020300,"Census Tract 203, Randall County, Texas",2335,222,1738,216,597,204
1400000US48381020400,48381020400,"Census Tract 204, Randall County, Texas",1829,154,1412,241,417,215
1400000US48381020500,48381020500,"Census Tract 205, Randall County, Texas",4102,372,3022,346,1080,253
1400000US48381020600,48381020600,"Census Tract 206, Randall County, Texas",3854,302,2353,348,1501,335
1400000US48381020800,48381020800,"Census Tract 208, Randall County, Texas",6305,465,5334,427,971,234
1400000US48381020900,48381020900,"Census Tract 209, Randall County, Texas",3119,629,2460,635,659,211
1400000US48381021000,48381021000,"Census Tract 210, Randall County, Texas",2549,230,1874,217,675,181
1400000US48381021101,48381021101,"Census Tract 211.01, Randall County, Texas",3959,457,3701,455,258,164
1400000US48381021102,48381021102,"Census Tract 211.02, Randall County, Texas",2004,372,1439,363,565,209
1400000US48381021200,48381021200,"Census Tract 212, Randall County, Texas",5272,447,4495,388,777,343
1400000US48381021300,48381021300,"Census Tract 213, Randall County, Texas",5505,434,4763,450,742,233
1400000US48381021500,48381021500,"Census Tract 215, Randall County, Texas",4694,313,4258,315,436,152
1400000US48381021602,48381021602,"Census Tract 216.02, Randall County, Texas",5619,355,5033,380,586,269
1400000US48381021603,48381021603,"Census Tract 216.03, Randall County, Texas",1965,113,1784,170,181,114
1400000US48381021604,48381021604,"Census Tract 216.04, Randall County, Texas",4462,418,4184,401,278,124
1400000US48381021605,48381021605,"Census Tract 216.05, Randall County, Texas",2032,169,1869,187,163,82
1400000US48381021606,48381021606,"Census Tract 216.06, Randall County, Texas",5594,345,5231,375,363,204
1400000US48381021608,48381021608,"Census Tract 216.08, Randall County, Texas",4621,410,4294,406,327,123
1400000US48381021609,48381021609,"Census Tract 216.09, Randall County, Texas",2312,147,2154,159,158,107
1400000US48381021702,48381021702,"Census Tract 217.02, Randall County, Texas",3959,339,3350,285,609,217
1400000US48381021703,48381021703,"Census Tract 217.03, Randall County, Texas",7251,605,5795,565,1456,509
1400000US48381021704,48381021704,"Census Tract 217.04, Randall County, Texas",5948,462,5473,466,475,172
1400000US48381021801,48381021801,"Census Tract 218.01, Randall County, Texas",6477,434,5370,490,1107,325
1400000US48381021802,48381021802,"Census Tract 218.02, Randall County, Texas",5421,427,4833,409,588,191
1400000US48381021900,48381021900,"Census Tract 219, Randall County, Texas",3552,369,3096,392,456,286
1400000US48381022001,48381022001,"Census Tract 220.01, Randall County, Texas",3058,257,2486,260,572,201
1400000US48381022002,48381022002,"Census Tract 220.02, Randall County, Texas",4800,469,3504,456,1296,336
1400000US48383950100,48383950100,"Census Tract 9501, Reagan County, Texas",3298,,1329,169,1969,169
1400000US48385950100,48385950100,"Census Tract 9501, Real County, Texas",3279,,2541,137,738,137
1400000US48387950100,48387950100,"Census Tract 9501, Red River County, Texas",2687,254,2513,244,174,95
1400000US48387950500,48387950500,"Census Tract 9505, Red River County, Texas",4608,255,4162,274,446,147
1400000US48387950600,48387950600,"Census Tract 9506, Red River County, Texas",2829,258,2816,258,13,17
1400000US48387950700,48387950700,"Census Tract 9507, Red River County, Texas",2863,324,2719,315,144,140
1400000US48389950100,48389950100,"Census Tract 9501, Reeves County, Texas",3119,449,425,296,2694,489
1400000US48389950200,48389950200,"Census Tract 9502, Reeves County, Texas",2202,443,150,112,2052,412
1400000US48389950300,48389950300,"Census Tract 9503, Reeves County, Texas",2166,479,228,170,1938,477
1400000US48389950400,48389950400,"Census Tract 9504, Reeves County, Texas",3940,448,769,228,3171,452
1400000US48389950500,48389950500,"Census Tract 9505, Reeves County, Texas",1842,421,402,197,1440,361
1400000US48391950200,48391950200,"Census Tract 9502, Refugio County, Texas",3701,251,1982,210,1719,195
1400000US48391950400,48391950400,"Census Tract 9504, Refugio County, Texas",3733,251,2081,210,1652,195
1400000US48393950100,48393950100,"Census Tract 9501, Roberts County, Texas",877,121,856,116,21,39
1400000US48395960100,48395960100,"Census Tract 9601, Robertson County, Texas",2260,350,2234,345,26,28
1400000US48395960200,48395960200,"Census Tract 9602, Robertson County, Texas",1438,198,1194,168,244,125
1400000US48395960300,48395960300,"Census Tract 9603, Robertson County, Texas",4296,410,4163,404,133,84
1400000US48395960400,48395960400,"Census Tract 9604, Robertson County, Texas",3088,401,2507,385,581,197
1400000US48395960500,48395960500,"Census Tract 9605, Robertson County, Texas",5492,327,3686,362,1806,227
1400000US48397040101,48397040101,"Census Tract 401.01, Rockwall County, Texas",6031,325,5613,355,418,163
1400000US48397040102,48397040102,"Census Tract 401.02, Rockwall County, Texas",6242,414,5569,437,673,224
1400000US48397040200,48397040200,"Census Tract 402, Rockwall County, Texas",3807,264,3495,304,312,165
1400000US48397040301,48397040301,"Census Tract 403.01, Rockwall County, Texas",5580,345,4614,403,966,325
1400000US48397040302,48397040302,"Census Tract 403.02, Rockwall County, Texas",6727,443,6156,432,571,282
1400000US48397040401,48397040401,"Census Tract 404.01, Rockwall County, Texas",8596,609,6986,588,1610,343
1400000US48397040402,48397040402,"Census Tract 404.02, Rockwall County, Texas",7767,484,6566,463,1201,262
1400000US48397040503,48397040503,"Census Tract 405.03, Rockwall County, Texas",7023,526,4042,487,2981,588
1400000US48397040504,48397040504,"Census Tract 405.04, Rockwall County, Texas",5879,424,5334,466,545,265
1400000US48397040505,48397040505,"Census Tract 405.05, Rockwall County, Texas",9386,653,7856,610,1530,338
1400000US48397040506,48397040506,"Census Tract 405.06, Rockwall County, Texas",6273,489,5812,451,461,199
1400000US48399950100,48399950100,"Census Tract 9501, Runnels County, Texas",1037,176,953,188,84,61
1400000US48399950200,48399950200,"Census Tract 9502, Runnels County, Texas",2432,109,1440,174,992,169
1400000US48399950500,48399950500,"Census Tract 9505, Runnels County, Texas",2025,309,1483,332,542,175
1400000US48399950600,48399950600,"Census Tract 9506, Runnels County, Texas",4998,373,3385,430,1613,233
1400000US48401950100,48401950100,"Census Tract 9501, Rusk County, Texas",5979,644,4932,547,1047,425
1400000US48401950200,48401950200,"Census Tract 9502, Rusk County, Texas",3249,303,3019,305,230,182
1400000US48401950300,48401950300,"Census Tract 9503, Rusk County, Texas",6029,543,5430,496,599,273
1400000US48401950400,48401950400,"Census Tract 9504, Rusk County, Texas",5474,1111,4789,939,685,301
1400000US48401950501,48401950501,"Census Tract 9505.01, Rusk County, Texas",4485,495,3762,422,723,257
1400000US48401950502,48401950502,"Census Tract 9505.02, Rusk County, Texas",4634,521,4086,506,548,173
1400000US48401950600,48401950600,"Census Tract 9506, Rusk County, Texas",1971,318,1930,315,41,45
1400000US48401950700,48401950700,"Census Tract 9507, Rusk County, Texas",4185,446,3753,394,432,166
1400000US48401950800,48401950800,"Census Tract 9508, Rusk County, Texas",4271,425,3564,404,707,212
1400000US48401950900,48401950900,"Census Tract 9509, Rusk County, Texas",4058,381,3615,360,443,162
1400000US48401951000,48401951000,"Census Tract 9510, Rusk County, Texas",2755,367,1764,313,991,311
1400000US48401951100,48401951100,"Census Tract 9511, Rusk County, Texas",2542,282,2296,276,246,123
1400000US48401951200,48401951200,"Census Tract 9512, Rusk County, Texas",2384,345,2239,317,145,97
1400000US48403950100,48403950100,"Census Tract 9501, Sabine County, Texas",2529,471,2519,472,10,17
1400000US48403950200,48403950200,"Census Tract 9502, Sabine County, Texas",2967,496,2859,486,108,58
1400000US48403950300,48403950300,"Census Tract 9503, Sabine County, Texas",5157,541,4971,534,186,63
1400000US48405950100,48405950100,"Census Tract 9501, San Augustine County, Texas",3114,467,3103,465,11,21
1400000US48405950200,48405950200,"Census Tract 9502, San Augustine County, Texas",3048,326,2584,325,464,20
1400000US48405950300,48405950300,"Census Tract 9503, San Augustine County, Texas",2834,397,2834,397,0,127
1400000US48407200101,48407200101,"Census Tract 2001.01, San Jacinto County, Texas",7266,674,6468,681,798,325
1400000US48407200102,48407200102,"Census Tract 2001.02, San Jacinto County, Texas",8962,689,7733,683,1229,291
1400000US48407200200,48407200200,"Census Tract 2002, San Jacinto County, Texas",4167,648,4006,633,161,116
1400000US48407200300,48407200300,"Census Tract 2003, San Jacinto County, Texas",5464,528,5126,559,338,142
1400000US48409010201,48409010201,"Census Tract 102.01, San Patricio County, Texas",3730,469,2286,508,1444,451
1400000US48409010202,48409010202,"Census Tract 102.02, San Patricio County, Texas",4934,596,2704,498,2230,549
1400000US48409010301,48409010301,"Census Tract 103.01, San Patricio County, Texas",4253,678,2596,582,1657,396
1400000US48409010302,48409010302,"Census Tract 103.02, San Patricio County, Texas",5440,729,3428,894,2012,457
1400000US48409010500,48409010500,"Census Tract 105, San Patricio County, Texas",1573,195,76,38,1497,200
1400000US48409010601,48409010601,"Census Tract 106.01, San Patricio County, Texas",4787,445,2923,400,1864,390
1400000US48409010602,48409010602,"Census Tract 106.02, San Patricio County, Texas",4116,324,2516,276,1600,390
1400000US48409010603,48409010603,"Census Tract 106.03, San Patricio County, Texas",2638,261,2217,224,421,141
1400000US48409010604,48409010604,"Census Tract 106.04, San Patricio County, Texas",3245,250,2370,236,875,263
1400000US48409010700,48409010700,"Census Tract 107, San Patricio County, Texas",3702,562,2336,329,1366,478
1400000US48409010800,48409010800,"Census Tract 108, San Patricio County, Texas",5268,416,1042,281,4226,405
1400000US48409010900,48409010900,"Census Tract 109, San Patricio County, Texas",4604,578,2057,397,2547,579
1400000US48409011000,48409011000,"Census Tract 110, San Patricio County, Texas",6788,416,1813,306,4975,474
1400000US48409011100,48409011100,"Census Tract 111, San Patricio County, Texas",2690,330,699,177,1991,300
1400000US48409011200,48409011200,"Census Tract 112, San Patricio County, Texas",2999,458,1454,264,1545,423
1400000US48409011300,48409011300,"Census Tract 113, San Patricio County, Texas",5333,234,562,158,4771,293
1400000US48411950100,48411950100,"Census Tract 9501, San Saba County, Texas",2959,243,2024,221,935,204
1400000US48411950200,48411950200,"Census Tract 9502, San Saba County, Texas",3064,243,2434,221,630,204
1400000US48413950300,48413950300,"Census Tract 9503, Schleicher County, Texas",3343,171,1878,150,1465,117
1400000US48415950100,48415950100,"Census Tract 9501, Scurry County, Texas",4446,346,2482,292,1964,312
1400000US48415950200,48415950200,"Census Tract 9502, Scurry County, Texas",1333,249,1160,231,173,122
1400000US48415950300,48415950300,"Census Tract 9503, Scurry County, Texas",5558,449,4175,384,1383,280
1400000US48415950600,48415950600,"Census Tract 9506, Scurry County, Texas",5242,548,3079,420,2163,332
1400000US48417950300,48417950300,"Census Tract 9503, Shackelford County, Texas",3182,146,2879,145,303,59
1400000US48419950100,48419950100,"Census Tract 9501, Shelby County, Texas",4864,542,4071,517,793,410
1400000US48419950200,48419950200,"Census Tract 9502, Shelby County, Texas",3520,445,3121,385,399,303
1400000US48419950300,48419950300,"Census Tract 9503, Shelby County, Texas",4040,493,3687,450,353,256
1400000US48419950400,48419950400,"Census Tract 9504, Shelby County, Texas",6451,369,4482,527,1969,425
1400000US48419950500,48419950500,"Census Tract 9505, Shelby County, Texas",3287,440,3114,448,173,151
1400000US48419950600,48419950600,"Census Tract 9506, Shelby County, Texas",3261,415,3211,433,50,79
1400000US48421950200,48421950200,"Census Tract 9502, Sherman County, Texas",3000,,1925,79,1075,79
1400000US48423000100,48423000100,"Census Tract 1, Smith County, Texas",5967,638,3953,612,2014,357
1400000US48423000201,48423000201,"Census Tract 2.01, Smith County, Texas",3571,635,2985,587,586,440
1400000US48423000202,48423000202,"Census Tract 2.02, Smith County, Texas",2409,477,1657,384,752,397
1400000US48423000300,48423000300,"Census Tract 3, Smith County, Texas",5740,583,1730,350,4010,505
1400000US48423000400,48423000400,"Census Tract 4, Smith County, Texas",2255,349,1456,262,799,281
1400000US48423000500,48423000500,"Census Tract 5, Smith County, Texas",2197,442,1034,304,1163,364
1400000US48423000600,48423000600,"Census Tract 6, Smith County, Texas",2039,280,691,221,1348,287
1400000US48423000700,48423000700,"Census Tract 7, Smith County, Texas",4505,601,4125,571,380,282
1400000US48423000800,48423000800,"Census Tract 8, Smith County, Texas",6489,650,4378,454,2111,551
1400000US48423000900,48423000900,"Census Tract 9, Smith County, Texas",4729,607,3319,540,1410,321
1400000US48423001000,48423001000,"Census Tract 10, Smith County, Texas",5063,408,4082,448,981,356
1400000US48423001101,48423001101,"Census Tract 11.01, Smith County, Texas",4311,364,4227,341,84,59
1400000US48423001102,48423001102,"Census Tract 11.02, Smith County, Texas",2527,292,2404,307,123,114
1400000US48423001200,48423001200,"Census Tract 12, Smith County, Texas",3314,352,3045,308,269,170
1400000US48423001300,48423001300,"Census Tract 13, Smith County, Texas",2186,202,1914,227,272,189
1400000US48423001401,48423001401,"Census Tract 14.01, Smith County, Texas",8251,599,7919,586,332,146
1400000US48423001403,48423001403,"Census Tract 14.03, Smith County, Texas",6118,498,5731,521,387,164
1400000US48423001404,48423001404,"Census Tract 14.04, Smith County, Texas",5132,553,4860,542,272,329
1400000US48423001500,48423001500,"Census Tract 15, Smith County, Texas",5126,477,4893,459,233,121
1400000US48423001601,48423001601,"Census Tract 16.01, Smith County, Texas",5775,610,4011,477,1764,466
1400000US48423001602,48423001602,"Census Tract 16.02, Smith County, Texas",3869,363,3602,380,267,110
1400000US48423001604,48423001604,"Census Tract 16.04, Smith County, Texas",6345,636,4354,438,1991,582
1400000US48423001700,48423001700,"Census Tract 17, Smith County, Texas",8883,742,4329,720,4554,837
1400000US48423001801,48423001801,"Census Tract 18.01, Smith County, Texas",6552,595,5454,518,1098,434
1400000US48423001802,48423001802,"Census Tract 18.02, Smith County, Texas",6662,499,5785,499,877,345
1400000US48423001803,48423001803,"Census Tract 18.03, Smith County, Texas",4950,405,4693,425,257,161
1400000US48423001901,48423001901,"Census Tract 19.01, Smith County, Texas",5485,493,5219,518,266,162
1400000US48423001905,48423001905,"Census Tract 19.05, Smith County, Texas",7678,457,7431,466,247,176
1400000US48423001906,48423001906,"Census Tract 19.06, Smith County, Texas",5144,411,4838,404,306,92
1400000US48423001907,48423001907,"Census Tract 19.07, Smith County, Texas",6283,380,5930,438,353,207
1400000US48423001908,48423001908,"Census Tract 19.08, Smith County, Texas",9115,626,8710,567,405,215
1400000US48423002003,48423002003,"Census Tract 20.03, Smith County, Texas",4169,444,3607,474,562,264
1400000US48423002004,48423002004,"Census Tract 20.04, Smith County, Texas",2620,279,2483,323,137,159
1400000US48423002006,48423002006,"Census Tract 20.06, Smith County, Texas",3364,258,3364,258,0,127
1400000US48423002007,48423002007,"Census Tract 20.07, Smith County, Texas",6615,503,5994,490,621,289
1400000US48423002008,48423002008,"Census Tract 20.08, Smith County, Texas",5736,442,5482,435,254,157
1400000US48423002009,48423002009,"Census Tract 20.09, Smith County, Texas",6966,432,6586,439,380,313
1400000US48423002101,48423002101,"Census Tract 21.01, Smith County, Texas",3434,420,3077,391,357,186
1400000US48423002102,48423002102,"Census Tract 21.02, Smith County, Texas",5469,460,4961,541,508,292
1400000US48423002200,48423002200,"Census Tract 22, Smith County, Texas",6350,667,6167,671,183,114
1400000US48423980000,48423980000,"Census Tract 9800, Smith County, Texas",0,127,0,127,0,127
1400000US48425000100,48425000100,"Census Tract 1, Somervell County, Texas",6126,357,5335,229,791,337
1400000US48425000200,48425000200,"Census Tract 2, Somervell County, Texas",2074,357,1460,229,614,337
1400000US48427950101,48427950101,"Census Tract 9501.01, Starr County, Texas",1186,262,41,31,1145,258
1400000US48427950104,48427950104,"Census Tract 9501.04, Starr County, Texas",4047,513,44,41,4003,515
1400000US48427950105,48427950105,"Census Tract 9501.05, Starr County, Texas",3343,599,22,21,3321,602
1400000US48427950106,48427950106,"Census Tract 9501.06, Starr County, Texas",3760,506,45,64,3715,519
1400000US48427950107,48427950107,"Census Tract 9501.07, Starr County, Texas",3808,726,67,89,3741,715
1400000US48427950108,48427950108,"Census Tract 9501.08, Starr County, Texas",3887,909,260,215,3627,900
1400000US48427950202,48427950202,"Census Tract 9502.02, Starr County, Texas",2820,529,75,47,2745,540
1400000US48427950203,48427950203,"Census Tract 9502.03, Starr County, Texas",3114,508,0,127,3114,508
1400000US48427950204,48427950204,"Census Tract 9502.04, Starr County, Texas",5506,915,77,130,5429,949
1400000US48427950401,48427950401,"Census Tract 9504.01, Starr County, Texas",6514,755,8,13,6506,754
1400000US48427950402,48427950402,"Census Tract 9504.02, Starr County, Texas",5147,638,0,127,5147,638
1400000US48427950500,48427950500,"Census Tract 9505, Starr County, Texas",4214,606,67,65,4147,607
1400000US48427950600,48427950600,"Census Tract 9506, Starr County, Texas",5490,752,162,131,5328,754
1400000US48427950701,48427950701,"Census Tract 9507.01, Starr County, Texas",3905,522,82,73,3823,536
1400000US48427950702,48427950702,"Census Tract 9507.02, Starr County, Texas",3248,468,53,52,3195,468
1400000US48429950200,48429950200,"Census Tract 9502, Stephens County, Texas",3948,334,2980,329,968,193
1400000US48429950300,48429950300,"Census Tract 9503, Stephens County, Texas",2741,279,2165,285,576,195
1400000US48429950500,48429950500,"Census Tract 9505, Stephens County, Texas",2873,252,2588,243,285,119
1400000US48431950100,48431950100,"Census Tract 9501, Sterling County, Texas",1160,147,838,123,322,93
1400000US48433950300,48433950300,"Census Tract 9503, Stonewall County, Texas",1434,155,1324,150,110,70
1400000US48435950300,48435950300,"Census Tract 9503, Sutton County, Texas",4257,,1852,249,2405,249
1400000US48437950200,48437950200,"Census Tract 9502, Swisher County, Texas",2280,246,1631,208,649,135
1400000US48437950300,48437950300,"Census Tract 9503, Swisher County, Texas",4393,218,2499,216,1894,152
1400000US48437950400,48437950400,"Census Tract 9504, Swisher County, Texas",1155,180,742,148,413,129
1400000US48439100101,48439100101,"Census Tract 1001.01, Tarrant County, Texas",5485,466,1995,404,3490,470
1400000US48439100102,48439100102,"Census Tract 1001.02, Tarrant County, Texas",4605,537,1597,199,3008,576
1400000US48439100201,48439100201,"Census Tract 1002.01, Tarrant County, Texas",5160,747,605,266,4555,733
1400000US48439100202,48439100202,"Census Tract 1002.02, Tarrant County, Texas",5174,448,408,162,4766,472
1400000US48439100300,48439100300,"Census Tract 1003, Tarrant County, Texas",5075,572,775,182,4300,551
1400000US48439100400,48439100400,"Census Tract 1004, Tarrant County, Texas",8364,1036,401,229,7963,1070
1400000US48439100501,48439100501,"Census Tract 1005.01, Tarrant County, Texas",8332,798,2052,517,6280,852
1400000US48439100502,48439100502,"Census Tract 1005.02, Tarrant County, Texas",6968,873,1093,257,5875,890
1400000US48439100601,48439100601,"Census Tract 1006.01, Tarrant County, Texas",2110,342,2030,331,80,64
1400000US48439100602,48439100602,"Census Tract 1006.02, Tarrant County, Texas",3778,315,2522,353,1256,404
1400000US48439100700,48439100700,"Census Tract 1007, Tarrant County, Texas",4226,428,2139,276,2087,390
1400000US48439100800,48439100800,"Census Tract 1008, Tarrant County, Texas",5790,656,299,137,5491,674
1400000US48439100900,48439100900,"Census Tract 1009, Tarrant County, Texas",2101,425,45,37,2056,433
1400000US48439101201,48439101201,"Census Tract 1012.01, Tarrant County, Texas",1724,385,996,199,728,308
1400000US48439101202,48439101202,"Census Tract 1012.02, Tarrant County, Texas",4189,516,1602,305,2587,475
1400000US48439101301,48439101301,"Census Tract 1013.01, Tarrant County, Texas",4791,432,3611,442,1180,323
1400000US48439101302,48439101302,"Census Tract 1013.02, Tarrant County, Texas",3148,259,2141,308,1007,275
1400000US48439101401,48439101401,"Census Tract 1014.01, Tarrant County, Texas",4462,423,3270,310,1192,390
1400000US48439101402,48439101402,"Census Tract 1014.02, Tarrant County, Texas",3144,402,1158,328,1986,315
1400000US48439101403,48439101403,"Census Tract 1014.03, Tarrant County, Texas",4373,528,2307,506,2066,483
1400000US48439101500,48439101500,"Census Tract 1015, Tarrant County, Texas",4889,468,2528,496,2361,481
1400000US48439101700,48439101700,"Census Tract 1017, Tarrant County, Texas",2885,550,2479,564,406,132
1400000US48439102000,48439102000,"Census Tract 1020, Tarrant County, Texas",904,238,358,131,546,237
1400000US48439102100,48439102100,"Census Tract 1021, Tarrant County, Texas",5318,494,4048,406,1270,424
1400000US48439102201,48439102201,"Census Tract 1022.01, Tarrant County, Texas",3588,264,2693,234,895,272
1400000US48439102202,48439102202,"Census Tract 1022.02, Tarrant County, Texas",2649,300,2508,313,141,77
1400000US48439102301,48439102301,"Census Tract 1023.01, Tarrant County, Texas",3128,410,1988,288,1140,363
1400000US48439102302,48439102302,"Census Tract 1023.02, Tarrant County, Texas",4790,549,3060,563,1730,548
1400000US48439102401,48439102401,"Census Tract 1024.01, Tarrant County, Texas",4121,429,3662,384,459,226
1400000US48439102402,48439102402,"Census Tract 1024.02, Tarrant County, Texas",4510,249,4103,262,407,180
1400000US48439102500,48439102500,"Census Tract 1025, Tarrant County, Texas",3395,486,2547,432,848,311
1400000US48439102601,48439102601,"Census Tract 1026.01, Tarrant County, Texas",3511,378,2161,314,1350,343
1400000US48439102602,48439102602,"Census Tract 1026.02, Tarrant County, Texas",3662,438,1888,310,1774,398
1400000US48439102700,48439102700,"Census Tract 1027, Tarrant County, Texas",3260,365,2568,234,692,304
1400000US48439102800,48439102800,"Census Tract 1028, Tarrant County, Texas",1433,197,1301,192,132,116
1400000US48439103500,48439103500,"Census Tract 1035, Tarrant County, Texas",5572,849,1652,497,3920,636
1400000US48439103601,48439103601,"Census Tract 1036.01, Tarrant County, Texas",2358,522,1636,507,722,304
1400000US48439103602,48439103602,"Census Tract 1036.02, Tarrant County, Texas",2355,303,1903,231,452,228
1400000US48439103701,48439103701,"Census Tract 1037.01, Tarrant County, Texas",3855,494,928,207,2927,523
1400000US48439103702,48439103702,"Census Tract 1037.02, Tarrant County, Texas",3118,455,1247,289,1871,354
1400000US48439103800,48439103800,"Census Tract 1038, Tarrant County, Texas",3404,382,2279,363,1125,250
1400000US48439104100,48439104100,"Census Tract 1041, Tarrant County, Texas",3749,557,1922,283,1827,523
1400000US48439104201,48439104201,"Census Tract 1042.01, Tarrant County, Texas",7074,1833,6671,1805,403,159
1400000US48439104202,48439104202,"Census Tract 1042.02, Tarrant County, Texas",3156,287,2549,293,607,258
1400000US48439104300,48439104300,"Census Tract 1043, Tarrant County, Texas",5171,478,4021,396,1150,409
1400000US48439104400,48439104400,"Census Tract 1044, Tarrant County, Texas",5894,680,2676,449,3218,646
1400000US48439104502,48439104502,"Census Tract 1045.02, Tarrant County, Texas",3330,335,564,155,2766,356
1400000US48439104503,48439104503,"Census Tract 1045.03, Tarrant County, Texas",2349,352,99,92,2250,364
1400000US48439104504,48439104504,"Census Tract 1045.04, Tarrant County, Texas",2851,516,596,233,2255,525
1400000US48439104505,48439104505,"Census Tract 1045.05, Tarrant County, Texas",2855,401,1932,410,923,339
1400000US48439104601,48439104601,"Census Tract 1046.01, Tarrant County, Texas",3739,501,1626,364,2113,469
1400000US48439104602,48439104602,"Census Tract 1046.02, Tarrant County, Texas",4477,619,1509,349,2968,595
1400000US48439104603,48439104603,"Census Tract 1046.03, Tarrant County, Texas",3419,483,1022,234,2397,459
1400000US48439104604,48439104604,"Census Tract 1046.04, Tarrant County, Texas",2552,438,1666,309,886,402
1400000US48439104605,48439104605,"Census Tract 1046.05, Tarrant County, Texas",4267,581,3044,457,1223,373
1400000US48439104701,48439104701,"Census Tract 1047.01, Tarrant County, Texas",4220,428,408,197,3812,504
1400000US48439104702,48439104702,"Census Tract 1047.02, Tarrant County, Texas",3325,593,545,203,2780,600
1400000US48439104802,48439104802,"Census Tract 1048.02, Tarrant County, Texas",5640,589,2465,467,3175,456
1400000US48439104803,48439104803,"Census Tract 1048.03, Tarrant County, Texas",6883,681,1618,402,5265,722
1400000US48439104804,48439104804,"Census Tract 1048.04, Tarrant County, Texas",3165,596,801,162,2364,591
1400000US48439104900,48439104900,"Census Tract 1049, Tarrant County, Texas",2955,378,1108,181,1847,461
1400000US48439105001,48439105001,"Census Tract 1050.01, Tarrant County, Texas",5302,525,993,224,4309,588
1400000US48439105006,48439105006,"Census Tract 1050.06, Tarrant County, Texas",1678,372,1264,324,414,183
1400000US48439105007,48439105007,"Census Tract 1050.07, Tarrant County, Texas",4244,337,3698,336,546,235
1400000US48439105008,48439105008,"Census Tract 1050.08, Tarrant County, Texas",6032,600,4653,504,1379,416
1400000US48439105201,48439105201,"Census Tract 1052.01, Tarrant County, Texas",5453,861,2925,430,2528,873
1400000US48439105203,48439105203,"Census Tract 1052.03, Tarrant County, Texas",2205,196,1464,279,741,294
1400000US48439105204,48439105204,"Census Tract 1052.04, Tarrant County, Texas",3053,402,2197,281,856,323
1400000US48439105205,48439105205,"Census Tract 1052.05, Tarrant County, Texas",4940,665,3811,552,1129,518
1400000US48439105403,48439105403,"Census Tract 1054.03, Tarrant County, Texas",5540,468,5212,452,328,159
1400000US48439105404,48439105404,"Census Tract 1054.04, Tarrant County, Texas",3791,217,3602,240,189,108
1400000US48439105405,48439105405,"Census Tract 1054.05, Tarrant County, Texas",3615,431,3382,447,233,191
1400000US48439105406,48439105406,"Census Tract 1054.06, Tarrant County, Texas",5177,546,4853,548,324,167
1400000US48439105502,48439105502,"Census Tract 1055.02, Tarrant County, Texas",5384,467,4180,413,1204,349
1400000US48439105503,48439105503,"Census Tract 1055.03, Tarrant County, Texas",5288,538,4342,354,946,442
1400000US48439105505,48439105505,"Census Tract 1055.05, Tarrant County, Texas",4124,384,2968,314,1156,368
1400000US48439105507,48439105507,"Census Tract 1055.07, Tarrant County, Texas",6935,544,6528,571,407,172
1400000US48439105508,48439105508,"Census Tract 1055.08, Tarrant County, Texas",6144,477,5514,470,630,235
1400000US48439105510,48439105510,"Census Tract 1055.10, Tarrant County, Texas",7166,591,6093,503,1073,305
1400000US48439105511,48439105511,"Census Tract 1055.11, Tarrant County, Texas",6028,653,4609,661,1419,238
1400000US48439105512,48439105512,"Census Tract 1055.12, Tarrant County, Texas",4154,243,3596,228,558,134
1400000US48439105513,48439105513,"Census Tract 1055.13, Tarrant County, Texas",3657,540,2837,454,820,322
1400000US48439105514,48439105514,"Census Tract 1055.14, Tarrant County, Texas",2477,310,2037,311,440,234
1400000US48439105600,48439105600,"Census Tract 1056, Tarrant County, Texas",4825,308,2498,258,2327,304
1400000US48439105701,48439105701,"Census Tract 1057.01, Tarrant County, Texas",3249,264,2040,197,1209,270
1400000US48439105703,48439105703,"Census Tract 1057.03, Tarrant County, Texas",3349,337,1933,290,1416,375
1400000US48439105704,48439105704,"Census Tract 1057.04, Tarrant County, Texas",8660,668,5250,596,3410,648
1400000US48439105800,48439105800,"Census Tract 1058, Tarrant County, Texas",4525,437,1305,274,3220,447
1400000US48439105901,48439105901,"Census Tract 1059.01, Tarrant County, Texas",2930,382,508,229,2422,381
1400000US48439105902,48439105902,"Census Tract 1059.02, Tarrant County, Texas",4993,869,3109,927,1884,467
1400000US48439106001,48439106001,"Census Tract 1060.01, Tarrant County, Texas",7016,667,3802,635,3214,677
1400000US48439106002,48439106002,"Census Tract 1060.02, Tarrant County, Texas",3360,540,2434,471,926,375
1400000US48439106004,48439106004,"Census Tract 1060.04, Tarrant County, Texas",4145,550,3342,519,803,254
1400000US48439106101,48439106101,"Census Tract 1061.01, Tarrant County, Texas",1545,299,1066,272,479,223
1400000US48439106102,48439106102,"Census Tract 1061.02, Tarrant County, Texas",2985,635,1855,411,1130,515
1400000US48439106201,48439106201,"Census Tract 1062.01, Tarrant County, Texas",3178,451,2929,476,249,181
1400000US48439106202,48439106202,"Census Tract 1062.02, Tarrant County, Texas",4503,593,3859,564,644,312
1400000US48439106300,48439106300,"Census Tract 1063, Tarrant County, Texas",2929,515,2325,388,604,418
1400000US48439106400,48439106400,"Census Tract 1064, Tarrant County, Texas",2505,357,1442,291,1063,250
1400000US48439106502,48439106502,"Census Tract 1065.02, Tarrant County, Texas",2481,331,2208,336,273,202
1400000US48439106503,48439106503,"Census Tract 1065.03, Tarrant County, Texas",5194,519,4264,468,930,426
1400000US48439106507,48439106507,"Census Tract 1065.07, Tarrant County, Texas",1854,184,1674,214,180,116
1400000US48439106509,48439106509,"Census Tract 1065.09, Tarrant County, Texas",4070,315,3342,305,728,297
1400000US48439106510,48439106510,"Census Tract 1065.10, Tarrant County, Texas",7912,477,6809,428,1103,261
1400000US48439106511,48439106511,"Census Tract 1065.11, Tarrant County, Texas",6096,547,5168,536,928,306
1400000US48439106512,48439106512,"Census Tract 1065.12, Tarrant County, Texas",4927,449,3957,352,970,423
1400000US48439106513,48439106513,"Census Tract 1065.13, Tarrant County, Texas",2874,356,2584,391,290,182
1400000US48439106514,48439106514,"Census Tract 1065.14, Tarrant County, Texas",5056,449,4275,447,781,325
1400000US48439106515,48439106515,"Census Tract 1065.15, Tarrant County, Texas",4551,558,3965,536,586,347
1400000US48439106516,48439106516,"Census Tract 1065.16, Tarrant County, Texas",4598,595,3719,561,879,344
1400000US48439106517,48439106517,"Census Tract 1065.17, Tarrant County, Texas",7259,559,5919,571,1340,438
1400000US48439106518,48439106518,"Census Tract 1065.18, Tarrant County, Texas",2665,319,1934,271,731,284
1400000US48439106600,48439106600,"Census Tract 1066, Tarrant County, Texas",2561,345,1875,270,686,229
1400000US48439106700,48439106700,"Census Tract 1067, Tarrant County, Texas",2196,470,1684,519,512,175
1400000US48439110101,48439110101,"Census Tract 1101.01, Tarrant County, Texas",7416,613,5133,544,2283,624
1400000US48439110102,48439110102,"Census Tract 1101.02, Tarrant County, Texas",4067,420,2333,285,1734,375
1400000US48439110202,48439110202,"Census Tract 1102.02, Tarrant County, Texas",3795,309,2184,237,1611,314
1400000US48439110203,48439110203,"Census Tract 1102.03, Tarrant County, Texas",8413,550,6116,475,2297,434
1400000US48439110204,48439110204,"Census Tract 1102.04, Tarrant County, Texas",5726,466,3922,450,1804,376
1400000US48439110301,48439110301,"Census Tract 1103.01, Tarrant County, Texas",3281,368,1838,209,1443,373
1400000US48439110302,48439110302,"Census Tract 1103.02, Tarrant County, Texas",5244,575,2543,566,2701,620
1400000US48439110401,48439110401,"Census Tract 1104.01, Tarrant County, Texas",4531,118,3635,225,896,208
1400000US48439110402,48439110402,"Census Tract 1104.02, Tarrant County, Texas",4585,37,2643,408,1942,407
1400000US48439110500,48439110500,"Census Tract 1105, Tarrant County, Texas",7508,98,4107,379,3401,378
1400000US48439110600,48439110600,"Census Tract 1106, Tarrant County, Texas",2478,224,1765,165,713,149
1400000US48439110701,48439110701,"Census Tract 1107.01, Tarrant County, Texas",7764,816,6019,903,1745,381
1400000US48439110703,48439110703,"Census Tract 1107.03, Tarrant County, Texas",4173,473,3230,427,943,244
1400000US48439110704,48439110704,"Census Tract 1107.04, Tarrant County, Texas",3977,503,2939,487,1038,274
1400000US48439110805,48439110805,"Census Tract 1108.05, Tarrant County, Texas",5342,397,4291,401,1051,231
1400000US48439110806,48439110806,"Census Tract 1108.06, Tarrant County, Texas",3936,350,3277,370,659,205
1400000US48439110807,48439110807,"Census Tract 1108.07, Tarrant County, Texas",5858,530,5085,501,773,337
1400000US48439110808,48439110808,"Census Tract 1108.08, Tarrant County, Texas",1483,311,1464,312,19,31
1400000US48439110809,48439110809,"Census Tract 1108.09, Tarrant County, Texas",1747,170,1543,252,204,209
1400000US48439110901,48439110901,"Census Tract 1109.01, Tarrant County, Texas",4052,279,3640,250,412,287
1400000US48439110903,48439110903,"Census Tract 1109.03, Tarrant County, Texas",1720,226,1652,229,68,45
1400000US48439110905,48439110905,"Census Tract 1109.05, Tarrant County, Texas",4404,272,4015,333,389,296
1400000US48439110906,48439110906,"Census Tract 1109.06, Tarrant County, Texas",4559,303,4143,324,416,138
1400000US48439110907,48439110907,"Census Tract 1109.07, Tarrant County, Texas",2806,211,2458,215,348,173
1400000US48439111003,48439111003,"Census Tract 1110.03, Tarrant County, Texas",2732,19,1961,152,771,151
1400000US48439111005,48439111005,"Census Tract 1110.05, Tarrant County, Texas",8642,781,6003,616,2639,584
1400000US48439111008,48439111008,"Census Tract 1110.08, Tarrant County, Texas",6052,463,4934,537,1118,374
1400000US48439111010,48439111010,"Census Tract 1110.10, Tarrant County, Texas",2926,292,2790,310,136,118
1400000US48439111011,48439111011,"Census Tract 1110.11, Tarrant County, Texas",8611,599,6446,595,2165,287
1400000US48439111012,48439111012,"Census Tract 1110.12, Tarrant County, Texas",7794,651,6415,582,1379,520
1400000US48439111013,48439111013,"Census Tract 1110.13, Tarrant County, Texas",7591,708,6266,578,1325,390
1400000US48439111015,48439111015,"Census Tract 1110.15, Tarrant County, Texas",2369,247,2114,263,255,121
1400000US48439111016,48439111016,"Census Tract 1110.16, Tarrant County, Texas",8116,377,6980,391,1136,307
1400000US48439111017,48439111017,"Census Tract 1110.17, Tarrant County, Texas",9970,698,8753,760,1217,245
1400000US48439111018,48439111018,"Census Tract 1110.18, Tarrant County, Texas",2211,291,1965,306,246,200
1400000US48439111102,48439111102,"Census Tract 1111.02, Tarrant County, Texas",5549,416,3452,385,2097,390
1400000US48439111103,48439111103,"Census Tract 1111.03, Tarrant County, Texas",3455,438,1835,506,1620,474
1400000US48439111104,48439111104,"Census Tract 1111.04, Tarrant County, Texas",2523,460,2030,263,493,439
1400000US48439111202,48439111202,"Census Tract 1112.02, Tarrant County, Texas",6031,43,3518,315,2513,317
1400000US48439111203,48439111203,"Census Tract 1112.03, Tarrant County, Texas",4511,387,3656,362,855,269
1400000US48439111204,48439111204,"Census Tract 1112.04, Tarrant County, Texas",5490,547,4562,500,928,488
1400000US48439111301,48439111301,"Census Tract 1113.01, Tarrant County, Texas",8812,688,7477,604,1335,387
1400000US48439111304,48439111304,"Census Tract 1113.04, Tarrant County, Texas",6648,363,6010,368,638,197
1400000US48439111306,48439111306,"Census Tract 1113.06, Tarrant County, Texas",4541,420,3194,367,1347,297
1400000US48439111307,48439111307,"Census Tract 1113.07, Tarrant County, Texas",2889,311,2186,323,703,244
1400000US48439111308,48439111308,"Census Tract 1113.08, Tarrant County, Texas",1511,182,1199,186,312,200
1400000US48439111309,48439111309,"Census Tract 1113.09, Tarrant County, Texas",3859,552,2650,473,1209,331
1400000US48439111310,48439111310,"Census Tract 1113.10, Tarrant County, Texas",6458,394,4770,417,1688,327
1400000US48439111311,48439111311,"Census Tract 1113.11, Tarrant County, Texas",5796,407,4932,415,864,268
1400000US48439111312,48439111312,"Census Tract 1113.12, Tarrant County, Texas",3352,392,3110,438,242,182
1400000US48439111313,48439111313,"Census Tract 1113.13, Tarrant County, Texas",4315,362,4058,386,257,228
1400000US48439111314,48439111314,"Census Tract 1113.14, Tarrant County, Texas",3710,421,3386,426,324,174
1400000US48439111402,48439111402,"Census Tract 1114.02, Tarrant County, Texas",6249,322,5638,401,611,190
1400000US48439111404,48439111404,"Census Tract 1114.04, Tarrant County, Texas",7908,530,7460,579,448,207
1400000US48439111405,48439111405,"Census Tract 1114.05, Tarrant County, Texas",2151,332,2031,330,120,96
1400000US48439111406,48439111406,"Census Tract 1114.06, Tarrant County, Texas",3048,300,2782,313,266,84
1400000US48439111407,48439111407,"Census Tract 1114.07, Tarrant County, Texas",3201,188,2943,215,258,118
1400000US48439111408,48439111408,"Census Tract 1114.08, Tarrant County, Texas",2159,311,1928,324,231,187
1400000US48439111409,48439111409,"Census Tract 1114.09, Tarrant County, Texas",4860,259,4267,304,593,220
1400000US48439111505,48439111505,"Census Tract 1115.05, Tarrant County, Texas",4210,271,3504,341,706,299
1400000US48439111506,48439111506,"Census Tract 1115.06, Tarrant County, Texas",6145,412,5842,404,303,141
1400000US48439111513,48439111513,"Census Tract 1115.13, Tarrant County, Texas",4057,364,3177,251,880,348
1400000US48439111514,48439111514,"Census Tract 1115.14, Tarrant County, Texas",6570,445,4332,392,2238,427
1400000US48439111516,48439111516,"Census Tract 1115.16, Tarrant County, Texas",5977,524,4482,497,1495,311
1400000US48439111521,48439111521,"Census Tract 1115.21, Tarrant County, Texas",8138,524,4854,635,3284,622
1400000US48439111522,48439111522,"Census Tract 1115.22, Tarrant County, Texas",7220,726,4128,565,3092,527
1400000US48439111523,48439111523,"Census Tract 1115.23, Tarrant County, Texas",8443,664,6743,727,1700,401
1400000US48439111524,48439111524,"Census Tract 1115.24, Tarrant County, Texas",7565,852,4612,638,2953,642
1400000US48439111525,48439111525,"Census Tract 1115.25, Tarrant County, Texas",5558,466,3558,431,2000,488
1400000US48439111526,48439111526,"Census Tract 1115.26, Tarrant County, Texas",3825,361,3061,290,764,232
1400000US48439111529,48439111529,"Census Tract 1115.29, Tarrant County, Texas",4091,244,3708,253,383,112
1400000US48439111530,48439111530,"Census Tract 1115.30, Tarrant County, Texas",6189,293,5723,290,466,129
1400000US48439111531,48439111531,"Census Tract 1115.31, Tarrant County, Texas",4191,232,3814,248,377,107
1400000US48439111532,48439111532,"Census Tract 1115.32, Tarrant County, Texas",7693,465,6381,439,1312,513
1400000US48439111533,48439111533,"Census Tract 1115.33, Tarrant County, Texas",5041,432,4342,416,699,216
1400000US48439111534,48439111534,"Census Tract 1115.34, Tarrant County, Texas",6134,471,5595,400,539,346
1400000US48439111536,48439111536,"Census Tract 1115.36, Tarrant County, Texas",3706,399,2697,390,1009,292
1400000US48439111537,48439111537,"Census Tract 1115.37, Tarrant County, Texas",7321,552,5160,568,2161,620
1400000US48439111538,48439111538,"Census Tract 1115.38, Tarrant County, Texas",5546,477,3750,463,1796,522
1400000US48439111539,48439111539,"Census Tract 1115.39, Tarrant County, Texas",8403,510,6808,466,1595,282
1400000US48439111540,48439111540,"Census Tract 1115.40, Tarrant County, Texas",6221,514,4930,449,1291,445
1400000US48439111541,48439111541,"Census Tract 1115.41, Tarrant County, Texas",4227,380,3468,487,759,375
1400000US48439111542,48439111542,"Census Tract 1115.42, Tarrant County, Texas",6008,637,4355,652,1653,349
1400000US48439111543,48439111543,"Census Tract 1115.43, Tarrant County, Texas",6777,570,5292,597,1485,345
1400000US48439111544,48439111544,"Census Tract 1115.44, Tarrant County, Texas",7208,640,5386,635,1822,534
1400000US48439111545,48439111545,"Census Tract 1115.45, Tarrant County, Texas",2475,204,2459,203,16,17
1400000US48439111546,48439111546,"Census Tract 1115.46, Tarrant County, Texas",6706,441,5733,511,973,482
1400000US48439111547,48439111547,"Census Tract 1115.47, Tarrant County, Texas",14592,978,11349,1034,3243,550
1400000US48439111548,48439111548,"Census Tract 1115.48, Tarrant County, Texas",5952,560,4733,549,1219,268
1400000US48439111549,48439111549,"Census Tract 1115.49, Tarrant County, Texas",4641,586,3683,623,958,380
1400000US48439111550,48439111550,"Census Tract 1115.50, Tarrant County, Texas",14068,1043,10601,891,3467,770
1400000US48439111551,48439111551,"Census Tract 1115.51, Tarrant County, Texas",6919,471,6325,375,594,283
1400000US48439111552,48439111552,"Census Tract 1115.52, Tarrant County, Texas",3385,385,2889,296,496,324
1400000US48439111553,48439111553,"Census Tract 1115.53, Tarrant County, Texas",3127,391,2746,432,381,212
1400000US48439113001,48439113001,"Census Tract 1130.01, Tarrant County, Texas",3512,350,2627,213,885,325
1400000US48439113002,48439113002,"Census Tract 1130.02, Tarrant County, Texas",5910,703,3455,569,2455,683
1400000US48439113102,48439113102,"Census Tract 1131.02, Tarrant County, Texas",5070,438,4483,419,587,189
1400000US48439113104,48439113104,"Census Tract 1131.04, Tarrant County, Texas",3131,386,2578,300,553,315
1400000US48439113107,48439113107,"Census Tract 1131.07, Tarrant County, Texas",2370,164,2104,187,266,158
1400000US48439113108,48439113108,"Census Tract 1131.08, Tarrant County, Texas",4372,221,4241,214,131,87
1400000US48439113109,48439113109,"Census Tract 1131.09, Tarrant County, Texas",3832,428,3011,383,821,398
1400000US48439113110,48439113110,"Census Tract 1131.10, Tarrant County, Texas",4826,636,3234,391,1592,667
1400000US48439113111,48439113111,"Census Tract 1131.11, Tarrant County, Texas",4310,682,2898,576,1412,537
1400000US48439113112,48439113112,"Census Tract 1131.12, Tarrant County, Texas",3050,412,2185,314,865,326
1400000US48439113113,48439113113,"Census Tract 1131.13, Tarrant County, Texas",4021,457,3403,495,618,333
1400000US48439113114,48439113114,"Census Tract 1131.14, Tarrant County, Texas",3724,429,3408,414,316,152
1400000US48439113115,48439113115,"Census Tract 1131.15, Tarrant County, Texas",3085,391,1916,305,1169,416
1400000US48439113116,48439113116,"Census Tract 1131.16, Tarrant County, Texas",4111,537,3397,509,714,272
1400000US48439113206,48439113206,"Census Tract 1132.06, Tarrant County, Texas",5556,506,3597,424,1959,527
1400000US48439113207,48439113207,"Census Tract 1132.07, Tarrant County, Texas",4290,222,3877,276,413,148
1400000US48439113210,48439113210,"Census Tract 1132.10, Tarrant County, Texas",6686,282,6144,309,542,172
1400000US48439113212,48439113212,"Census Tract 1132.12, Tarrant County, Texas",4260,349,3665,409,595,428
1400000US48439113213,48439113213,"Census Tract 1132.13, Tarrant County, Texas",4038,1036,3640,1053,398,176
1400000US48439113214,48439113214,"Census Tract 1132.14, Tarrant County, Texas",4569,287,3919,293,650,179
1400000US48439113215,48439113215,"Census Tract 1132.15, Tarrant County, Texas",4861,443,4218,405,643,363
1400000US48439113216,48439113216,"Census Tract 1132.16, Tarrant County, Texas",4738,357,4053,380,685,189
1400000US48439113217,48439113217,"Census Tract 1132.17, Tarrant County, Texas",4586,394,4188,414,398,162
1400000US48439113218,48439113218,"Census Tract 1132.18, Tarrant County, Texas",2378,162,2165,205,213,170
1400000US48439113220,48439113220,"Census Tract 1132.20, Tarrant County, Texas",5180,725,3209,568,1971,676
1400000US48439113221,48439113221,"Census Tract 1132.21, Tarrant County, Texas",4247,419,3760,416,487,262
1400000US48439113301,48439113301,"Census Tract 1133.01, Tarrant County, Texas",3947,236,3589,280,358,178
1400000US48439113302,48439113302,"Census Tract 1133.02, Tarrant County, Texas",3976,285,3274,294,702,217
1400000US48439113403,48439113403,"Census Tract 1134.03, Tarrant County, Texas",2539,294,2150,304,389,193
1400000US48439113404,48439113404,"Census Tract 1134.04, Tarrant County, Texas",5001,316,4288,301,713,279
1400000US48439113405,48439113405,"Census Tract 1134.05, Tarrant County, Texas",5836,510,4486,389,1350,447
1400000US48439113407,48439113407,"Census Tract 1134.07, Tarrant County, Texas",5932,577,2830,470,3102,700
1400000US48439113408,48439113408,"Census Tract 1134.08, Tarrant County, Texas",5124,462,3647,495,1477,555
1400000US48439113509,48439113509,"Census Tract 1135.09, Tarrant County, Texas",4404,500,3060,412,1344,505
1400000US48439113510,48439113510,"Census Tract 1135.10, Tarrant County, Texas",4119,395,3464,434,655,158
1400000US48439113511,48439113511,"Census Tract 1135.11, Tarrant County, Texas",3758,248,3061,260,697,192
1400000US48439113512,48439113512,"Census Tract 1135.12, Tarrant County, Texas",5268,558,4647,531,621,221
1400000US48439113513,48439113513,"Census Tract 1135.13, Tarrant County, Texas",5300,447,4301,510,999,385
1400000US48439113514,48439113514,"Census Tract 1135.14, Tarrant County, Texas",5211,551,3454,518,1757,383
1400000US48439113516,48439113516,"Census Tract 1135.16, Tarrant County, Texas",4413,428,3857,496,556,340
1400000US48439113517,48439113517,"Census Tract 1135.17, Tarrant County, Texas",3614,290,2936,253,678,282
1400000US48439113518,48439113518,"Census Tract 1135.18, Tarrant County, Texas",4827,394,3976,427,851,296
1400000US48439113519,48439113519,"Census Tract 1135.19, Tarrant County, Texas",5589,455,5170,484,419,148
1400000US48439113520,48439113520,"Census Tract 1135.20, Tarrant County, Texas",5107,313,4574,359,533,222
1400000US48439113607,48439113607,"Census Tract 1136.07, Tarrant County, Texas",4572,426,3465,352,1107,453
1400000US48439113610,48439113610,"Census Tract 1136.10, Tarrant County, Texas",10495,435,10153,484,342,191
1400000US48439113611,48439113611,"Census Tract 1136.11, Tarrant County, Texas",4598,216,4243,306,355,242
1400000US48439113612,48439113612,"Census Tract 1136.12, Tarrant County, Texas",4132,240,3971,262,161,119
1400000US48439113613,48439113613,"Census Tract 1136.13, Tarrant County, Texas",4470,442,4060,343,410,456
1400000US48439113618,48439113618,"Census Tract 1136.18, Tarrant County, Texas",6222,339,5755,351,467,130
1400000US48439113619,48439113619,"Census Tract 1136.19, Tarrant County, Texas",4583,571,4212,560,371,207
1400000US48439113622,48439113622,"Census Tract 1136.22, Tarrant County, Texas",5719,300,5445,314,274,120
1400000US48439113623,48439113623,"Census Tract 1136.23, Tarrant County, Texas",3836,272,3224,272,612,330
1400000US48439113624,48439113624,"Census Tract 1136.24, Tarrant County, Texas",4049,163,3631,191,418,113
1400000US48439113625,48439113625,"Census Tract 1136.25, Tarrant County, Texas",3267,257,3142,264,125,107
1400000US48439113626,48439113626,"Census Tract 1136.26, Tarrant County, Texas",4062,240,3889,261,173,113
1400000US48439113627,48439113627,"Census Tract 1136.27, Tarrant County, Texas",5117,422,4716,410,401,165
1400000US48439113628,48439113628,"Census Tract 1136.28, Tarrant County, Texas",4036,368,3678,386,358,143
1400000US48439113629,48439113629,"Census Tract 1136.29, Tarrant County, Texas",4171,287,3767,298,404,136
1400000US48439113630,48439113630,"Census Tract 1136.30, Tarrant County, Texas",3932,670,3718,693,214,126
1400000US48439113631,48439113631,"Census Tract 1136.31, Tarrant County, Texas",6774,616,4563,560,2211,725
1400000US48439113632,48439113632,"Census Tract 1136.32, Tarrant County, Texas",5101,253,4947,287,154,118
1400000US48439113633,48439113633,"Census Tract 1136.33, Tarrant County, Texas",4526,428,4278,446,248,149
1400000US48439113634,48439113634,"Census Tract 1136.34, Tarrant County, Texas",5021,308,4495,359,526,315
1400000US48439113703,48439113703,"Census Tract 1137.03, Tarrant County, Texas",8226,679,6610,494,1616,521
1400000US48439113705,48439113705,"Census Tract 1137.05, Tarrant County, Texas",5099,424,4130,343,969,384
1400000US48439113707,48439113707,"Census Tract 1137.07, Tarrant County, Texas",4843,426,4492,423,351,119
1400000US48439113709,48439113709,"Census Tract 1137.09, Tarrant County, Texas",4892,363,4500,364,392,134
1400000US48439113710,48439113710,"Census Tract 1137.10, Tarrant County, Texas",4036,281,2817,300,1219,369
1400000US48439113711,48439113711,"Census Tract 1137.11, Tarrant County, Texas",4000,319,3714,319,286,131
1400000US48439113803,48439113803,"Census Tract 1138.03, Tarrant County, Texas",5449,354,4497,370,952,231
1400000US48439113808,48439113808,"Census Tract 1138.08, Tarrant County, Texas",6611,356,5278,329,1333,381
1400000US48439113809,48439113809,"Census Tract 1138.09, Tarrant County, Texas",4613,371,3811,421,802,233
1400000US48439113810,48439113810,"Census Tract 1138.10, Tarrant County, Texas",4732,323,3393,465,1339,348
1400000US48439113811,48439113811,"Census Tract 1138.11, Tarrant County, Texas",3960,331,3124,346,836,307
1400000US48439113812,48439113812,"Census Tract 1138.12, Tarrant County, Texas",5470,344,5003,372,467,187
1400000US48439113813,48439113813,"Census Tract 1138.13, Tarrant County, Texas",5088,239,4842,258,246,123
1400000US48439113814,48439113814,"Census Tract 1138.14, Tarrant County, Texas",3866,296,3604,389,262,183
1400000US48439113815,48439113815,"Census Tract 1138.15, Tarrant County, Texas",5124,285,4815,343,309,151
1400000US48439113816,48439113816,"Census Tract 1138.16, Tarrant County, Texas",4770,242,4567,243,203,115
1400000US48439113906,48439113906,"Census Tract 1139.06, Tarrant County, Texas",5878,368,5518,400,360,150
1400000US48439113907,48439113907,"Census Tract 1139.07, Tarrant County, Texas",5671,382,5521,403,150,98
1400000US48439113908,48439113908,"Census Tract 1139.08, Tarrant County, Texas",5455,291,5233,308,222,143
1400000US48439113909,48439113909,"Census Tract 1139.09, Tarrant County, Texas",6684,367,6557,344,127,108
1400000US48439113910,48439113910,"Census Tract 1139.10, Tarrant County, Texas",7088,360,6924,374,164,130
1400000US48439113911,48439113911,"Census Tract 1139.11, Tarrant County, Texas",6334,316,5658,387,676,190
1400000US48439113912,48439113912,"Census Tract 1139.12, Tarrant County, Texas",5916,243,5659,263,257,102
1400000US48439113916,48439113916,"Census Tract 1139.16, Tarrant County, Texas",3981,471,2766,302,1215,384
1400000US48439113917,48439113917,"Census Tract 1139.17, Tarrant County, Texas",6371,537,5340,459,1031,384
1400000US48439113918,48439113918,"Census Tract 1139.18, Tarrant County, Texas",5303,593,4540,557,763,234
1400000US48439113919,48439113919,"Census Tract 1139.19, Tarrant County, Texas",7839,458,6965,419,874,202
1400000US48439113920,48439113920,"Census Tract 1139.20, Tarrant County, Texas",5797,317,5043,369,754,279
1400000US48439113921,48439113921,"Census Tract 1139.21, Tarrant County, Texas",16235,906,13157,750,3078,893
1400000US48439113922,48439113922,"Census Tract 1139.22, Tarrant County, Texas",16084,741,13661,651,2423,401
1400000US48439113923,48439113923,"Census Tract 1139.23, Tarrant County, Texas",2358,235,2058,248,300,104
1400000US48439113924,48439113924,"Census Tract 1139.24, Tarrant County, Texas",4969,322,3821,348,1148,221
1400000US48439113925,48439113925,"Census Tract 1139.25, Tarrant County, Texas",4124,358,3342,523,782,307
1400000US48439113926,48439113926,"Census Tract 1139.26, Tarrant County, Texas",9658,673,7545,615,2113,419
1400000US48439113927,48439113927,"Census Tract 1139.27, Tarrant County, Texas",8550,451,7468,405,1082,279
1400000US48439113928,48439113928,"Census Tract 1139.28, Tarrant County, Texas",6615,307,5450,373,1165,268
1400000US48439113929,48439113929,"Census Tract 1139.29, Tarrant County, Texas",8589,408,7590,433,999,217
1400000US48439114003,48439114003,"Census Tract 1140.03, Tarrant County, Texas",6741,338,4643,462,2098,435
1400000US48439114005,48439114005,"Census Tract 1140.05, Tarrant County, Texas",6912,421,5344,523,1568,387
1400000US48439114006,48439114006,"Census Tract 1140.06, Tarrant County, Texas",6680,347,5191,361,1489,318
1400000US48439114007,48439114007,"Census Tract 1140.07, Tarrant County, Texas",10950,771,8259,672,2691,529
1400000US48439114008,48439114008,"Census Tract 1140.08, Tarrant County, Texas",9339,955,6057,615,3282,619
1400000US48439114102,48439114102,"Census Tract 1141.02, Tarrant County, Texas",7547,568,6943,529,604,242
1400000US48439114103,48439114103,"Census Tract 1141.03, Tarrant County, Texas",16565,745,14172,752,2393,482
1400000US48439114104,48439114104,"Census Tract 1141.04, Tarrant County, Texas",5510,812,4688,705,822,400
1400000US48439114203,48439114203,"Census Tract 1142.03, Tarrant County, Texas",5366,423,5003,419,363,146
1400000US48439114204,48439114204,"Census Tract 1142.04, Tarrant County, Texas",5587,341,5377,392,210,159
1400000US48439114205,48439114205,"Census Tract 1142.05, Tarrant County, Texas",3265,365,2974,368,291,200
1400000US48439114206,48439114206,"Census Tract 1142.06, Tarrant County, Texas",4183,471,3344,502,839,411
1400000US48439114207,48439114207,"Census Tract 1142.07, Tarrant County, Texas",4985,342,4360,332,625,152
1400000US48439121601,48439121601,"Census Tract 1216.01, Tarrant County, Texas",6966,464,5313,666,1653,652
1400000US48439121604,48439121604,"Census Tract 1216.04, Tarrant County, Texas",5337,616,3669,486,1668,508
1400000US48439121605,48439121605,"Census Tract 1216.05, Tarrant County, Texas",2720,236,2228,199,492,155
1400000US48439121606,48439121606,"Census Tract 1216.06, Tarrant County, Texas",3340,237,3103,274,237,167
1400000US48439121608,48439121608,"Census Tract 1216.08, Tarrant County, Texas",5001,255,4698,256,303,157
1400000US48439121609,48439121609,"Census Tract 1216.09, Tarrant County, Texas",6041,453,5666,495,375,228
1400000US48439121610,48439121610,"Census Tract 1216.10, Tarrant County, Texas",2307,127,1828,264,479,272
1400000US48439121611,48439121611,"Census Tract 1216.11, Tarrant County, Texas",4527,435,3994,435,533,183
1400000US48439121702,48439121702,"Census Tract 1217.02, Tarrant County, Texas",1877,374,1360,247,517,255
1400000US48439121703,48439121703,"Census Tract 1217.03, Tarrant County, Texas",5700,555,2517,284,3183,498
1400000US48439121704,48439121704,"Census Tract 1217.04, Tarrant County, Texas",3869,547,1230,301,2639,551
1400000US48439121903,48439121903,"Census Tract 1219.03, Tarrant County, Texas",5847,785,1593,356,4254,852
1400000US48439121904,48439121904,"Census Tract 1219.04, Tarrant County, Texas",4266,503,2028,447,2238,498
1400000US48439121905,48439121905,"Census Tract 1219.05, Tarrant County, Texas",5393,728,2448,470,2945,632
1400000US48439121906,48439121906,"Census Tract 1219.06, Tarrant County, Texas",3384,691,1402,466,1982,524
1400000US48439122001,48439122001,"Census Tract 1220.01, Tarrant County, Texas",3687,620,1399,450,2288,783
1400000US48439122002,48439122002,"Census Tract 1220.02, Tarrant County, Texas",3698,587,1898,547,1800,728
1400000US48439122100,48439122100,"Census Tract 1221, Tarrant County, Texas",6391,787,3065,441,3326,806
1400000US48439122200,48439122200,"Census Tract 1222, Tarrant County, Texas",1936,411,816,244,1120,350
1400000US48439122300,48439122300,"Census Tract 1223, Tarrant County, Texas",4242,531,3436,489,806,259
1400000US48439122400,48439122400,"Census Tract 1224, Tarrant County, Texas",5795,543,4298,447,1497,370
1400000US48439122500,48439122500,"Census Tract 1225, Tarrant County, Texas",4141,387,3768,373,373,163
1400000US48439122600,48439122600,"Census Tract 1226, Tarrant County, Texas",3717,260,3376,254,341,145
1400000US48439122700,48439122700,"Census Tract 1227, Tarrant County, Texas",5115,548,4296,453,819,356
1400000US48439122801,48439122801,"Census Tract 1228.01, Tarrant County, Texas",3829,630,1802,282,2027,627
1400000US48439122802,48439122802,"Census Tract 1228.02, Tarrant County, Texas",4456,524,1877,259,2579,533
1400000US48439122900,48439122900,"Census Tract 1229, Tarrant County, Texas",7607,823,3099,538,4508,838
1400000US48439123000,48439123000,"Census Tract 1230, Tarrant County, Texas",6444,648,4650,549,1794,710
1400000US48439123100,48439123100,"Census Tract 1231, Tarrant County, Texas",2232,233,1695,239,537,162
1400000US48439123200,48439123200,"Census Tract 1232, Tarrant County, Texas",2063,409,1099,320,964,280
1400000US48439123300,48439123300,"Census Tract 1233, Tarrant County, Texas",4968,328,4443,333,525,124
1400000US48439123400,48439123400,"Census Tract 1234, Tarrant County, Texas",2348,393,1229,234,1119,348
1400000US48439123500,48439123500,"Census Tract 1235, Tarrant County, Texas",2569,448,1364,286,1205,396
1400000US48439123600,48439123600,"Census Tract 1236, Tarrant County, Texas",2831,467,1253,382,1578,354
1400000US48439980000,48439980000,"Census Tract 9800, Tarrant County, Texas",0,127,0,127,0,127
1400000US48441010100,48441010100,"Census Tract 101, Taylor County, Texas",6224,712,5651,663,573,298
1400000US48441010200,48441010200,"Census Tract 102, Taylor County, Texas",3228,599,2258,460,970,335
1400000US48441010300,48441010300,"Census Tract 103, Taylor County, Texas",1575,490,1191,387,384,368
1400000US48441010400,48441010400,"Census Tract 104, Taylor County, Texas",2291,268,655,175,1636,273
1400000US48441010500,48441010500,"Census Tract 105, Taylor County, Texas",3145,328,2179,272,966,381
1400000US48441010600,48441010600,"Census Tract 106, Taylor County, Texas",3734,227,2915,191,819,215
1400000US48441010700,48441010700,"Census Tract 107, Taylor County, Texas",3568,392,1682,353,1886,480
1400000US48441010800,48441010800,"Census Tract 108, Taylor County, Texas",1849,280,1037,302,812,243
1400000US48441010900,48441010900,"Census Tract 109, Taylor County, Texas",6005,619,5044,558,961,417
1400000US48441011000,48441011000,"Census Tract 110, Taylor County, Texas",1604,334,910,274,694,339
1400000US48441011200,48441011200,"Census Tract 112, Taylor County, Texas",2202,466,1483,283,719,393
1400000US48441011300,48441011300,"Census Tract 113, Taylor County, Texas",3595,396,2462,337,1133,281
1400000US48441011400,48441011400,"Census Tract 114, Taylor County, Texas",4071,377,3396,346,675,304
1400000US48441011500,48441011500,"Census Tract 115, Taylor County, Texas",2992,335,2466,285,526,217
1400000US48441011600,48441011600,"Census Tract 116, Taylor County, Texas",3043,313,2405,259,638,288
1400000US48441011700,48441011700,"Census Tract 117, Taylor County, Texas",2552,340,1790,320,762,184
1400000US48441011900,48441011900,"Census Tract 119, Taylor County, Texas",2313,249,1258,297,1055,313
1400000US48441012000,48441012000,"Census Tract 120, Taylor County, Texas",2430,215,2277,236,153,148
1400000US48441012100,48441012100,"Census Tract 121, Taylor County, Texas",1156,435,917,344,239,123
1400000US48441012200,48441012200,"Census Tract 122, Taylor County, Texas",2666,223,1915,191,751,162
1400000US48441012300,48441012300,"Census Tract 123, Taylor County, Texas",4052,510,2711,439,1341,457
1400000US48441012400,48441012400,"Census Tract 124, Taylor County, Texas",2254,275,1774,277,480,224
1400000US48441012500,48441012500,"Census Tract 125, Taylor County, Texas",3115,290,2788,303,327,198
1400000US48441012600,48441012600,"Census Tract 126, Taylor County, Texas",2992,159,2891,164,101,84
1400000US48441012700,48441012700,"Census Tract 127, Taylor County, Texas",7435,429,6877,394,558,201
1400000US48441012801,48441012801,"Census Tract 128.01, Taylor County, Texas",3217,303,2752,327,465,319
1400000US48441012802,48441012802,"Census Tract 128.02, Taylor County, Texas",4282,568,3309,552,973,418
1400000US48441012900,48441012900,"Census Tract 129, Taylor County, Texas",1443,208,1092,251,351,198
1400000US48441013000,48441013000,"Census Tract 130, Taylor County, Texas",964,281,869,276,95,65
1400000US48441013100,48441013100,"Census Tract 131, Taylor County, Texas",6243,617,3731,500,2512,591
1400000US48441013200,48441013200,"Census Tract 132, Taylor County, Texas",1774,212,1529,237,245,145
1400000US48441013300,48441013300,"Census Tract 133, Taylor County, Texas",2181,255,1825,277,356,88
1400000US48441013401,48441013401,"Census Tract 134.01, Taylor County, Texas",3635,365,3004,389,631,279
1400000US48441013402,48441013402,"Census Tract 134.02, Taylor County, Texas",6686,540,5569,498,1117,484
1400000US48441013404,48441013404,"Census Tract 134.04, Taylor County, Texas",6571,539,6099,532,472,155
1400000US48441013500,48441013500,"Census Tract 135, Taylor County, Texas",6972,478,6550,489,422,134
1400000US48441013600,48441013600,"Census Tract 136, Taylor County, Texas",5418,431,4498,431,920,356
1400000US48441980000,48441980000,"Census Tract 9800, Taylor County, Texas",0,127,0,127,0,127
1400000US48443950100,48443950100,"Census Tract 9501, Terrell County, Texas",850,171,461,149,389,117
1400000US48445950100,48445950100,"Census Tract 9501, Terry County, Texas",2797,159,1901,218,896,190
1400000US48445950300,48445950300,"Census Tract 9503, Terry County, Texas",2569,325,1094,204,1475,296
1400000US48445950400,48445950400,"Census Tract 9504, Terry County, Texas",7132,377,3674,311,3458,372
1400000US48447950300,48447950300,"Census Tract 9503, Throckmorton County, Texas",1814,146,1680,144,134,59
1400000US48449950100,48449950100,"Census Tract 9501, Titus County, Texas",2192,330,1824,262,368,208
1400000US48449950200,48449950200,"Census Tract 9502, Titus County, Texas",2722,373,1942,369,780,242
1400000US48449950300,48449950300,"Census Tract 9503, Titus County, Texas",8025,633,5332,448,2693,565
1400000US48449950400,48449950400,"Census Tract 9504, Titus County, Texas",5071,497,4093,387,978,323
1400000US48449950500,48449950500,"Census Tract 9505, Titus County, Texas",2749,344,1045,238,1704,295
1400000US48449950600,48449950600,"Census Tract 9506, Titus County, Texas",3946,375,1655,288,2291,377
1400000US48449950700,48449950700,"Census Tract 9507, Titus County, Texas",1703,300,1028,206,675,269
1400000US48449950800,48449950800,"Census Tract 9508, Titus County, Texas",4587,420,2368,329,2219,388
1400000US48451000100,48451000100,"Census Tract 1, Tom Green County, Texas",2315,269,1438,215,877,243
1400000US48451000200,48451000200,"Census Tract 2, Tom Green County, Texas",4293,453,2161,406,2132,411
1400000US48451000300,48451000300,"Census Tract 3, Tom Green County, Texas",4992,630,2836,377,2156,507
1400000US48451000400,48451000400,"Census Tract 4, Tom Green County, Texas",6460,665,1355,385,5105,636
1400000US48451000700,48451000700,"Census Tract 7, Tom Green County, Texas",4122,417,1460,321,2662,439
1400000US48451000801,48451000801,"Census Tract 8.01, Tom Green County, Texas",4333,487,2521,440,1812,388
1400000US48451000802,48451000802,"Census Tract 8.02, Tom Green County, Texas",3908,454,1705,369,2203,458
1400000US48451000900,48451000900,"Census Tract 9, Tom Green County, Texas",3235,384,1229,273,2006,408
1400000US48451001000,48451001000,"Census Tract 10, Tom Green County, Texas",4814,409,4335,397,479,201
1400000US48451001101,48451001101,"Census Tract 11.01, Tom Green County, Texas",4930,346,3422,384,1508,294
1400000US48451001102,48451001102,"Census Tract 11.02, Tom Green County, Texas",4476,366,2582,331,1894,249
1400000US48451001200,48451001200,"Census Tract 12, Tom Green County, Texas",7057,653,3516,456,3541,512
1400000US48451001301,48451001301,"Census Tract 13.01, Tom Green County, Texas",6362,764,5203,596,1159,345
1400000US48451001303,48451001303,"Census Tract 13.03, Tom Green County, Texas",4121,379,3202,362,919,319
1400000US48451001304,48451001304,"Census Tract 13.04, Tom Green County, Texas",2812,286,2237,318,575,161
1400000US48451001400,48451001400,"Census Tract 14, Tom Green County, Texas",4424,470,2207,387,2217,507
1400000US48451001500,48451001500,"Census Tract 15, Tom Green County, Texas",3146,780,2503,595,643,436
1400000US48451001600,48451001600,"Census Tract 16, Tom Green County, Texas",4727,425,4063,422,664,180
1400000US48451001702,48451001702,"Census Tract 17.02, Tom Green County, Texas",2886,334,2339,307,547,183
1400000US48451001704,48451001704,"Census Tract 17.04, Tom Green County, Texas",7621,611,6511,604,1110,340
1400000US48451001706,48451001706,"Census Tract 17.06, Tom Green County, Texas",3843,334,2922,284,921,296
1400000US48451001707,48451001707,"Census Tract 17.07, Tom Green County, Texas",4980,365,4207,329,773,407
1400000US48451001708,48451001708,"Census Tract 17.08, Tom Green County, Texas",5742,423,5067,427,675,228
1400000US48451001800,48451001800,"Census Tract 18, Tom Green County, Texas",2401,385,1193,247,1208,308
1400000US48451980000,48451980000,"Census Tract 9800, Tom Green County, Texas",0,127,0,127,0,127
1400000US48453000101,48453000101,"Census Tract 1.01, Travis County, Texas",3904,333,3648,329,256,108
1400000US48453000102,48453000102,"Census Tract 1.02, Travis County, Texas",2486,173,2354,158,132,89
1400000US48453000203,48453000203,"Census Tract 2.03, Travis County, Texas",1982,1333,1654,1064,328,297
1400000US48453000204,48453000204,"Census Tract 2.04, Travis County, Texas",2773,320,2631,327,142,78
1400000US48453000205,48453000205,"Census Tract 2.05, Travis County, Texas",3251,354,2520,319,731,302
1400000US48453000206,48453000206,"Census Tract 2.06, Travis County, Texas",2894,343,2661,306,233,153
1400000US48453000302,48453000302,"Census Tract 3.02, Travis County, Texas",5208,437,4476,462,732,223
1400000US48453000304,48453000304,"Census Tract 3.04, Travis County, Texas",2833,385,2576,380,257,163
1400000US48453000305,48453000305,"Census Tract 3.05, Travis County, Texas",3620,510,3221,508,399,182
1400000US48453000306,48453000306,"Census Tract 3.06, Travis County, Texas",1230,305,703,172,527,280
1400000US48453000307,48453000307,"Census Tract 3.07, Travis County, Texas",1566,156,1124,139,442,172
1400000US48453000401,48453000401,"Census Tract 4.01, Travis County, Texas",3106,408,2729,398,377,131
1400000US48453000402,48453000402,"Census Tract 4.02, Travis County, Texas",2458,279,1979,252,479,177
1400000US48453000500,48453000500,"Census Tract 5, Travis County, Texas",4455,588,3922,583,533,205
1400000US48453000601,48453000601,"Census Tract 6.01, Travis County, Texas",9211,854,7141,754,2070,354
1400000US48453000603,48453000603,"Census Tract 6.03, Travis County, Texas",6173,788,5415,764,758,226
1400000US48453000604,48453000604,"Census Tract 6.04, Travis County, Texas",3682,546,3304,532,378,133
1400000US48453000700,48453000700,"Census Tract 7, Travis County, Texas",1102,185,1005,187,97,70
1400000US48453000801,48453000801,"Census Tract 8.01, Travis County, Texas",1326,217,193,82,1133,193
1400000US48453000802,48453000802,"Census Tract 8.02, Travis County, Texas",3038,379,1902,347,1136,393
1400000US48453000803,48453000803,"Census Tract 8.03, Travis County, Texas",2103,382,1596,290,507,201
1400000US48453000804,48453000804,"Census Tract 8.04, Travis County, Texas",2697,376,1456,229,1241,322
1400000US48453000901,48453000901,"Census Tract 9.01, Travis County, Texas",1666,341,1162,367,504,231
1400000US48453000902,48453000902,"Census Tract 9.02, Travis County, Texas",5280,826,1202,342,4078,783
1400000US48453001000,48453001000,"Census Tract 10, Travis County, Texas",4020,548,1170,390,2850,546
1400000US48453001100,48453001100,"Census Tract 11, Travis County, Texas",3377,612,2962,509,415,180
1400000US48453001200,48453001200,"Census Tract 12, Travis County, Texas",3520,480,3171,438,349,197
1400000US48453001303,48453001303,"Census Tract 13.03, Travis County, Texas",2379,261,2154,271,225,106
1400000US48453001304,48453001304,"Census Tract 13.04, Travis County, Texas",3680,350,3071,366,609,214
1400000US48453001305,48453001305,"Census Tract 13.05, Travis County, Texas",4996,495,3106,394,1890,421
1400000US48453001307,48453001307,"Census Tract 13.07, Travis County, Texas",3768,446,2197,251,1571,493
1400000US48453001308,48453001308,"Census Tract 13.08, Travis County, Texas",2676,373,1438,237,1238,366
1400000US48453001401,48453001401,"Census Tract 14.01, Travis County, Texas",2788,300,2300,313,488,244
1400000US48453001402,48453001402,"Census Tract 14.02, Travis County, Texas",2693,281,2137,244,556,295
1400000US48453001403,48453001403,"Census Tract 14.03, Travis County, Texas",1360,197,895,176,465,175
1400000US48453001501,48453001501,"Census Tract 15.01, Travis County, Texas",4983,324,4443,338,540,228
1400000US48453001503,48453001503,"Census Tract 15.03, Travis County, Texas",3996,546,2546,381,1450,446
1400000US48453001504,48453001504,"Census Tract 15.04, Travis County, Texas",4263,361,3665,351,598,174
1400000US48453001505,48453001505,"Census Tract 15.05, Travis County, Texas",4236,318,3413,321,823,400
1400000US48453001602,48453001602,"Census Tract 16.02, Travis County, Texas",3180,393,2724,360,456,229
1400000US48453001603,48453001603,"Census Tract 16.03, Travis County, Texas",4455,397,4243,388,212,127
1400000US48453001604,48453001604,"Census Tract 16.04, Travis County, Texas",4050,301,3950,298,100,53
1400000US48453001605,48453001605,"Census Tract 16.05, Travis County, Texas",3777,598,3313,486,464,366
1400000US48453001606,48453001606,"Census Tract 16.06, Travis County, Texas",2020,1887,1567,1450,453,545
1400000US48453001705,48453001705,"Census Tract 17.05, Travis County, Texas",4618,323,4231,324,387,217
1400000US48453001706,48453001706,"Census Tract 17.06, Travis County, Texas",3595,282,3334,292,261,129
1400000US48453001707,48453001707,"Census Tract 17.07, Travis County, Texas",4756,629,3860,465,896,629
1400000US48453001712,48453001712,"Census Tract 17.12, Travis County, Texas",3670,317,2730,289,940,310
1400000US48453001713,48453001713,"Census Tract 17.13, Travis County, Texas",3750,483,2539,288,1211,483
1400000US48453001714,48453001714,"Census Tract 17.14, Travis County, Texas",11063,558,10164,524,899,336
1400000US48453001716,48453001716,"Census Tract 17.16, Travis County, Texas",4694,254,4213,279,481,232
1400000US48453001718,48453001718,"Census Tract 17.18, Travis County, Texas",5392,324,5001,322,391,175
1400000US48453001719,48453001719,"Census Tract 17.19, Travis County, Texas",3608,261,3308,269,300,130
1400000US48453001722,48453001722,"Census Tract 17.22, Travis County, Texas",4032,275,3502,302,530,179
1400000US48453001728,48453001728,"Census Tract 17.28, Travis County, Texas",6517,404,4904,445,1613,432
1400000US48453001729,48453001729,"Census Tract 17.29, Travis County, Texas",4456,351,2940,416,1516,318
1400000US48453001733,48453001733,"Census Tract 17.33, Travis County, Texas",3064,301,2709,326,355,141
1400000US48453001737,48453001737,"Census Tract 17.37, Travis County, Texas",9974,416,8285,409,1689,407
1400000US48453001738,48453001738,"Census Tract 17.38, Travis County, Texas",6820,288,5848,310,972,226
1400000US48453001740,48453001740,"Census Tract 17.40, Travis County, Texas",3964,267,2907,266,1057,248
1400000US48453001741,48453001741,"Census Tract 17.41, Travis County, Texas",3609,394,2940,332,669,303
1400000US48453001742,48453001742,"Census Tract 17.42, Travis County, Texas",4436,568,2980,302,1456,538
1400000US48453001745,48453001745,"Census Tract 17.45, Travis County, Texas",2413,236,2111,249,302,97
1400000US48453001746,48453001746,"Census Tract 17.46, Travis County, Texas",3806,317,2577,215,1229,290
1400000US48453001747,48453001747,"Census Tract 17.47, Travis County, Texas",5319,455,3510,395,1809,409
1400000US48453001748,48453001748,"Census Tract 17.48, Travis County, Texas",4686,447,3274,393,1412,280
1400000US48453001749,48453001749,"Census Tract 17.49, Travis County, Texas",5727,533,5029,476,698,306
1400000US48453001750,48453001750,"Census Tract 17.50, Travis County, Texas",5083,521,3182,326,1901,519
1400000US48453001751,48453001751,"Census Tract 17.51, Travis County, Texas",1989,138,1860,142,129,95
1400000US48453001752,48453001752,"Census Tract 17.52, Travis County, Texas",3835,365,3230,352,605,262
1400000US48453001753,48453001753,"Census Tract 17.53, Travis County, Texas",1101,128,934,132,167,124
1400000US48453001754,48453001754,"Census Tract 17.54, Travis County, Texas",5331,1030,4422,997,909,288
1400000US48453001755,48453001755,"Census Tract 17.55, Travis County, Texas",5765,230,5378,212,387,159
1400000US48453001756,48453001756,"Census Tract 17.56, Travis County, Texas",3956,291,3628,300,328,122
1400000US48453001757,48453001757,"Census Tract 17.57, Travis County, Texas",1796,157,1719,154,77,68
1400000US48453001760,48453001760,"Census Tract 17.60, Travis County, Texas",12035,680,11019,709,1016,286
1400000US48453001761,48453001761,"Census Tract 17.61, Travis County, Texas",7026,355,6501,417,525,225
1400000US48453001764,48453001764,"Census Tract 17.64, Travis County, Texas",5379,447,4994,458,385,193
1400000US48453001765,48453001765,"Census Tract 17.65, Travis County, Texas",15929,902,13515,743,2414,542
1400000US48453001766,48453001766,"Census Tract 17.66, Travis County, Texas",7247,643,6070,622,1177,305
1400000US48453001768,48453001768,"Census Tract 17.68, Travis County, Texas",5200,487,4841,500,359,151
1400000US48453001769,48453001769,"Census Tract 17.69, Travis County, Texas",5489,339,4478,400,1011,398
1400000US48453001770,48453001770,"Census Tract 17.70, Travis County, Texas",10932,421,9651,510,1281,268
1400000US48453001771,48453001771,"Census Tract 17.71, Travis County, Texas",3841,352,3458,323,383,227
1400000US48453001772,48453001772,"Census Tract 17.72, Travis County, Texas",2479,241,1020,212,1459,277
1400000US48453001773,48453001773,"Census Tract 17.73, Travis County, Texas",5025,297,4684,288,341,107
1400000US48453001774,48453001774,"Census Tract 17.74, Travis County, Texas",7911,438,5872,443,2039,307
1400000US48453001775,48453001775,"Census Tract 17.75, Travis County, Texas",4087,380,3441,403,646,202
1400000US48453001776,48453001776,"Census Tract 17.76, Travis County, Texas",2459,272,1776,295,683,246
1400000US48453001777,48453001777,"Census Tract 17.77, Travis County, Texas",5403,485,3950,399,1453,285
1400000US48453001778,48453001778,"Census Tract 17.78, Travis County, Texas",3668,379,3323,370,345,128
1400000US48453001779,48453001779,"Census Tract 17.79, Travis County, Texas",5615,219,5163,223,452,228
1400000US48453001780,48453001780,"Census Tract 17.80, Travis County, Texas",3802,407,3478,432,324,136
1400000US48453001781,48453001781,"Census Tract 17.81, Travis County, Texas",2265,186,2088,192,177,118
1400000US48453001782,48453001782,"Census Tract 17.82, Travis County, Texas",5015,416,4510,420,505,191
1400000US48453001783,48453001783,"Census Tract 17.83, Travis County, Texas",5404,491,5089,524,315,188
1400000US48453001784,48453001784,"Census Tract 17.84, Travis County, Texas",4786,326,4620,337,166,137
1400000US48453001785,48453001785,"Census Tract 17.85, Travis County, Texas",4023,268,3242,367,781,336
1400000US48453001786,48453001786,"Census Tract 17.86, Travis County, Texas",4889,390,4209,421,680,349
1400000US48453001804,48453001804,"Census Tract 18.04, Travis County, Texas",5995,590,2940,489,3055,647
1400000US48453001805,48453001805,"Census Tract 18.05, Travis County, Texas",4878,552,1845,396,3033,479
1400000US48453001806,48453001806,"Census Tract 18.06, Travis County, Texas",5725,524,1846,339,3879,519
1400000US48453001811,48453001811,"Census Tract 18.11, Travis County, Texas",3103,471,1097,242,2006,541
1400000US48453001812,48453001812,"Census Tract 18.12, Travis County, Texas",7484,737,2458,477,5026,830
1400000US48453001813,48453001813,"Census Tract 18.13, Travis County, Texas",6154,599,2015,336,4139,698
1400000US48453001817,48453001817,"Census Tract 18.17, Travis County, Texas",3418,388,3054,276,364,239
1400000US48453001818,48453001818,"Census Tract 18.18, Travis County, Texas",5831,695,2399,281,3432,765
1400000US48453001819,48453001819,"Census Tract 18.19, Travis County, Texas",4403,509,1528,292,2875,500
1400000US48453001820,48453001820,"Census Tract 18.20, Travis County, Texas",7266,750,2372,433,4894,777
1400000US48453001821,48453001821,"Census Tract 18.21, Travis County, Texas",5273,664,2265,369,3008,679
1400000US48453001822,48453001822,"Census Tract 18.22, Travis County, Texas",6422,777,2558,531,3864,742
1400000US48453001823,48453001823,"Census Tract 18.23, Travis County, Texas",5958,688,1549,315,4409,708
1400000US48453001824,48453001824,"Census Tract 18.24, Travis County, Texas",1887,379,1413,221,474,359
1400000US48453001826,48453001826,"Census Tract 18.26, Travis County, Texas",2006,256,1594,228,412,204
1400000US48453001828,48453001828,"Census Tract 18.28, Travis County, Texas",3602,301,2875,343,727,237
1400000US48453001829,48453001829,"Census Tract 18.29, Travis County, Texas",2416,222,1985,266,431,117
1400000US48453001832,48453001832,"Census Tract 18.32, Travis County, Texas",2698,410,1849,229,849,365
1400000US48453001833,48453001833,"Census Tract 18.33, Travis County, Texas",7618,921,3490,609,4128,968
1400000US48453001834,48453001834,"Census Tract 18.34, Travis County, Texas",7365,572,5055,532,2310,549
1400000US48453001835,48453001835,"Census Tract 18.35, Travis County, Texas",4886,576,2320,508,2566,584
1400000US48453001839,48453001839,"Census Tract 18.39, Travis County, Texas",6113,491,4904,501,1209,382
1400000US48453001840,48453001840,"Census Tract 18.40, Travis County, Texas",7686,901,4750,876,2936,865
1400000US48453001841,48453001841,"Census Tract 18.41, Travis County, Texas",16295,1036,10663,800,5632,1071
1400000US48453001842,48453001842,"Census Tract 18.42, Travis County, Texas",6218,531,3575,364,2643,536
1400000US48453001843,48453001843,"Census Tract 18.43, Travis County, Texas",2454,268,1501,189,953,318
1400000US48453001844,48453001844,"Census Tract 18.44, Travis County, Texas",3593,447,2511,422,1082,243
1400000US48453001845,48453001845,"Census Tract 18.45, Travis County, Texas",3264,437,2478,372,786,267
1400000US48453001846,48453001846,"Census Tract 18.46, Travis County, Texas",2374,149,1978,247,396,191
1400000US48453001847,48453001847,"Census Tract 18.47, Travis County, Texas",6894,669,4705,593,2189,604
1400000US48453001848,48453001848,"Census Tract 18.48, Travis County, Texas",4601,466,3518,417,1083,262
1400000US48453001849,48453001849,"Census Tract 18.49, Travis County, Texas",5258,451,4515,464,743,290
1400000US48453001850,48453001850,"Census Tract 18.50, Travis County, Texas",4255,430,2615,338,1640,460
1400000US48453001851,48453001851,"Census Tract 18.51, Travis County, Texas",8856,617,6702,645,2154,545
1400000US48453001853,48453001853,"Census Tract 18.53, Travis County, Texas",3198,216,2581,254,617,207
1400000US48453001854,48453001854,"Census Tract 18.54, Travis County, Texas",4363,494,3050,416,1313,370
1400000US48453001855,48453001855,"Census Tract 18.55, Travis County, Texas",11647,631,9049,608,2598,467
1400000US48453001856,48453001856,"Census Tract 18.56, Travis County, Texas",4650,466,2996,428,1654,350
1400000US48453001857,48453001857,"Census Tract 18.57, Travis County, Texas",5032,533,3649,596,1383,251
1400000US48453001858,48453001858,"Census Tract 18.58, Travis County, Texas",12960,756,10091,716,2869,606
1400000US48453001859,48453001859,"Census Tract 18.59, Travis County, Texas",1124,200,1012,188,112,99
1400000US48453001860,48453001860,"Census Tract 18.60, Travis County, Texas",3667,400,2140,476,1527,376
1400000US48453001861,48453001861,"Census Tract 18.61, Travis County, Texas",4737,373,3106,500,1631,545
1400000US48453001862,48453001862,"Census Tract 18.62, Travis County, Texas",4909,410,4115,425,794,207
1400000US48453001863,48453001863,"Census Tract 18.63, Travis County, Texas",3275,377,2233,331,1042,352
1400000US48453001864,48453001864,"Census Tract 18.64, Travis County, Texas",2742,316,2180,289,562,180
1400000US48453001901,48453001901,"Census Tract 19.01, Travis County, Texas",5341,923,4618,825,723,208
1400000US48453001908,48453001908,"Census Tract 19.08, Travis County, Texas",7375,762,5094,456,2281,766
1400000US48453001910,48453001910,"Census Tract 19.10, Travis County, Texas",4067,344,3701,375,366,178
1400000US48453001911,48453001911,"Census Tract 19.11, Travis County, Texas",2930,229,2450,276,480,189
1400000US48453001912,48453001912,"Census Tract 19.12, Travis County, Texas",3785,414,3520,436,265,155
1400000US48453001913,48453001913,"Census Tract 19.13, Travis County, Texas",4902,367,4779,371,123,66
1400000US48453001914,48453001914,"Census Tract 19.14, Travis County, Texas",5775,355,5248,429,527,219
1400000US48453001915,48453001915,"Census Tract 19.15, Travis County, Texas",1846,315,1382,284,464,187
1400000US48453001916,48453001916,"Census Tract 19.16, Travis County, Texas",3316,304,3103,437,213,203
1400000US48453001917,48453001917,"Census Tract 19.17, Travis County, Texas",4778,285,4582,318,196,154
1400000US48453001918,48453001918,"Census Tract 19.18, Travis County, Texas",2519,191,2392,188,127,97
1400000US48453001919,48453001919,"Census Tract 19.19, Travis County, Texas",3719,232,3561,244,158,92
1400000US48453002002,48453002002,"Census Tract 20.02, Travis County, Texas",2842,329,1746,298,1096,340
1400000US48453002003,48453002003,"Census Tract 20.03, Travis County, Texas",3815,552,1429,246,2386,605
1400000US48453002004,48453002004,"Census Tract 20.04, Travis County, Texas",2244,349,1397,255,847,381
1400000US48453002005,48453002005,"Census Tract 20.05, Travis County, Texas",4563,502,2733,325,1830,490
1400000US48453002104,48453002104,"Census Tract 21.04, Travis County, Texas",3234,346,2118,340,1116,383
1400000US48453002105,48453002105,"Census Tract 21.05, Travis County, Texas",5242,753,1732,521,3510,789
1400000US48453002106,48453002106,"Census Tract 21.06, Travis County, Texas",3359,510,2361,549,998,319
1400000US48453002107,48453002107,"Census Tract 21.07, Travis County, Texas",3786,467,2381,386,1405,347
1400000US48453002108,48453002108,"Census Tract 21.08, Travis County, Texas",3552,486,1841,297,1711,481
1400000US48453002109,48453002109,"Census Tract 21.09, Travis County, Texas",3080,376,1998,344,1082,317
1400000US48453002110,48453002110,"Census Tract 21.10, Travis County, Texas",4438,516,1575,376,2863,593
1400000US48453002111,48453002111,"Census Tract 21.11, Travis County, Texas",4349,611,1292,298,3057,613
1400000US48453002112,48453002112,"Census Tract 21.12, Travis County, Texas",4822,632,2324,521,2498,563
1400000US48453002113,48453002113,"Census Tract 21.13, Travis County, Texas",3669,387,2364,363,1305,439
1400000US48453002201,48453002201,"Census Tract 22.01, Travis County, Texas",1870,368,1200,300,670,279
1400000US48453002202,48453002202,"Census Tract 22.02, Travis County, Texas",7575,1212,3412,732,4163,959
1400000US48453002207,48453002207,"Census Tract 22.07, Travis County, Texas",7565,554,3387,456,4178,472
1400000US48453002208,48453002208,"Census Tract 22.08, Travis County, Texas",6310,984,2523,787,3787,766
1400000US48453002209,48453002209,"Census Tract 22.09, Travis County, Texas",6841,605,4433,734,2408,570
1400000US48453002210,48453002210,"Census Tract 22.10, Travis County, Texas",3280,505,1646,325,1634,487
1400000US48453002211,48453002211,"Census Tract 22.11, Travis County, Texas",1529,538,458,231,1071,537
1400000US48453002212,48453002212,"Census Tract 22.12, Travis County, Texas",880,152,484,113,396,114
1400000US48453002304,48453002304,"Census Tract 23.04, Travis County, Texas",4285,813,833,209,3452,837
1400000US48453002307,48453002307,"Census Tract 23.07, Travis County, Texas",5020,777,2016,272,3004,785
1400000US48453002308,48453002308,"Census Tract 23.08, Travis County, Texas",5320,906,2816,502,2504,680
1400000US48453002310,48453002310,"Census Tract 23.10, Travis County, Texas",2335,401,481,143,1854,393
1400000US48453002312,48453002312,"Census Tract 23.12, Travis County, Texas",6102,636,1131,352,4971,670
1400000US48453002313,48453002313,"Census Tract 23.13, Travis County, Texas",4133,425,2138,343,1995,442
1400000US48453002314,48453002314,"Census Tract 23.14, Travis County, Texas",4858,471,2686,307,2172,451
1400000US48453002315,48453002315,"Census Tract 23.15, Travis County, Texas",3212,445,1245,275,1967,459
1400000US48453002316,48453002316,"Census Tract 23.16, Travis County, Texas",5659,793,1165,244,4494,865
1400000US48453002317,48453002317,"Census Tract 23.17, Travis County, Texas",4802,525,2483,460,2319,491
1400000US48453002318,48453002318,"Census Tract 23.18, Travis County, Texas",5571,715,2206,385,3365,716
1400000US48453002319,48453002319,"Census Tract 23.19, Travis County, Texas",809,350,573,271,236,135
1400000US48453002402,48453002402,"Census Tract 24.02, Travis County, Texas",5991,636,2998,363,2993,599
1400000US48453002403,48453002403,"Census Tract 24.03, Travis County, Texas",3326,509,1104,232,2222,539
1400000US48453002407,48453002407,"Census Tract 24.07, Travis County, Texas",3707,213,2774,201,933,175
1400000US48453002409,48453002409,"Census Tract 24.09, Travis County, Texas",3406,335,1395,191,2011,343
1400000US48453002410,48453002410,"Census Tract 24.10, Travis County, Texas",3878,342,1832,253,2046,357
1400000US48453002411,48453002411,"Census Tract 24.11, Travis County, Texas",6110,416,953,240,5157,490
1400000US48453002412,48453002412,"Census Tract 24.12, Travis County, Texas",5162,375,913,289,4249,418
1400000US48453002413,48453002413,"Census Tract 24.13, Travis County, Texas",4715,581,830,280,3885,655
1400000US48453002419,48453002419,"Census Tract 24.19, Travis County, Texas",3809,449,1461,263,2348,437
1400000US48453002421,48453002421,"Census Tract 24.21, Travis County, Texas",4923,553,3298,473,1625,389
1400000US48453002422,48453002422,"Census Tract 24.22, Travis County, Texas",4785,478,2317,366,2468,496
1400000US48453002423,48453002423,"Census Tract 24.23, Travis County, Texas",5890,824,2885,312,3005,806
1400000US48453002424,48453002424,"Census Tract 24.24, Travis County, Texas",3682,754,1989,541,1693,435
1400000US48453002425,48453002425,"Census Tract 24.25, Travis County, Texas",2787,377,1384,376,1403,292
1400000US48453002426,48453002426,"Census Tract 24.26, Travis County, Texas",6460,607,2223,393,4237,620
1400000US48453002427,48453002427,"Census Tract 24.27, Travis County, Texas",7380,755,1609,305,5771,793
1400000US48453002428,48453002428,"Census Tract 24.28, Travis County, Texas",4806,555,3221,427,1585,479
1400000US48453002429,48453002429,"Census Tract 24.29, Travis County, Texas",531,175,353,143,178,125
1400000US48453002430,48453002430,"Census Tract 24.30, Travis County, Texas",3521,428,1096,216,2425,517
1400000US48453002431,48453002431,"Census Tract 24.31, Travis County, Texas",6224,558,1798,330,4426,532
1400000US48453002432,48453002432,"Census Tract 24.32, Travis County, Texas",2050,477,606,221,1444,464
1400000US48453002433,48453002433,"Census Tract 24.33, Travis County, Texas",5233,623,2040,384,3193,531
1400000US48453002434,48453002434,"Census Tract 24.34, Travis County, Texas",1473,245,781,206,692,157
1400000US48453002435,48453002435,"Census Tract 24.35, Travis County, Texas",5760,653,2027,437,3733,609
1400000US48453002436,48453002436,"Census Tract 24.36, Travis County, Texas",2332,305,797,181,1535,280
1400000US48453002500,48453002500,"Census Tract 25, Travis County, Texas",4919,294,4425,306,494,188
1400000US48453980000,48453980000,"Census Tract 9800, Travis County, Texas",0,127,0,127,0,127
1400000US48455950100,48455950100,"Census Tract 9501, Trinity County, Texas",2959,494,2925,499,34,37
1400000US48455950200,48455950200,"Census Tract 9502, Trinity County, Texas",3838,417,3422,413,416,208
1400000US48455950300,48455950300,"Census Tract 9503, Trinity County, Texas",2037,402,2037,402,0,127
1400000US48455950400,48455950400,"Census Tract 9504, Trinity County, Texas",3514,551,3225,503,289,190
1400000US48455950500,48455950500,"Census Tract 9505, Trinity County, Texas",2103,350,1841,322,262,211
1400000US48457950100,48457950100,"Census Tract 9501, Tyler County, Texas",2753,376,2709,374,44,53
1400000US48457950200,48457950200,"Census Tract 9502, Tyler County, Texas",8057,718,7440,795,617,337
1400000US48457950300,48457950300,"Census Tract 9503, Tyler County, Texas",2501,186,2483,187,18,21
1400000US48457950400,48457950400,"Census Tract 9504, Tyler County, Texas",4621,573,4549,530,72,131
1400000US48457950500,48457950500,"Census Tract 9505, Tyler County, Texas",3540,469,3540,469,0,127
1400000US48459950100,48459950100,"Census Tract 9501, Upshur County, Texas",7293,537,6822,506,471,165
1400000US48459950200,48459950200,"Census Tract 9502, Upshur County, Texas",3372,267,3227,296,145,141
1400000US48459950300,48459950300,"Census Tract 9503, Upshur County, Texas",7560,636,7293,618,267,157
1400000US48459950400,48459950400,"Census Tract 9504, Upshur County, Texas",4787,179,4268,341,519,276
1400000US48459950500,48459950500,"Census Tract 9505, Upshur County, Texas",6204,595,6037,574,167,120
1400000US48459950600,48459950600,"Census Tract 9506, Upshur County, Texas",4184,470,3936,500,248,144
1400000US48459950700,48459950700,"Census Tract 9507, Upshur County, Texas",5285,484,4738,512,547,246
1400000US48461950100,48461950100,"Census Tract 9501, Upton County, Texas",1404,448,1040,186,364,303
1400000US48461950200,48461950200,"Census Tract 9502, Upton County, Texas",1839,448,798,228,1041,271
1400000US48463950100,48463950100,"Census Tract 9501, Uvalde County, Texas",2655,394,1369,256,1286,313
1400000US48463950200,48463950200,"Census Tract 9502, Uvalde County, Texas",7879,774,3612,394,4267,874
1400000US48463950300,48463950300,"Census Tract 9503, Uvalde County, Texas",6428,732,1502,300,4926,763
1400000US48463950400,48463950400,"Census Tract 9504, Uvalde County, Texas",3135,356,1167,185,1968,313
1400000US48463950500,48463950500,"Census Tract 9505, Uvalde County, Texas",6188,732,733,218,5455,747
1400000US48465950201,48465950201,"Census Tract 9502.01, Val Verde County, Texas",7842,539,3498,365,4344,536
1400000US48465950301,48465950301,"Census Tract 9503.01, Val Verde County, Texas",4929,431,612,202,4317,469
1400000US48465950302,48465950302,"Census Tract 9503.02, Val Verde County, Texas",4525,605,268,173,4257,628
1400000US48465950400,48465950400,"Census Tract 9504, Val Verde County, Texas",3815,540,630,297,3185,607
1400000US48465950500,48465950500,"Census Tract 9505, Val Verde County, Texas",6529,666,1745,336,4784,622
1400000US48465950601,48465950601,"Census Tract 9506.01, Val Verde County, Texas",3926,416,175,112,3751,401
1400000US48465950602,48465950602,"Census Tract 9506.02, Val Verde County, Texas",4841,546,68,63,4773,542
1400000US48465950700,48465950700,"Census Tract 9507, Val Verde County, Texas",6848,603,1081,263,5767,541
1400000US48465950800,48465950800,"Census Tract 9508, Val Verde County, Texas",4833,713,1796,315,3037,720
1400000US48465980000,48465980000,"Census Tract 9800, Val Verde County, Texas",0,127,0,127,0,127
1400000US48467950100,48467950100,"Census Tract 9501, Van Zandt County, Texas",5335,542,4932,548,403,169
1400000US48467950200,48467950200,"Census Tract 9502, Van Zandt County, Texas",3346,321,2663,321,683,186
1400000US48467950300,48467950300,"Census Tract 9503, Van Zandt County, Texas",4280,392,4088,400,192,97
1400000US48467950400,48467950400,"Census Tract 9504, Van Zandt County, Texas",5133,579,4635,578,498,289
1400000US48467950500,48467950500,"Census Tract 9505, Van Zandt County, Texas",4550,266,4048,396,502,251
1400000US48467950600,48467950600,"Census Tract 9506, Van Zandt County, Texas",7227,665,7105,680,122,111
1400000US48467950700,48467950700,"Census Tract 9507, Van Zandt County, Texas",4017,231,3620,293,397,198
1400000US48467950800,48467950800,"Census Tract 9508, Van Zandt County, Texas",5307,443,4683,452,624,231
1400000US48467950900,48467950900,"Census Tract 9509, Van Zandt County, Texas",7011,647,6290,636,721,265
1400000US48467951000,48467951000,"Census Tract 9510, Van Zandt County, Texas",6156,654,5650,624,506,149
1400000US48469000100,48469000100,"Census Tract 1, Victoria County, Texas",2803,496,895,224,1908,464
1400000US48469000201,48469000201,"Census Tract 2.01, Victoria County, Texas",3072,357,1038,236,2034,401
1400000US48469000202,48469000202,"Census Tract 2.02, Victoria County, Texas",5076,424,1529,306,3547,443
1400000US48469000301,48469000301,"Census Tract 3.01, Victoria County, Texas",1482,266,455,210,1027,273
1400000US48469000302,48469000302,"Census Tract 3.02, Victoria County, Texas",2495,352,397,164,2098,392
1400000US48469000400,48469000400,"Census Tract 4, Victoria County, Texas",1711,247,1064,228,647,220
1400000US48469000501,48469000501,"Census Tract 5.01, Victoria County, Texas",3728,376,1898,288,1830,356
1400000US48469000502,48469000502,"Census Tract 5.02, Victoria County, Texas",3809,474,2022,350,1787,365
1400000US48469000601,48469000601,"Census Tract 6.01, Victoria County, Texas",3061,439,996,259,2065,459
1400000US48469000602,48469000602,"Census Tract 6.02, Victoria County, Texas",4208,554,2041,388,2167,565
1400000US48469000700,48469000700,"Census Tract 7, Victoria County, Texas",3481,440,1619,204,1862,434
1400000US48469000800,48469000800,"Census Tract 8, Victoria County, Texas",1468,206,1098,211,370,230
1400000US48469001300,48469001300,"Census Tract 13, Victoria County, Texas",2259,261,1508,196,751,276
1400000US48469001400,48469001400,"Census Tract 14, Victoria County, Texas",8411,463,5870,455,2541,400
1400000US48469001501,48469001501,"Census Tract 15.01, Victoria County, Texas",3191,231,2401,219,790,201
1400000US48469001503,48469001503,"Census Tract 15.03, Victoria County, Texas",2294,226,2294,226,0,127
1400000US48469001504,48469001504,"Census Tract 15.04, Victoria County, Texas",6274,344,4801,349,1473,269
1400000US48469001601,48469001601,"Census Tract 16.01, Victoria County, Texas",5636,592,4079,554,1557,450
1400000US48469001604,48469001604,"Census Tract 16.04, Victoria County, Texas",6448,573,3905,428,2543,506
1400000US48469001605,48469001605,"Census Tract 16.05, Victoria County, Texas",3137,307,2059,297,1078,231
1400000US48469001606,48469001606,"Census Tract 16.06, Victoria County, Texas",7616,551,5690,387,1926,524
1400000US48469001700,48469001700,"Census Tract 17, Victoria County, Texas",4153,476,1307,327,2846,537
1400000US48469980000,48469980000,"Census Tract 9800, Victoria County, Texas",0,127,0,127,0,127
1400000US48471790101,48471790101,"Census Tract 7901.01, Walker County, Texas",8253,889,7310,868,943,304
1400000US48471790102,48471790102,"Census Tract 7901.02, Walker County, Texas",3288,427,2737,401,551,277
1400000US48471790103,48471790103,"Census Tract 7901.03, Walker County, Texas",5288,695,4540,494,748,504
1400000US48471790200,48471790200,"Census Tract 7902, Walker County, Texas",6408,910,5226,742,1182,709
1400000US48471790300,48471790300,"Census Tract 7903, Walker County, Texas",8019,815,7769,796,250,134
1400000US48471790400,48471790400,"Census Tract 7904, Walker County, Texas",7798,595,6818,667,980,307
1400000US48471790500,48471790500,"Census Tract 7905, Walker County, Texas",9943,1458,8252,1069,1691,650
1400000US48471790600,48471790600,"Census Tract 7906, Walker County, Texas",4365,562,2717,390,1648,466
1400000US48471790700,48471790700,"Census Tract 7907, Walker County, Texas",6348,1152,4501,943,1847,587
1400000US48471790800,48471790800,"Census Tract 7908, Walker County, Texas",6643,1767,5777,1600,866,304
1400000US48473680100,48473680100,"Census Tract 6801, Waller County, Texas",2609,343,1985,309,624,433
1400000US48473680200,48473680200,"Census Tract 6802, Waller County, Texas",9545,628,4636,512,4909,642
1400000US48473680300,48473680300,"Census Tract 6803, Waller County, Texas",11593,886,9573,806,2020,430
1400000US48473680400,48473680400,"Census Tract 6804, Waller County, Texas",626,513,626,513,0,127
1400000US48473680500,48473680500,"Census Tract 6805, Waller County, Texas",8739,438,7108,474,1631,332
1400000US48473680600,48473680600,"Census Tract 6806, Waller County, Texas",7719,703,5813,624,1906,568
1400000US48475950100,48475950100,"Census Tract 9501, Ward County, Texas",3976,136,2243,170,1733,196
1400000US48475950200,48475950200,"Census Tract 9502, Ward County, Texas",3818,232,2494,211,1324,260
1400000US48475950300,48475950300,"Census Tract 9503, Ward County, Texas",2711,222,967,213,1744,262
1400000US48477170100,48477170100,"Census Tract 1701, Washington County, Texas",3007,421,2532,392,475,187
1400000US48477170200,48477170200,"Census Tract 1702, Washington County, Texas",6188,542,5526,500,662,286
1400000US48477170300,48477170300,"Census Tract 1703, Washington County, Texas",5806,537,4855,505,951,485
1400000US48477170400,48477170400,"Census Tract 1704, Washington County, Texas",6442,561,5513,461,929,284
1400000US48477170500,48477170500,"Census Tract 1705, Washington County, Texas",6694,485,6136,463,558,220
1400000US48477170600,48477170600,"Census Tract 1706, Washington County, Texas",4812,437,4168,379,644,319
1400000US48479000101,48479000101,"Census Tract 1.01, Webb County, Texas",4592,487,148,75,4444,498
1400000US48479000105,48479000105,"Census Tract 1.05, Webb County, Texas",2274,458,0,127,2274,458
1400000US48479000106,48479000106,"Census Tract 1.06, Webb County, Texas",4084,678,8,14,4076,681
1400000US48479000107,48479000107,"Census Tract 1.07, Webb County, Texas",3504,595,127,154,3377,583
1400000US48479000108,48479000108,"Census Tract 1.08, Webb County, Texas",3439,439,104,152,3335,468
1400000US48479000109,48479000109,"Census Tract 1.09, Webb County, Texas",2219,345,52,85,2167,338
1400000US48479000200,48479000200,"Census Tract 2, Webb County, Texas",3521,525,114,73,3407,531
1400000US48479000300,48479000300,"Census Tract 3, Webb County, Texas",2682,408,20,32,2662,407
1400000US48479000601,48479000601,"Census Tract 6.01, Webb County, Texas",2769,569,46,57,2723,566
1400000US48479000602,48479000602,"Census Tract 6.02, Webb County, Texas",2387,367,45,78,2342,374
1400000US48479000700,48479000700,"Census Tract 7, Webb County, Texas",2970,440,75,88,2895,439
1400000US48479000800,48479000800,"Census Tract 8, Webb County, Texas",2632,545,163,153,2469,506
1400000US48479000901,48479000901,"Census Tract 9.01, Webb County, Texas",4567,643,215,145,4352,633
1400000US48479000903,48479000903,"Census Tract 9.03, Webb County, Texas",2987,428,12,18,2975,431
1400000US48479000904,48479000904,"Census Tract 9.04, Webb County, Texas",3200,423,110,93,3090,424
1400000US48479001001,48479001001,"Census Tract 10.01, Webb County, Texas",4870,568,161,123,4709,569
1400000US48479001003,48479001003,"Census Tract 10.03, Webb County, Texas",2404,284,34,45,2370,288
1400000US48479001004,48479001004,"Census Tract 10.04, Webb County, Texas",1541,285,74,60,1467,295
1400000US48479001101,48479001101,"Census Tract 11.01, Webb County, Texas",3967,490,519,214,3448,486
1400000US48479001103,48479001103,"Census Tract 11.03, Webb County, Texas",1755,313,51,61,1704,318
1400000US48479001104,48479001104,"Census Tract 11.04, Webb County, Texas",3468,384,472,293,2996,365
1400000US48479001105,48479001105,"Census Tract 11.05, Webb County, Texas",2601,309,117,115,2484,356
1400000US48479001201,48479001201,"Census Tract 12.01, Webb County, Texas",2899,440,9,19,2890,432
1400000US48479001202,48479001202,"Census Tract 12.02, Webb County, Texas",3647,518,251,203,3396,529
1400000US48479001300,48479001300,"Census Tract 13, Webb County, Texas",3417,481,67,65,3350,502
1400000US48479001401,48479001401,"Census Tract 14.01, Webb County, Texas",4240,731,57,59,4183,740
1400000US48479001402,48479001402,"Census Tract 14.02, Webb County, Texas",3178,575,28,34,3150,572
1400000US48479001501,48479001501,"Census Tract 15.01, Webb County, Texas",2985,384,217,196,2768,364
1400000US48479001502,48479001502,"Census Tract 15.02, Webb County, Texas",5091,530,86,74,5005,528
1400000US48479001601,48479001601,"Census Tract 16.01, Webb County, Texas",3977,483,464,162,3513,489
1400000US48479001602,48479001602,"Census Tract 16.02, Webb County, Texas",3671,462,541,269,3130,470
1400000US48479001706,48479001706,"Census Tract 17.06, Webb County, Texas",5346,504,196,138,5150,511
1400000US48479001709,48479001709,"Census Tract 17.09, Webb County, Texas",6202,602,679,253,5523,611
1400000US48479001710,48479001710,"Census Tract 17.10, Webb County, Texas",2064,522,152,81,1912,540
1400000US48479001711,48479001711,"Census Tract 17.11, Webb County, Texas",5242,474,549,253,4693,499
1400000US48479001712,48479001712,"Census Tract 17.12, Webb County, Texas",5921,748,329,173,5592,710
1400000US48479001713,48479001713,"Census Tract 17.13, Webb County, Texas",10673,641,699,265,9974,635
1400000US48479001714,48479001714,"Census Tract 17.14, Webb County, Texas",3211,614,172,94,3039,602
1400000US48479001715,48479001715,"Census Tract 17.15, Webb County, Texas",5720,545,209,148,5511,556
1400000US48479001716,48479001716,"Census Tract 17.16, Webb County, Texas",6283,457,240,131,6043,458
1400000US48479001717,48479001717,"Census Tract 17.17, Webb County, Texas",4359,658,52,44,4307,645
1400000US48479001718,48479001718,"Census Tract 17.18, Webb County, Texas",2332,296,251,217,2081,272
1400000US48479001719,48479001719,"Census Tract 17.19, Webb County, Texas",3646,334,236,161,3410,325
1400000US48479001720,48479001720,"Census Tract 17.20, Webb County, Texas",5695,575,754,415,4941,465
1400000US48479001721,48479001721,"Census Tract 17.21, Webb County, Texas",2329,256,60,33,2269,252
1400000US48479001722,48479001722,"Census Tract 17.22, Webb County, Texas",6162,504,543,385,5619,527
1400000US48479001806,48479001806,"Census Tract 18.06, Webb County, Texas",3188,411,21,29,3167,410
1400000US48479001807,48479001807,"Census Tract 18.07, Webb County, Texas",8835,1058,150,192,8685,1124
1400000US48479001808,48479001808,"Census Tract 18.08, Webb County, Texas",7158,639,40,52,7118,641
1400000US48479001809,48479001809,"Census Tract 18.09, Webb County, Texas",5194,878,46,52,5148,890
1400000US48479001810,48479001810,"Census Tract 18.10, Webb County, Texas",4017,400,161,73,3856,397
1400000US48479001811,48479001811,"Census Tract 18.11, Webb County, Texas",4841,322,104,79,4737,310
1400000US48479001812,48479001812,"Census Tract 18.12, Webb County, Texas",6558,481,111,119,6447,502
1400000US48479001813,48479001813,"Census Tract 18.13, Webb County, Texas",839,237,72,57,767,223
1400000US48479001814,48479001814,"Census Tract 18.14, Webb County, Texas",5593,530,370,324,5223,460
1400000US48479001815,48479001815,"Census Tract 18.15, Webb County, Texas",1831,496,72,81,1759,506
1400000US48479001816,48479001816,"Census Tract 18.16, Webb County, Texas",3886,708,95,78,3791,710
1400000US48479001817,48479001817,"Census Tract 18.17, Webb County, Texas",5025,114,62,75,4963,136
1400000US48479001818,48479001818,"Census Tract 18.18, Webb County, Texas",3331,16,24,20,3307,27
1400000US48479001900,48479001900,"Census Tract 19, Webb County, Texas",3327,448,111,165,3216,439
1400000US48479980000,48479980000,"Census Tract 9800, Webb County, Texas",0,127,0,127,0,127
1400000US48481740100,48481740100,"Census Tract 7401, Wharton County, Texas",5312,558,4259,439,1053,404
1400000US48481740200,48481740200,"Census Tract 7402, Wharton County, Texas",1463,325,1114,290,349,120
1400000US48481740300,48481740300,"Census Tract 7403, Wharton County, Texas",1698,498,1266,389,432,345
1400000US48481740400,48481740400,"Census Tract 7404, Wharton County, Texas",6569,543,4469,551,2100,458
1400000US48481740500,48481740500,"Census Tract 7405, Wharton County, Texas",3053,478,1966,329,1087,416
1400000US48481740600,48481740600,"Census Tract 7406, Wharton County, Texas",3810,465,2370,413,1440,392
1400000US48481740700,48481740700,"Census Tract 7407, Wharton County, Texas",1680,221,698,208,982,234
1400000US48481740800,48481740800,"Census Tract 7408, Wharton County, Texas",3471,461,1408,256,2063,508
1400000US48481740900,48481740900,"Census Tract 7409, Wharton County, Texas",6754,570,4818,412,1936,427
1400000US48481741000,48481741000,"Census Tract 7410, Wharton County, Texas",4704,536,1929,324,2775,510
1400000US48481741100,48481741100,"Census Tract 7411, Wharton County, Texas",2522,336,1894,269,628,251
1400000US48483950100,48483950100,"Census Tract 9501, Wheeler County, Texas",2878,218,2107,170,771,196
1400000US48483950300,48483950300,"Census Tract 9503, Wheeler County, Texas",2357,218,2082,221,275,131
1400000US48485010100,48485010100,"Census Tract 101, Wichita County, Texas",1284,241,840,220,444,169
1400000US48485010200,48485010200,"Census Tract 102, Wichita County, Texas",1167,189,754,172,413,179
1400000US48485010400,48485010400,"Census Tract 104, Wichita County, Texas",2327,381,1922,342,405,209
1400000US48485010600,48485010600,"Census Tract 106, Wichita County, Texas",2639,311,1911,339,728,207
1400000US48485010700,48485010700,"Census Tract 107, Wichita County, Texas",2370,293,1646,293,724,158
1400000US48485010800,48485010800,"Census Tract 108, Wichita County, Texas",2559,344,1601,336,958,186
1400000US48485010900,48485010900,"Census Tract 109, Wichita County, Texas",1881,377,1612,324,269,171
1400000US48485011000,48485011000,"Census Tract 110, Wichita County, Texas",2376,387,1427,299,949,267
1400000US48485011100,48485011100,"Census Tract 111, Wichita County, Texas",1497,222,336,153,1161,183
1400000US48485011200,48485011200,"Census Tract 112, Wichita County, Texas",2031,217,1833,253,198,130
1400000US48485011300,48485011300,"Census Tract 113, Wichita County, Texas",1503,257,1299,238,204,120
1400000US48485011400,48485011400,"Census Tract 114, Wichita County, Texas",2807,457,1733,272,1074,372
1400000US48485011500,48485011500,"Census Tract 115, Wichita County, Texas",2794,356,2476,317,318,149
1400000US48485011600,48485011600,"Census Tract 116, Wichita County, Texas",4403,472,3002,502,1401,396
1400000US48485011700,48485011700,"Census Tract 117, Wichita County, Texas",2291,273,2027,221,264,187
1400000US48485011800,48485011800,"Census Tract 118, Wichita County, Texas",1794,170,1560,209,234,139
1400000US48485011900,48485011900,"Census Tract 119, Wichita County, Texas",4296,363,3774,393,522,192
1400000US48485012000,48485012000,"Census Tract 120, Wichita County, Texas",6638,539,6205,549,433,161
1400000US48485012100,48485012100,"Census Tract 121, Wichita County, Texas",2909,341,2291,263,618,251
1400000US48485012200,48485012200,"Census Tract 122, Wichita County, Texas",6133,406,5328,438,805,300
1400000US48485012300,48485012300,"Census Tract 123, Wichita County, Texas",7008,526,6566,455,442,188
1400000US48485012400,48485012400,"Census Tract 124, Wichita County, Texas",7317,485,6809,505,508,168
1400000US48485012600,48485012600,"Census Tract 126, Wichita County, Texas",4196,339,3676,290,520,294
1400000US48485012700,48485012700,"Census Tract 127, Wichita County, Texas",2580,267,1847,231,733,322
1400000US48485012800,48485012800,"Census Tract 128, Wichita County, Texas",4380,366,3678,375,702,214
1400000US48485012900,48485012900,"Census Tract 129, Wichita County, Texas",2750,346,2619,351,131,102
1400000US48485013000,48485013000,"Census Tract 130, Wichita County, Texas",2578,256,1899,301,679,324
1400000US48485013100,48485013100,"Census Tract 131, Wichita County, Texas",8576,555,6595,471,1981,289
1400000US48485013200,48485013200,"Census Tract 132, Wichita County, Texas",6360,629,5802,616,558,234
1400000US48485013300,48485013300,"Census Tract 133, Wichita County, Texas",1417,364,1417,364,0,127
1400000US48485013401,48485013401,"Census Tract 134.01, Wichita County, Texas",5335,755,4554,656,781,220
1400000US48485013501,48485013501,"Census Tract 135.01, Wichita County, Texas",5904,331,5571,377,333,198
1400000US48485013502,48485013502,"Census Tract 135.02, Wichita County, Texas",4809,327,4477,335,332,191
1400000US48485013600,48485013600,"Census Tract 136, Wichita County, Texas",6079,189,5895,193,184,94
1400000US48485013700,48485013700,"Census Tract 137, Wichita County, Texas",2849,15,2317,234,532,232
1400000US48485013800,48485013800,"Census Tract 138, Wichita County, Texas",3139,313,2980,374,159,201
1400000US48485980000,48485980000,"Census Tract 9800, Wichita County, Texas",0,127,0,127,0,127
1400000US48487950300,48487950300,"Census Tract 9503, Wilbarger County, Texas",2050,180,1551,190,499,151
1400000US48487950500,48487950500,"Census Tract 9505, Wilbarger County, Texas",3001,380,2559,300,442,182
1400000US48487950600,48487950600,"Census Tract 9506, Wilbarger County, Texas",5523,422,4644,380,879,261
1400000US48487950700,48487950700,"Census Tract 9507, Wilbarger County, Texas",3063,415,1518,318,1545,306
1400000US48489950300,48489950300,"Census Tract 9503, Willacy County, Texas",6658,576,620,177,6038,567
1400000US48489950400,48489950400,"Census Tract 9504, Willacy County, Texas",6990,589,1161,200,5829,561
1400000US48489950500,48489950500,"Census Tract 9505, Willacy County, Texas",3105,199,330,163,2775,205
1400000US48489950600,48489950600,"Census Tract 9506, Willacy County, Texas",2489,394,329,87,2160,378
1400000US48489950700,48489950700,"Census Tract 9507, Willacy County, Texas",2527,312,541,143,1986,272
1400000US48489990000,48489990000,"Census Tract 9900, Willacy County, Texas",0,127,0,127,0,127
1400000US48491020105,48491020105,"Census Tract 201.05, Williamson County, Texas",3257,354,2955,337,302,286
1400000US48491020106,48491020106,"Census Tract 201.06, Williamson County, Texas",2624,286,2402,321,222,119
1400000US48491020107,48491020107,"Census Tract 201.07, Williamson County, Texas",4460,318,4369,318,91,74
1400000US48491020108,48491020108,"Census Tract 201.08, Williamson County, Texas",2852,228,2703,204,149,192
1400000US48491020109,48491020109,"Census Tract 201.09, Williamson County, Texas",2690,338,2596,353,94,80
1400000US48491020110,48491020110,"Census Tract 201.10, Williamson County, Texas",3314,204,3023,215,291,212
1400000US48491020111,48491020111,"Census Tract 201.11, Williamson County, Texas",2743,251,2194,275,549,285
1400000US48491020112,48491020112,"Census Tract 201.12, Williamson County, Texas",3098,307,2994,304,104,98
1400000US48491020113,48491020113,"Census Tract 201.13, Williamson County, Texas",2601,272,1884,236,717,174
1400000US48491020114,48491020114,"Census Tract 201.14, Williamson County, Texas",5011,751,3335,329,1676,846
1400000US48491020115,48491020115,"Census Tract 201.15, Williamson County, Texas",1866,331,1708,287,158,116
1400000US48491020201,48491020201,"Census Tract 202.01, Williamson County, Texas",1668,238,1284,234,384,193
1400000US48491020202,48491020202,"Census Tract 202.02, Williamson County, Texas",4318,445,3919,353,399,331
1400000US48491020203,48491020203,"Census Tract 202.03, Williamson County, Texas",1939,300,1939,300,0,127
1400000US48491020204,48491020204,"Census Tract 202.04, Williamson County, Texas",4379,551,3522,493,857,452
1400000US48491020301,48491020301,"Census Tract 203.01, Williamson County, Texas",4949,501,4410,527,539,177
1400000US48491020302,48491020302,"Census Tract 203.02, Williamson County, Texas",2772,371,2151,328,621,318
1400000US48491020310,48491020310,"Census Tract 203.10, Williamson County, Texas",2402,164,2236,165,166,154
1400000US48491020311,48491020311,"Census Tract 203.11, Williamson County, Texas",1966,199,1397,244,569,186
1400000US48491020312,48491020312,"Census Tract 203.12, Williamson County, Texas",6356,568,3590,498,2766,658
1400000US48491020313,48491020313,"Census Tract 203.13, Williamson County, Texas",7977,434,6645,486,1332,350
1400000US48491020314,48491020314,"Census Tract 203.14, Williamson County, Texas",4939,545,3744,549,1195,350
1400000US48491020315,48491020315,"Census Tract 203.15, Williamson County, Texas",2290,315,2017,223,273,301
1400000US48491020316,48491020316,"Census Tract 203.16, Williamson County, Texas",2649,294,2220,333,429,227
1400000US48491020317,48491020317,"Census Tract 203.17, Williamson County, Texas",1596,222,1274,228,322,159
1400000US48491020318,48491020318,"Census Tract 203.18, Williamson County, Texas",8547,473,7633,527,914,332
1400000US48491020319,48491020319,"Census Tract 203.19, Williamson County, Texas",4755,316,3791,331,964,235
1400000US48491020320,48491020320,"Census Tract 203.20, Williamson County, Texas",6450,450,5420,446,1030,289
1400000US48491020321,48491020321,"Census Tract 203.21, Williamson County, Texas",1684,257,1261,241,423,266
1400000US48491020322,48491020322,"Census Tract 203.22, Williamson County, Texas",8323,446,6769,529,1554,366
1400000US48491020323,48491020323,"Census Tract 203.23, Williamson County, Texas",1845,184,1643,216,202,113
1400000US48491020324,48491020324,"Census Tract 203.24, Williamson County, Texas",5409,454,4659,470,750,165
1400000US48491020325,48491020325,"Census Tract 203.25, Williamson County, Texas",3025,463,2127,675,898,375
1400000US48491020326,48491020326,"Census Tract 203.26, Williamson County, Texas",5848,336,5110,363,738,207
1400000US48491020327,48491020327,"Census Tract 203.27, Williamson County, Texas",2736,399,2046,337,690,433
1400000US48491020328,48491020328,"Census Tract 203.28, Williamson County, Texas",6470,332,5103,384,1367,414
1400000US48491020403,48491020403,"Census Tract 204.03, Williamson County, Texas",1777,240,1410,224,367,176
1400000US48491020404,48491020404,"Census Tract 204.04, Williamson County, Texas",3376,240,2752,244,624,187
1400000US48491020405,48491020405,"Census Tract 204.05, Williamson County, Texas",5696,559,4467,529,1229,325
1400000US48491020406,48491020406,"Census Tract 204.06, Williamson County, Texas",5577,608,4845,550,732,324
1400000US48491020408,48491020408,"Census Tract 204.08, Williamson County, Texas",3942,410,3110,407,832,414
1400000US48491020409,48491020409,"Census Tract 204.09, Williamson County, Texas",3641,329,2855,319,786,292
1400000US48491020410,48491020410,"Census Tract 204.10, Williamson County, Texas",5494,363,4289,405,1205,438
1400000US48491020411,48491020411,"Census Tract 204.11, Williamson County, Texas",6432,612,5415,647,1017,318
1400000US48491020503,48491020503,"Census Tract 205.03, Williamson County, Texas",4679,317,4129,294,550,214
1400000US48491020504,48491020504,"Census Tract 205.04, Williamson County, Texas",7682,654,4813,561,2869,621
1400000US48491020505,48491020505,"Census Tract 205.05, Williamson County, Texas",2876,210,2635,243,241,163
1400000US48491020506,48491020506,"Census Tract 205.06, Williamson County, Texas",8596,664,7276,633,1320,270
1400000US48491020507,48491020507,"Census Tract 205.07, Williamson County, Texas",2883,339,2405,373,478,262
1400000US48491020508,48491020508,"Census Tract 205.08, Williamson County, Texas",4377,495,3373,426,1004,385
1400000US48491020509,48491020509,"Census Tract 205.09, Williamson County, Texas",6596,463,5948,395,648,197
1400000US48491020510,48491020510,"Census Tract 205.10, Williamson County, Texas",8989,450,8264,461,725,243
1400000US48491020602,48491020602,"Census Tract 206.02, Williamson County, Texas",5104,429,3503,379,1601,420
1400000US48491020603,48491020603,"Census Tract 206.03, Williamson County, Texas",7560,353,6740,367,820,213
1400000US48491020604,48491020604,"Census Tract 206.04, Williamson County, Texas",4427,364,3344,317,1083,341
1400000US48491020605,48491020605,"Census Tract 206.05, Williamson County, Texas",6565,361,5553,370,1012,362
1400000US48491020701,48491020701,"Census Tract 207.01, Williamson County, Texas",2445,438,1385,308,1060,504
1400000US48491020703,48491020703,"Census Tract 207.03, Williamson County, Texas",10695,941,6479,657,4216,765
1400000US48491020704,48491020704,"Census Tract 207.04, Williamson County, Texas",5017,422,2781,327,2236,436
1400000US48491020706,48491020706,"Census Tract 207.06, Williamson County, Texas",4237,453,3528,380,709,397
1400000US48491020707,48491020707,"Census Tract 207.07, Williamson County, Texas",4499,627,3262,450,1237,727
1400000US48491020708,48491020708,"Census Tract 207.08, Williamson County, Texas",5868,666,4942,691,926,342
1400000US48491020803,48491020803,"Census Tract 208.03, Williamson County, Texas",4064,543,2550,375,1514,509
1400000US48491020804,48491020804,"Census Tract 208.04, Williamson County, Texas",7241,443,6294,476,947,390
1400000US48491020805,48491020805,"Census Tract 208.05, Williamson County, Texas",6171,584,4502,480,1669,499
1400000US48491020806,48491020806,"Census Tract 208.06, Williamson County, Texas",1723,355,1034,349,689,296
1400000US48491020807,48491020807,"Census Tract 208.07, Williamson County, Texas",6121,412,4250,454,1871,310
1400000US48491020808,48491020808,"Census Tract 208.08, Williamson County, Texas",1565,368,1269,253,296,246
1400000US48491020809,48491020809,"Census Tract 208.09, Williamson County, Texas",5533,355,4437,396,1096,274
1400000US48491020900,48491020900,"Census Tract 209, Williamson County, Texas",4203,348,3525,355,678,259
1400000US48491021000,48491021000,"Census Tract 210, Williamson County, Texas",3084,328,1247,230,1837,276
1400000US48491021100,48491021100,"Census Tract 211, Williamson County, Texas",2657,563,1416,513,1241,357
1400000US48491021201,48491021201,"Census Tract 212.01, Williamson County, Texas",2665,261,2107,245,558,203
1400000US48491021202,48491021202,"Census Tract 212.02, Williamson County, Texas",3226,474,2543,430,683,337
1400000US48491021203,48491021203,"Census Tract 212.03, Williamson County, Texas",2679,380,1847,378,832,243
1400000US48491021300,48491021300,"Census Tract 213, Williamson County, Texas",3814,349,2921,328,893,220
1400000US48491021401,48491021401,"Census Tract 214.01, Williamson County, Texas",8951,756,5557,681,3394,738
1400000US48491021402,48491021402,"Census Tract 214.02, Williamson County, Texas",4064,662,1897,394,2167,576
1400000US48491021403,48491021403,"Census Tract 214.03, Williamson County, Texas",3332,408,1519,229,1813,421
1400000US48491021502,48491021502,"Census Tract 215.02, Williamson County, Texas",4979,455,2379,346,2600,462
1400000US48491021503,48491021503,"Census Tract 215.03, Williamson County, Texas",3766,457,2961,500,805,351
1400000US48491021504,48491021504,"Census Tract 215.04, Williamson County, Texas",3184,617,2593,521,591,349
1400000US48491021505,48491021505,"Census Tract 215.05, Williamson County, Texas",6592,555,4083,334,2509,525
1400000US48491021506,48491021506,"Census Tract 215.06, Williamson County, Texas",2077,379,1344,302,733,303
1400000US48491021507,48491021507,"Census Tract 215.07, Williamson County, Texas",8082,769,6143,696,1939,676
1400000US48491021508,48491021508,"Census Tract 215.08, Williamson County, Texas",5225,581,4407,649,818,339
1400000US48491021601,48491021601,"Census Tract 216.01, Williamson County, Texas",2427,372,1660,179,767,339
1400000US48491021602,48491021602,"Census Tract 216.02, Williamson County, Texas",3318,591,2215,354,1103,567
1400000US48491021603,48491021603,"Census Tract 216.03, Williamson County, Texas",2134,370,1634,399,500,238
1400000US48493000102,48493000102,"Census Tract 1.02, Wilson County, Texas",3253,406,2444,410,809,199
1400000US48493000103,48493000103,"Census Tract 1.03, Wilson County, Texas",2683,401,1872,326,811,384
1400000US48493000104,48493000104,"Census Tract 1.04, Wilson County, Texas",4388,395,3349,382,1039,206
1400000US48493000201,48493000201,"Census Tract 2.01, Wilson County, Texas",3052,405,1400,318,1652,400
1400000US48493000202,48493000202,"Census Tract 2.02, Wilson County, Texas",1573,292,1237,289,336,151
1400000US48493000300,48493000300,"Census Tract 3, Wilson County, Texas",5067,348,1584,300,3483,341
1400000US48493000402,48493000402,"Census Tract 4.02, Wilson County, Texas",2405,276,1452,323,953,252
1400000US48493000403,48493000403,"Census Tract 4.03, Wilson County, Texas",6256,466,3930,328,2326,394
1400000US48493000404,48493000404,"Census Tract 4.04, Wilson County, Texas",5292,362,3606,370,1686,260
1400000US48493000500,48493000500,"Census Tract 5, Wilson County, Texas",3767,390,2868,401,899,203
1400000US48493000600,48493000600,"Census Tract 6, Wilson County, Texas",3528,357,1809,320,1719,306
1400000US48495950200,48495950200,"Census Tract 9502, Winkler County, Texas",2395,355,1293,213,1102,305
1400000US48495950300,48495950300,"Census Tract 9503, Winkler County, Texas",3281,361,1346,196,1935,305
1400000US48495950400,48495950400,"Census Tract 9504, Winkler County, Texas",1257,234,769,145,488,187
1400000US48497150101,48497150101,"Census Tract 1501.01, Wise County, Texas",3017,441,2526,279,491,388
1400000US48497150102,48497150102,"Census Tract 1501.02, Wise County, Texas",6163,546,5626,485,537,196
1400000US48497150200,48497150200,"Census Tract 1502, Wise County, Texas",5948,323,4016,427,1932,397
1400000US48497150300,48497150300,"Census Tract 1503, Wise County, Texas",3413,300,3261,311,152,88
1400000US48497150401,48497150401,"Census Tract 1504.01, Wise County, Texas",5429,619,4658,532,771,308
1400000US48497150402,48497150402,"Census Tract 1504.02, Wise County, Texas",5302,460,4935,447,367,194
1400000US48497150403,48497150403,"Census Tract 1504.03, Wise County, Texas",3624,420,3306,407,318,226
1400000US48497150500,48497150500,"Census Tract 1505, Wise County, Texas",6041,329,3757,469,2284,376
1400000US48497150601,48497150601,"Census Tract 1506.01, Wise County, Texas",8519,573,8064,563,455,217
1400000US48497150602,48497150602,"Census Tract 1506.02, Wise County, Texas",5967,601,4947,496,1020,325
1400000US48497150603,48497150603,"Census Tract 1506.03, Wise County, Texas",4631,574,3793,414,838,386
1400000US48499950100,48499950100,"Census Tract 9501, Wood County, Texas",4417,534,4145,468,272,230
1400000US48499950200,48499950200,"Census Tract 9502, Wood County, Texas",3331,298,3214,279,117,79
1400000US48499950301,48499950301,"Census Tract 9503.01, Wood County, Texas",3312,481,3140,476,172,132
1400000US48499950302,48499950302,"Census Tract 9503.02, Wood County, Texas",4720,727,4247,729,473,250
1400000US48499950400,48499950400,"Census Tract 9504, Wood County, Texas",4477,492,4124,464,353,188
1400000US48499950500,48499950500,"Census Tract 9505, Wood County, Texas",2226,258,2015,260,211,129
1400000US48499950601,48499950601,"Census Tract 9506.01, Wood County, Texas",4957,1408,4843,1397,114,95
1400000US48499950602,48499950602,"Census Tract 9506.02, Wood County, Texas",4352,506,4289,497,63,66
1400000US48499950700,48499950700,"Census Tract 9507, Wood County, Texas",4876,475,4393,477,483,232
1400000US48499950800,48499950800,"Census Tract 9508, Wood County, Texas",4957,301,3943,410,1014,304
1400000US48501950100,48501950100,"Census Tract 9501, Yoakum County, Texas",1992,294,1175,227,817,276
1400000US48501950200,48501950200,"Census Tract 9502, Yoakum County, Texas",5714,294,2242,227,3472,276
1400000US48503950200,48503950200,"Census Tract 9502, Young County, Texas",4448,242,3596,332,852,261
1400000US48503950400,48503950400,"Census Tract 9504, Young County, Texas",5485,272,5287,278,198,109
1400000US48503950500,48503950500,"Census Tract 9505, Young County, Texas",3086,277,2392,271,694,188
1400000US48503950600,48503950600,"Census Tract 9506, Young County, Texas",5279,300,4326,319,953,192
1400000US48505950301,48505950301,"Census Tract 9503.01, Zapata County, Texas",4190,849,0,127,4190,849
1400000US48505950302,48505950302,"Census Tract 9503.02, Zapata County, Texas",4928,659,613,225,4315,633
1400000US48505950400,48505950400,"Census Tract 9504, Zapata County, Texas",4491,705,490,225,4001,672
1400000US48507950100,48507950100,"Census Tract 9501, Zavala County, Texas",1268,306,66,86,1202,301
1400000US48507950200,48507950200,"Census Tract 9502, Zavala County, Texas",2181,446,287,142,1894,409
1400000US48507950301,48507950301,"Census Tract 9503.01, Zavala County, Texas",2396,524,183,175,2213,500
1400000US48507950302,48507950302,"Census Tract 9503.02, Zavala County, Texas",5813,425,407,179,5406,439